flag	name	description
$ITEM_SWORD	<RE>$ITM_W_SWORD
$ITEM_BOW	<RE>$ITM_W_BOW
$ITEM_STAFF	<RE>$ITM_W_STAFF
$ITEM_LIGHT	<RE>$ITM_A_LIGHT
$ITEM_HEAVY	<RE>$ITM_A_HEAVY
$ITEM_BOOK	<RE>$ITM_W_BOOK
$ITEM_WEAPON	무기
$ITEM_ARMOR	방어구
$ITM_W_BOOK	책	<NULL>
$ITM_W_BOOK_PLURAL	책	<NULL>
$ITM_A_LIGHT	경갑	<NULL>
$ITM_A_LIGHT_PLURAL	경갑	<NULL>
$ITM_A_HEAVY	중갑	<NULL>
$ITM_A_HEAVY_PLURAL	중갑	<NULL>
$ITM_W_SWORD	검	<NULL>
$ITM_W_SWORD_PLURAL	검	<NULL>
$ITM_W_BOW	활	<NULL>
$ITM_W_BOW_PLURAL	활	<NULL>
$ITM_W_STAFF	지팡이	<NULL>
$ITM_W_STAFF_PLURAL	지팡이	<NULL>
$ITM_A_LIGHT_PLURAL_SHORT	경갑	<NULL>
$ITM_A_HEAVY_PLURAL_SHORT	중갑	<NULL>
$ITM_W_SWORD_PLURAL_SHORT	검	<NULL>
$ITM_W_STAFF_PLURAL_SHORT	스태프	<NULL>
$ITM_W_BOW_PLURAL_SHORT	활	<NULL>
$ITM_W_BOOK_PLURAL_SHORT	책	<NULL>
$ITM_A_LIGHT_1	자루 옷	옷 아래 입는 삼베로 만든 자루. 없는 것보단 낫겠죠.
$ITM_A_LIGHT_2	생가죽	건조한 후, 손 대지 않은 동물의 가죽입니다. 호신용 조끼를 만드는데 사용됩니다. 두껍고 튼튼합니다.
$ITM_A_LIGHT_3	족장의 튜닉	현란한 색을 띈 유목민의 튜닉입니다. 두꺼운 양털과 화려한 자수로 만들어졌습니다. 옷단은 끝없이 얽혀있는 세계수의 뿌리를 본떴습니다.
$ITM_A_LIGHT_4	두꺼운 양털 튜닉	유목민의 목동 느낌의 길고 두꺼운 튜닉입니다.
$ITM_A_LIGHT_5	호랑이 가죽조끼	가죽 벨트에 새겨진 퀘이드 불꽃 장식만이 이 이국적인 물건의 기원을 암시해주고 있습니다.
$ITM_A_LIGHT_6	모피	귀중한 털 가죽으로 만든 푹신하고 따뜻한 조끼입니다.
$ITM_A_LIGHT_7	오지말의 코트	희미한 치즈 냄새가 납니다.
$ITM_A_LIGHT_8	가죽	무두질한 가죽을 주의 깊게 꿰맨 맵시 있는 조끼입니다.
$ITM_A_LIGHT_9	전투 수도승의 의복	이 두꺼운 수도사 의복에는 진실과 질서의 수호 가문인 '셀리니의 9번째 나뭇가지'의 문양이 장식되어 있습니다.
$ITM_A_LIGHT_10	양털 누비옷	좋은 양모를 몇 겹이나 겹쳐 공들여 꿰맨 다음, 사이에 남는 천이나 동물의 털을 욱여넣어 튼튼한 방어구를 만들었습니다. 치명상만 아니라면 거의 막아낼 수 있습니다.
$ITM_A_LIGHT_11	암살자의 어리석음	주의 깊게 보지 않는다면 그저 화려한 귀족의 의복이지만, 좀 더 자세히 본다면 옷 안쪽에 얇은 금속판들을 꿰매어 붙였다는 사실을 알 수 있습니다. 등 쪽에 난 자그마한 흠집은, 이 기발한 디자인의 옷이 최소한 한 번의 암살 시도는 막았었다는 사실을 알려줍니다.
$ITM_A_LIGHT_12	비단 누비옷	튼튼한 비단 여러 겹을 겹쳐 말갈기로 꿰매어, 화살 정도는 상처도 없이 막을 수 있는 방어구를 만들었습니다.
$ITM_A_LIGHT_13	활의 달인	애쉬가의 누비옷으로, 최상급의 비단 위에 현란하게 수놓인 자수는 그 주인이 '활의 달인'임을 여실히 드러내 보여줍니다. 표면에 자잘하게 수선한 흔적이 수십 개는 되는 것으로 보아. 이 대적할 자 없을 갑옷은 많은 전장에서 활약했음을 알 수 있습니다. 대부분 선대 마스터에게서 물려받는 식으로 이어져왔겠죠.
$ITM_A_LIGHT_14	백금 양털	황금 양털 따위와는 비교도 안되게 귀중한 물건입니다. 전설의 양 Axxima Vatta Muttunaxxor의 시체에서 벗겨낸 가죽으로, 그 눈부신 광채는 감히 어디에 비할 바가 되지 못 합니다.
$ITM_A_LIGHT_15	족장의 튜닉+	현란한 색을 띈 유목민의 튜닉입니다. 두꺼운 양털과 화려한 자수로 만들어졌습니다. 옷단은 끝없이 얽혀있는 세계수의 뿌리를 본떴습니다.
$ITM_A_LIGHT_16	호랑이 가죽조끼+	가죽 벨트에 새겨진 퀘이드 불꽃 장식만이 이 이국적인 물건의 기원을 암시해주고 있습니다.
$ITM_A_LIGHT_17	오지말의 코트+	희미한 치즈 냄새가 납니다.
$ITM_A_LIGHT_18	전투 수도승의 의복+	이 두꺼운 수도사 의복에는 진실과 질서의 수호 가문인 '셀리니의 9번째 나뭇가지'의 문양이 장식되어 있습니다.
$ITM_A_LIGHT_19	암살자의 어리석음+	주의 깊게 보지 않는다면 그저 화려한 귀족의 의복이지만, 좀 더 자세히 본다면 옷 안쪽에 얇은 금속판들을 꿰매어 붙였다는 사실을 알 수 있습니다. 등 쪽에 난 자그마한 흠집은, 이 기발한 디자인의 옷이 최소한 한 번의 암살 시도는 막았었다는 사실을 알려줍니다.
$ITM_A_LIGHT_20	활의 달인+	애쉬가의 솜옷으로, 갑옷 밑에 받쳐 입습니다. 최상급의 비단 위에 현란하게 수놓인 자수는, 그 주인이 '활의 달인'임을 여실히 드러내 보여줍니다. 표면에 자잘하게 수선한 흔적이 수십 개는 되는 것으로 보아. 이 대적할 자 없을 갑옷은 많은 전장에서 활약했음을 알 수 있습니다. 대부분 선대 마스터에게서 물려받는 식으로 이어져왔겠죠.
$ITM_A_LIGHT_21	백금 양털+	황금 양털 따위와는 비교도 안되게 귀중한 물건입니다. 전설의 양 Axxima Vatta Muttunaxxor의 시체에서 벗겨낸 가죽으로, 그 눈부신 광채는 감히 어디에 비할 바가 되지 못 합니다.
$ITM_A_LIGHT_22	자루 옷+	옷 아래 입는 삼베로 만든 자루. 없는 것보단 낫겠죠. 강화되어 더 강력해졌습니다.
$ITM_A_LIGHT_23	생가죽+	건조한 후, 손 대지 않은 동물의 가죽입니다. 호신용 조끼를 만드는데 사용됩니다. 두껍고 튼튼합니다. 강화되어 더 강력해졌습니다.
$ITM_A_LIGHT_24	두꺼운 양털 튜닉+	유목민의 목동 느낌의 길고 두꺼운 튜닉입니다. 강화되어 더 강력해졌습니다.
$ITM_A_LIGHT_25	모피+	귀중한 털 가죽으로 만든 푹신하고 따뜻한 조끼입니다. 강화되어 더 강력해졌습니다.
$ITM_A_LIGHT_26	가죽+	무두질한 가죽을 주의 깊게 꿰맨 맵시 있는 조끼입니다. 강화되어 더 강력해졌습니다.
$ITM_A_LIGHT_27	양털 누비옷+	좋은 양모를 몇 겹이나 겹쳐 공들여 꿰맨 다음, 사이에 남는 천이나 동물의 털을 욱여넣어 튼튼한 방어구를 만들었습니다. 치명상만 아니라면 거의 막아낼 수 있습니다. 강화되어 더 강력해졌습니다.
$ITM_A_LIGHT_28	비단 누비옷+	튼튼한 비단 여러 겹을 겹쳐 말갈기로 꿰매어, 화살 정도는 상처도 없이 막을 수 있는 방어구를 만들었습니다. 강화되어 더 강력해졌습니다.
$ITM_A_HEAVY_1	사슬 가죽조끼	가벼운 누비옷 위에 대충 제련한 쇠사슬을 붙여, 방어력을 더욱 보강한 물건입니다.
$ITM_A_HEAVY_2	사슬 셔츠	수백 개의 쇠사슬을 이어서 만든 셔츠로, 사슬이 튀어나가는 것을 막기 위해 하나하나가 대갈 못으로 박혀있습니다.
$ITM_A_HEAVY_3	전쟁의 영광	우아한 자태를 뽐내는 세련된 퀘이드 갑옷입니다. 사슬 하나하나가 모두 파랗게 물들어 있으며, 웃옷의 끝단은 금빛으로 마감되어 있습니다. 갑옷에 덧붙인 철판들은 하나하나가 모두 도금으로 장식되어 있으며 황족의 표식을 두드러지게 나타내고 있습니다. 표면에는 퀘이드어로 ""지금 생각해봐야 다 부질없는 것을""이라는 말이 거칠게 새겨져 있습니다. 판금의 곳곳에 몇몇 단어가 더 새겨져 있지만, 급하게 휘갈겼는지 거의 알아보기 힘듭니다.
$ITM_A_HEAVY_4	혼합 사슬 갑옷	사슬 갑옷 위에 철판을 덧붙여, 몸 쪽의 방어력을 보강했습니다. 퀘이드 보병의 제식 갑옷입니다.
$ITM_A_HEAVY_5	기수의 찰갑	맵시있는 찰갑입니다. 어깨와 무릎까지 모두 방어하는 것으로 보아 중기병들이 작용하던 물건으로 보입니다. 완갑에는 도금이 되어 있고 받쳐 입는 누비옷 역시 비단으로 만들어진 것으로 보아, 이전 주인은 상당한 부자일 뿐만 아니라 예술적 취향도 겸비했던 전사였음을 알 수 있습니다. 갑옷의 곳곳에는 어느 지방의 언어일지 모를 외국어 문장들이 아로새겨져 있습니다. 착용자의 심장 부위에는 아마 안녕을 기원하거나 액막이용 기도가 쓰여있는 것 같지만, 어디까지나 추측일 뿐입니다.
$ITM_A_HEAVY_6	찰갑	자그마한 철판들을 비단 끈으로 한데 엮어 만들었습니다.
$ITM_A_HEAVY_7	배신자의 장비	애쉬에서 만들어진 판금 코트입니다. 견갑에 도금이 되어 있는 것으로 보아 그 주인이 고위 장교였음을 짐작할 수 있습니다. 겉의 천은 한번 교체한 것으로 보이지만, 배신자라는 글자는 아직도 천에 새겨져 있습니다. 갑주에는 눈에 띌 만한 흔적이 남아있지 않지만, 붉은 염색에도 불구하고 핏자국이 선명하게 보입니다.
$ITM_A_HEAVY_8	판금 코트	질긴 천으로 만든 코트 밑에 두꺼운 철판 몇 장을 대갈 못으로 이어붙여, 몸 쪽 방어력이 완벽한 갑옷을 만들었습니다..
$ITM_A_HEAVY_9	와콜란의 힘	초록색 벨벳으로 만든 미늘 갑옷으로, 견갑이 상당히 크고 광택이 나는 것으로 보아 퀘이드 중 보병이 사용하던 갑주라고 생각됩니다.  퀘이드 영웅인 와콜란이 맨손으로 곰의 머리를 깨자, 그 밑에서 와콜란의 아이들인 와스탄과 와젤라가 곰의 입에서 흘러나오는 피를 받아마시는 장면이 그려져 있습니다. 이는 유명한 일화인 '가문의 망명' 중에 있었던 일로 보입니다.
$ITM_A_HEAVY_10	미늘 갑옷	수백 개의 철판이 캔버스 안에 고정되어 있습니다. 딱 맞는 상체 보호를 위해 외부는 부드러운 비단으로 구성되어 있습니다.
$ITM_A_HEAVY_11	위대한 워든의 장비	갑옷 위에 새겨진 문양은 이 완벽한 갑주의 주인이 애쉬에서 파견한 구덩이의 감시자, 위대한 워든임을 밝히고 있습니다. 이 귀족이 어떻게 자신이 감시하던 감옥 안에서 사라졌는지는 아직도 밝혀지지 않은 상태이나, 어깨에 묻어있는 핏자국은 그 사연이 범상치 않음을 암시하고 있습니다.
$ITM_A_HEAVY_12	판금 장비	가죽 기반 위의 복잡한 모양의 철판들은 최대의 보호를 제공함과 동시에 자유로운 움직임을 보장합니다. 애쉬 기사들이 선호하는 장비입니다.
$ITM_A_HEAVY_13	불꽃의 순수	이 찬란히 빛나는 판금 장비는 어떤 빛이던 지옥불 정도의 세기로 반사합니다. 희미한 에칭화는 퀘이드의 것으로 보이지만 적힌 말은 너무 오래되어 ""소모하는 것"" 정도만 읽힙니다. 흉부 판금은 셀 수 없이 교체된 것 같으며 그 외의 부분은 더욱 현대의 것입니다. 수수께끼 같은 그림문자가 제국의 불의 의식에서의 역할에 대한 힌트를 주고 있습니다.
$ITM_A_HEAVY_14	호수의 수호자	거장이 제작한 이 장비는 거의 흑색에 가까운 청색을 띱니다. 흉갑 표면에 새겨진 매끄러운 패턴은 애쉬 신전의 원천을 묘사합니다. 이는 이 놀라운 갑옷이 대부분 신전수호병에게 주어진다는 걸 암시합니다. 이렇게 값진 유물이 구덩이까지 왔는지는 의문이군요.
$ITM_A_HEAVY_15	전쟁의 영광+	우아한 자태를 뽐내는 세련된 퀘이드 갑옷입니다. 사슬 하나하나가 모두 파랗게 물들어 있으며, 웃옷의 끝단은 금빛으로 마감되어 있습니다. 갑옷에 덧붙인 철판들은 하나하나가 모두 도금으로 장식되어 있으며 황족의 표식을 두드러지게 나타내고 있습니다. 표면에는 퀘이드어로 ""지금 생각해봐야 다 부질없는 것을""이라는 말이 거칠게 새겨져 있습니다. 판금의 곳곳에 몇몇 단어가 더 새겨져 있지만, 급하게 휘갈겼는지 거의 알아보기 힘듭니다.
$ITM_A_HEAVY_16	기수의 찰갑+	맵시 있는 찰갑입니다. 어깨와 무릎까지 모두 방어하는 것으로 보아 중기병들이 작용하던 물건으로 보입니다. 완갑에는 도금이 되어 있고 받쳐 입는 누비옷 역시 비단으로 만들어진 것으로 보아, 이전 주인은 상당한 부자일 뿐만 아니라 예술적 취향도 겸비했던 전사였음을 알 수 있습니다. 갑옷의 곳곳에는 어느 지방의 언어일지 모를 외국어 문장들이 아로새겨져 있습니다. 착용자의 심장 부위에는 아마 안녕을 기원하거나 액막이용 기도가 쓰여있는것 같지만, 어디까지나 추측일 뿐입니다.
$ITM_A_HEAVY_17	배신자의 장비+	Ash에서 만들어진 판금 코트입니다. 견갑에 도금이 되어 있는 것으로 보아 그 주인이 고위 장교였음을 짐작할 수 있습니다. 겉의 천은 한번 교체한 것으로 보이지만, 배신자라는 글자는 아직도 천에 새겨져 있습니다. 갑주에는 눈에 띌 만한 흔적이 남아있지 않지만, 붉은 염색에도 불구하고 핏자국이 선명하게 보입니다.
$ITM_A_HEAVY_18	와콜란의 힘+	초록색 벨벳으로 만든 미늘 갑옷으로, 견갑이 상당히 크고 광택이 나는 것으로 보아 퀘이드 중보병이 사용하던 갑주라고 생각됩니다.  퀘이드 영웅인 와콜란이 맨손으로 곰의 머리를 깨자, 그 밑에서 와콜란의 아이들인 와스탄과 와젤라가 곰의 입에서 흘러나오는 피를 받아마시는 장면이 그려져 있습니다. 이는 유명한 일화인 '가문의 망명' 중에 있었던 일로 보입니다.
$ITM_A_HEAVY_19	위대한 워든의 장비+	갑옷 위에 새겨진 문양은 이 완벽한 갑주의 주인이 애쉬에서 파견한 구덩이의 감시자, 위대한 워든임을 밝히고 있습니다. 이 귀족이 어떻게 자신이 감시하던 감옥 안에서 사라졌는지는 아직도 밝혀지지 않은 상태이나, 어깨에 묻어있는 핏자국은 그 사연이 범상치 않음을 암시하고 있습니다.
$ITM_A_HEAVY_20	불꽃의 순수+	이 찬란히 빛나는 판금 장비는 어떤 빛이던 지옥불 정도의 세기로 반사합니다. 희미한 에칭화는 퀘이드의 것으로 보이지만 적힌 말은 너무 오래되어 ""소모하는 것"" 정도만 읽힙니다. 흉부 판금은 셀수없이 교체된 것 같으며 그 외의 부분은 더욱 현대의 것입니다. 수수께끼 같은 그림문자가 제국의 불의 의식에서의 역할에 대한 힌트를 주고 있습니다.
$ITM_A_HEAVY_21	호수의 수호자+	거장이 제작한 이 장비는 거의 흑색에 가까운 청색을 띱니다. 흉갑 표면에 새겨진 매끄러운 패턴은 애쉬 신전의 원천을 묘사합니다. 이는 이 놀라운 갑옷이 대부분 신전 수호병에게 주어진다는 걸 암시합니다. 이렇게 값진 유물이 구덩이까지 왔는지는 의문이군요.
$ITM_A_HEAVY_22	사슬 가죽조끼+	가벼운 누비옷 위에 대충 제련한 쇠사슬을 붙여, 방어력을 더욱 보강한 물건입니다. 강화를 통해 보통 옷보다 단단해졌습니다.
$ITM_A_HEAVY_23	사슬 셔츠+	수백 개의 쇠사슬을 이어서 만든 셔츠로, 사슬이 튀어나가는 것을 막기 위해 하나하나가 대갈 못으로 박혀있습니다. 강화를 통해 보통 옷보다 단단해졌습니다.
$ITM_A_HEAVY_24	혼합 사슬 갑옷+	사슬 갑옷 위에 철판을 덧붙여, 몸 쪽의 방어력을 보강했습니다.  퀘이드 보병의 제식 갑옷입니다. 강화를 통해 보통 갑옷보다 단단해졌습니다.
$ITM_A_HEAVY_25	찰갑+	자그마한 철판들을 비단끈으로 한데 엮어 만들었습니다. 강화를 통해 더욱 단단해졌습니다.
$ITM_A_HEAVY_26	판금 코트+	질긴 천으로 만든 코트 밑에 두꺼운 철판 몇 장을 대갈 못으로 이어붙여, 몸 쪽 방어력이 완벽한 갑옷을 만들었습니다. 강화를 통해 보통 갑옷 보다 단단해졌습니다.
$ITM_A_HEAVY_27	미늘 갑옷+	수백 개의 철판이 캔버스 안에 고정되어 있습니다. 딱 맞는 상체 보호를 위해 외부는 부드러운 비단으로 구성되어 있습니다. 강화를 통해 보통 갑옷 보다 단단해졌습니다.
$ITM_A_HEAVY_28	판금 장비+	가죽 기반 위의 복잡한 모양의 철판들은 최대의 보호를 제공함과 동시에 자유로운 움직임을 보장합니다. 애쉬 기사들이 선호하는 장비입니다. 강화를 통해 보통 갑옷 보다 단단해졌습니다.
$ITM_A_SKULL_1	돌 해골	잘 연마한 석재 해골입니다. 어떤 이들은 망령들이 가지고 있던 마법 부적이라 여깁니다. 베테랑들은 그냥 다른 쓸만한 물건과 바꿀 수 있을 것이라고 합니다.
$ITM_A_SKULL_2	동 해골	구리로 만든 해골입니다, 마법 주문이나 의식에서 사용되던 물건 같습니다. 물론 돌 해골보다는 값진 물건입니다.
$ITM_A_SKULL_3	흑요석 해골	흑요석 위에 해골을 세심하게 새긴 물건으로, 그 세세한 묘사가 소름이 끼칠 정도입니다. 구하기가 극도로 어렵기 때문에 수집가들 사이에서는 눈에 불을 켜고 찾는 물건이라고 합니다.
$ITM_A_SKULL_4	은 해골	이 해골은 순은으로 만들어졌습니다. 어디다 쓰겠어요?
$ITM_A_SKULL_5	금 해골	이 해골은 순금으로 만들어졌습니다. 어디다 쓰겠어요?
$ITM_A_SKULL_6	언옵티늄 해골	오직 언옵티늄으로 만들어진 해골이기 때문에, 얻기란 불가능합니다. 그런데 희한하게도 지금까지 잘도 들고 다니셨군요. 지금 눈치채셨죠.
$ITM_W_SWORD_1	돌 칼날	날카로운 돌에 나무 손잡이를 덧붙였습니다. 없는 것보단 낫습니다.
$ITM_W_SWORD_2	금속 칼날	고철로 만든 칼이지만, 효과는 좋습니다.
$ITM_W_SWORD_3	녹슨 칼	녹슬어 못쓰게 된 칼입니다. 이런 칼은 굴에서 동전 몇 닢 정도 밖에 안됩니다.
$ITM_W_SWORD_4	유혈 복수의 코팔	이 유목민 전투단검은 가스타부족의 상징이 피의 원수가 된 라이벌 부족의 상징 위에 자리 잡고 있습니다. 뼈로 만들어진 손잡이에는 17명을 살해했다는 표시가 새겨져 있습니다.
$ITM_W_SWORD_5	철검	단순한 철검입니다. 균형이 잘 잡혀있지 않고, 조잡하게 만들어져 있지만, 상태는 좋습니다.
$ITM_W_SWORD_6	명예의 증명	퀘이드의 결투용 검으로, 옥으로 화려하게 장식된 폼멜과 힐트는 검 본연의 잔인한 기능을 잊게 할 정도입니다. 검날에는 다음과 같은 문구가 새겨져 있습니다. ""명예의 증명이라. 내 안의 불꽃이 타오른다."" 아마 불명예스러운 일에 휘말린 귀족들의 결투에 사용하기 위해서 만들어진 것으로 생각됩니다.
$ITM_W_SWORD_7	병사의 검	전쟁 중 대량 생산된 군용 검입니다. 효과적이고 강력합니다.
$ITM_W_SWORD_8	질서의 칼날	애쉬에서 만들어진 검으로, 검날에 다음과 같은 문구가 새겨져 있습니다. ""나는 곧 질서의 칼날이라. 선으로 악을 베고, 빛으로 어둠을 벤다. 내가 이끄는 손이 곧 나를 죽..."" 세월의 손길은 나머지 문장을 희미하게 만들어 버렸습니다.
$ITM_W_SWORD_9	장교의 검	또 다른 전쟁의 잔여물입니다, 장교를 위해 손수 제작되었습니다.
$ITM_W_SWORD_10	군단의 지휘관	간단하지만 우아한 이 애쉬의 무기는 겸손한 귀족들을 위해 만들어졌습니다. 손잡이의 한 쪽에는 '군단의 지휘관'이라는 글귀가 새겨져 있고, 반대쪽에는 '부동의 원동자의 봉사자'라는 글귀가 새겨져 있습니다. 둥그런 칼의 자루 끝의 한편에는 *천상계의 영역이, 다른 한편에는 순례자가 애쉬 사원의 샘을 마시는 그림이 새겨져 있습니다.
$ITM_W_SWORD_11	달인의 검	전문적으로 균형 있게 주조되었습니다. 이보다 좋은 검은 알려져 있지 않습니다.
$ITM_W_SWORD_12	불꽃의 눈	비할 데 없이 완벽한 검으로, 그 검신에는 고대 퀘이드어 문구가 빽빽이 새겨져 있습니다. 너무도 오래전에 쓰인 고어이기 때문에 알아볼 수 있는 것은 다음 문구 정도밖에 없습니다. ""두려워하라... 불꽃의 눈... 영광... 졸렬하게 도망칠지어다...  실로 왕에게 어울릴..."" 폼멜에 박힌 두 개의 거대한 루비는 마치 그 안에서 영원한 불꽃이 타오르는 것처럼 보입니다. 장인의 손길이 거친 힐트에는 추모의 벽, 곧 역대 퀘이드 황제들의 이름이 차례로 새겨져 있습니다. 눈길을 사로잡는 이 검은 아마 왕가의 일원들이 사용하던 검으로 보입니다.
$ITM_W_SWORD_13	에브니	광전사의 꿈의 검입니다. 세상에 하나밖에 없기 때문에 가격은 때에 따라 적절히 형성됩니다.
$ITM_W_SWORD_14	유혈 복수의 코팔+	이 유목민 전투단검은 가스타 부족의 상징이 피의 원수가 된 라이벌 부족의 상징 위에 자리 잡고 있습니다. 뼈로 만들어진 손잡이에는 17명을 살해했다는 표시가 새겨져 있습니다.
$ITM_W_SWORD_15	명예의 증명+	퀘이드의 결투용 검으로, 옥으로 화려하게 장식된 폼멜과 힐트는 검 본연의 잔인한 기능을 잊게 할 정도입니다. 검날에는 다음과 같은 문구가 새겨져 있습니다. ""명예의 증명이라. 내 안의 불꽃이 타오른다."" 아마 불명예스러운 일에 휘말린 귀족들의 결투에 사용하기 위해서 만들어진 것으로 생각됩니다.
$ITM_W_SWORD_16	질서의 칼날+	애쉬에서 만들어진 검으로, 검날에 다음과 같은 문구가 새겨져 있습니다. ""나는 곧 질서의 칼날이라. 선으로 악을 베고, 빛으로 어둠을 벤다. 내가 이끄는 손이 곧 나를 죽..."" 세월의 손길은 나머지 문장을 희미하게 만들어 버렸습니다.
$ITM_W_SWORD_17	군단의 지휘관+	간단하지만 우아한 이 애쉬의 무기는 겸손한 귀족들을 위해 만들어졌습니다. 손잡이의 한 쪽에는 '군단의 지휘관'이라는 글귀가 새겨져 있고, 반대쪽에는 '부동의 원동자의 봉사자'라는 글귀가 새겨져 있습니다. 둥그런 칼의 자루 끝의 한편에는 *천상계의 영역이, 다른 한편에는 순례자가 Ash 사원의 샘을 마시는 그림이 새겨져 있습니다.
$ITM_W_SWORD_18	불꽃의 눈+	비할 데 없이 완벽한 검으로, 그 검신에는 고대 퀘이드어 문구가 빽빽이 새겨져 있습니다. 너무도 오래전에 쓰인 고어이기 때문에 알아볼 수 있는 것은 다음 문구 정도밖에 없습니다. ""두려워하라... 불꽃의 눈... 영광... 졸렬하게 도망칠지어다...  실로 왕에게 어울릴..."" 폼멜에 박힌 두 개의 거대한 루비는 마치 그 안에서 영원한 불꽃이 타오르는 것처럼 보입니다. 장인의 손길이 거친 힐트에는 추모의 벽, 곧 역대 Quaid 황제들의 이름이 차례로 새겨져 있습니다. 눈길을 사로잡는 이 검은 아마 왕가의 일원들이 사용하던 검으로 보입니다.
$ITM_W_SWORD_19	에브니+	광전사의 꿈의 검입니다. 세상에 하나밖에 없기 때문에 가격은 때에 따라 적절히 형성됩니다.
$ITM_W_SWORD_20	돌 칼날+	날카로운 돌에 나무 손잡이를 덧붙였습니다. 없는 것보단 낫습니다. 강화되었습니다
$ITM_W_SWORD_21	금속 칼날+	고철로 만든 칼이지만, 효과는 좋습니다. 강화되어 더 날카로워졌습니다..
$ITM_W_SWORD_22	녹슨 칼+	녹슬어 못쓰게 된 칼입니다. 이런 칼은 굴에서 동전 몇 닢 정도 밖에 안됩니다. 강화되어 더 날카로워졌습니다.
$ITM_W_SWORD_23	철검+	단순한 철검입니다. 균형이 잡혀있지 않고, 조잡하게 만들어져 있지만, 상태는 좋습니다. 강화되어 더 날카로워졌습니다.
$ITM_W_SWORD_24	병사의 검+	전쟁 중 대량 생산된 군용 검입니다. 효과적이고 강력합니다. 강화를 통해 보통 검보다 더욱 날카로워졌습니다.
$ITM_W_SWORD_25	장교의 검+	또 다른 전쟁의 잔여물입니다, 장교를 위해 손수 제작되었습니다. 강화를 통해 보통 검보다 더욱 날카로워졌습니다.
$ITM_W_SWORD_26	달인의 검+	전문적으로 균형 있게 주조되었습니다. 이보다 좋은 검은 알려져 있지 않습니다. 강화를 통해 보통 검보다 더욱 날카로워졌습니다.
$ITM_W_BOW_1	초록 활	묘목으로 만들어져 나무 화살을 갖춘 단순한 활입니다.
$ITM_W_BOW_2	나무 활	나무로 만들어져 돌촉 화살을 갖춘 활입니다.
$ITM_W_BOW_3	전투 사냥꾼	이 유목민 사냥 활은 전쟁용으로도 쓰였습니다. '죽음'을 의미하는 문양 위에 '좋은 사냥'을 뜻하는 유목 문양이 덧칠해져있습니다. 활 안쪽에는 잘린 머리를 들고 선 스데카족의 신에 대한 묘사가 있습니다. 끝 부분에 붉은 승리의 줄무늬는 이 무기가 오래전 잊혀진 전투에서 많이 사용됬음을 암시합니다.
$ITM_W_BOW_4	사냥꾼의 활	주목나무로 만들어져 돌촉 화살을 갖춘 튼튼한 활입니다.
$ITM_W_BOW_5	북쪽의 유물	이 훌륭한 사냥 활은 순수 흰 자작나무로 만들어졌습니다. 파란 가죽 손잡이는 금사로 감싸져있습니다. 그리고 이상한 글이 끝에 감겨있습니다. - 아마 북쪽 도시국가의 여러 언어 중 하나겠지요. 케드족의 문양이 한쪽에 새겨져 있습니다. 이 무기가 그 부족과 함께 남쪽으로 여행을 했다는 걸 암시합니다.
$ITM_W_BOW_6	사슴뿔 활	사슴 뿔로 만들어진 강력한 활입니다.
$ITM_W_BOW_7	대장의 활	이 애쉬제 활은 희귀한 나무를 층층이 붙여 만들어졌습니다. 손잡이에는 회전 장치가 있고 금에 글자가 새겨져 있습니다. 읽어보면, 대장 잔티몬, 길목의 방어자, 도적들과 노매드 침입자들로부터 애쉬 사원 순례자들을 지켰던 수많은 경비대 중 하나의 대장의 이름입니다.
$ITM_W_BOW_8	큰사슴 벌레 활	큰 사슴 벌레의 뿔로 만들어진 고대의 활입니다.
$ITM_W_BOW_9	지도자의 승리	이 훌륭하게 깎인 뒤로 휜 활은 황금 고리와 밝게 염색된 가죽으로 장식되어 있습니다. 무늬가 새겨진 손잡이는 승리한 지도자가 살육한 적들의 산 위에 서있는 모습을 묘사하고 있습니다. 몇몇 알 수 없는 신들이 위에서 그를 축복하고 있습니다. 이 무기는 부유하고 성공한 노매드 족장의 것이었음이 분명합니다.
$ITM_W_BOW_10	합성 궁	여러 종류의 나무들로 만들어진 이 합성 궁은 장교의 것으로 추정됩니다.
$ITM_W_BOW_11	호화스러운 죽음	뿔로 만들어진 끝을 지닌 이 활은 수많은 황금 고리로 장식되어 있습니다. 가죽 손잡이에는 구 퀘이드 언어의 설명이 적혀있습니다. ""루카완, 저속한 황금에 명예를 버린 자여, 이 무기의 황금 속에 너의 죽음이 보인다. 이 화살은 너를 찾을 것이고 네 배반의 시체는 개와 벌레들의 장난감이 될 것이다."" 그 아래에는 가죽의 흠집에는 ""처단되었다."" 라고 적혀있습니다.
$ITM_W_BOW_12	강화된 장궁	단단한 오크나무로 만들어진 이 활은 당기는데 엄청난 힘이 들지만 가능한 이들에게는 치명적인 사격을 선사합니다.
$ITM_W_BOW_13	전투 사냥꾼+	이 유목민 사냥 활은 전쟁용으로도 쓰였습니다. '죽음'을 의미하는 문양 위에 '좋은 사냥'을 뜻하는 유목 문양이 덧칠해져있습니다. 활 안쪽에는 잘린 머리를 들고 선 스데카족의 신에 대한 묘사가 있습니다. 끝 부분에 붉은 승리의 줄무늬는 이 무기가 오래전 잊혀진 전투에서 많이 사용되었음을 암시합니다.
$ITM_W_BOW_14	북쪽의 유물+	이 훌륭한 사냥활은 순수 흰 자작나무로 만들어졌습니다. 파란 가죽 손잡이는 금사로 감싸져있습니다. 그리고 이상한 글이 끝에 감겨있습니다. - 아마 북쪽 도시국가의 여러 언어 중 하나겠지요. 케드족의 문양이 한쪽에 새겨져 있습니다. 이 무기가 그 부족과 함께 남쪽으로 여행을 했다는 걸 암시합니다.
$ITM_W_BOW_15	대장의 활+	이 애쉬제 활은 희귀한 나무를 층층이 붙여 만들어졌습니다. 손잡이에는 회전 장치가 있고 금에 글자가 새겨져 있습니다. 읽어보면, 대장 잔티몬, 길목의 방어자, 도적들과 노매드 침입자들로부터 애쉬 사원 순례자들을 지켰던 수많은 경비대 중 하나의 대장의 이름입니다.
$ITM_W_BOW_16	지도자의 승리+	이 훌륭하게 깎인 뒤로 휜 활은 황금 고리와 밝게 염색된 가죽으로 장식되어 있습니다. 무늬가 새겨진 손잡이는 승리한 지도자가 살육한 적들의 산 위에 서있는 모습을 묘사하고 있습니다. 몇몇 알 수 없는 신들이 위에서 그를 축복하고 있습니다. 이 무기는 부유하고 성공한 노매드 족장의 것이었음이 분명합니다.
$ITM_W_BOW_17	호화스러운 죽음+	뿔로 만들어진 끝을 지닌 이 활은 수많은 황금 고리로 장식되어 있습니다. 가죽 손잡이에는 구 퀘이드 언어의 설명이 적혀있습니다. ""루카완, 저속한 황금에 명예를 버린 자여, 이 무기의 황금 속에 너의 죽음이 보인다. 이 화살은 너를 찾을 것이고 네 배반의 시체는 개와 벌레들의 놀잇거리가 될 것이다."" 그 아래에는 가죽의 흠집에는 ""처단되었다.""라고 적혀있습니다.
$ITM_W_BOW_18	초록 활+	묘목으로 만들어져 나무 화살을 갖춘 단순한 활입니다. 강화되어 더 강력해졌습니다.
$ITM_W_BOW_19	나무 활+	나무로 만들어져 돌촉 화살을 갖춘 활입니다. 강화되어 더 강력해졌습니다.
$ITM_W_BOW_20	사냥꾼의 활+	주목나무로 만들어져 돌촉 화살을 갖춘 튼튼한 활입니다. 강화되어 더 강력해졌습니다.
$ITM_W_BOW_21	사슴뿔 활+	사슴뿔로 만들어진 강력한 활입니다. 강화되어 더 강력해졌습니다.
$ITM_W_BOW_22	큰사슴 벌레 활+	큰사슴 벌레의 뿔로 만들어진 고대의 활입니다. 강화되어 더 강력해졌습니다.
$ITM_W_BOW_23	합성 궁+	여러 종류의 나무들로 만들어진 이 합성 궁은 장교의 것으로 추정됩니다. 강화되어 더 강력해졌습니다.
$ITM_W_BOW_24	강화된 장궁+	단단한 오크나무로 만들어진 이 활은 당기는데 엄청난 힘이 들지만 가능한 이들에게는 치명적인 사격을 선사합니다. 강화되어 더 강력해졌습니다.
$ITM_W_STAFF_1	지팡이	튼튼한 막대기입니다.
$ITM_W_STAFF_2	양치기의 지팡이	단순한 양치기의 지팡이입니다.
$ITM_W_STAFF_3	사기꾼의 지팡이	이 공들여 깎은 지팡이는 손잡이 주변에 이상한 글로 장식되어 있습니다. 자세히 보면 그저 중얼거림이고 글을 읽지 못하는 사람들을 속이기 위한 용도입니다. 지팡이의 끝에는 색 연기와 한때 카나리아였을 것을 담기 위한 빈 공간 몇 개가 존재합니다.
$ITM_W_STAFF_4	오크나무 지팡이	튼튼한 가죽 손잡이가 달린 잘 다듬어진 오크나무 지팡이입니다.
$ITM_W_STAFF_5	대양 치기의 지팡이	이 튼튼한 지팡이에는 퀘이드, 애쉬, 노매드와 알 수 없는 다양한 지역의 방언들로 쓰인 부적들이 붙어있습니다. 지팡이의 머리 부분에는 퀘이드 언어로 ""양의 지배자, 창고의 수호자""라고 쓰여있습니다. 사막 문양의 보석은 그 아래에 있어 운 나쁜 소유자가 도시 아래에서 포악한 양을 관리해야 했음을 보여줍니다. 지팡이의 끝 부분에는 수백 개의 이빨자국이 나있고 몇몇 이빨은 나무 표면에 박혀있습니다.
$ITM_W_STAFF_6	몽둥이	무게를 늘리기 위해 한쪽 끝을 파 납을 넣은 단단한 오크나무 지팡이입니다.
$ITM_W_STAFF_7	야수의 무기	이 놀라운 지팡이는 하나의 상아로 만들어졌습니다. 이 정도의 뿔을 가진 괴물은 정말 두려움 그 자체입니다. 지팡이의 길이만큼 새겨진 조각들은 이름 모를 영웅의 이야기를 담고 있습니다. 애쉬, 노매드, 퀘이드 어느 쪽의 주제에도 속하지 않고 알아볼 만한 단어도 없기에 조각가와 괴물의 정체는 신비에 싸여있습니다.
$ITM_W_STAFF_8	철 나무 지팡이	무척 희귀한 나무로 만들어진 훌륭한 지팡이입니다.
$ITM_W_STAFF_9	사형집행자의 몽둥이	이 커다란 지팡이는 철로 감싸져있고 한쪽 끝은 휘두를 때 탄력을 더하기 위해 속을 파 납으로 채워졌습니다. 이상한 에칭화들이 금속 표면을 장식하고 있습니다. 언어는 알 수 없지만 아마 북쪽에서 많이 쓰이는 말일 것입니다. 해골 아래 놓인 교차된 열쇠는 아마 간수나 사형집행자 등 칼이 어울리지 않는 인원들의 권위를 나타내고 있습니다. 휘두르는 쪽에 얼룩진 피는 그 권위가 자주 행사되었음을 보여줍니다.
$ITM_W_STAFF_10	철 도금 지팡이	이 튼튼한 지팡이는 긴 철판으로 보강되어있습니다.
$ITM_W_STAFF_11	불꽃 지킴이	이 은도금된 지팡이는 수 세대를 거치며 변색되었습니다. 적게 훼손된 부분에는 오래된 퀘이드 글자가 쓰여있습니다. 하지만  어두워진 은과 방언의 연대로 인해 대부분은 판독할 수가 없습니다. 그중 ""불꽃을 잡는 자""라는 구절과 ""황홀... 소모""라는 말이  수차례 반복되고 있습니다. 지팡이의 양 끝은 탄 흔적이 쌓여 새까맣게 되었기에 퀘이드 제국의 불의 의식에 쓰였다는 추측이 가능합니다.
$ITM_W_STAFF_12	순례자의 지팡이	셀리니 수도승들이 여행자들에게 주는 수많은 지팡이 중의 하나입니다. 손잡이는 철판으로 감싸져있고 나무 표면에는 기도문이 새겨져 있습니다.
$ITM_W_STAFF_13	코조몬의 권장	이 투박한 오크나무 지팡이는 애쉬 지역의 오래된 방언으로 코조몬 카스텐킴이란 이름을 가지고 있습니다. 그것은 셀레나드의 첫 제자의 물건이라는 의미입니다. 이 유물은 사제단 회의장이 퀘이드인 전쟁 말기에 약탈당하며 소실되었다고 여겨졌습니다. 권장을 장식하던 보석과 황금은 오래전에 벗겨졌지만 권장 자체는 손상되지 않았습니다. 수 세기 동안의 숭배와 몇 번의 화재가 원목을 칠흑에 가깝게 만들었지만 아직도 원래의 힘을 가지고 있습니다.
$ITM_W_STAFF_14	사기꾼의 지팡이+	이 공들여 깎은 지팡이는 손잡이 주변에 이상한 글로 장식되어 있습니다. 자세히 보면 그저 중얼거림이고 글을 읽지 못하는 사람들을 속이기 위한 용도입니다. 지팡이의 끝에는 색 연기와 한때 카나리아였을 것을 담기 위한 빈 공간 몇 개가 존재합니다.
$ITM_W_STAFF_15	대양 치기의 지팡이+	이 튼튼한 지팡이에는 퀘이드, 애쉬, 노매드와 알 수 없는 다양한 지역의 방언들로 쓰인 부적들이 붙어있습니다. 지팡이의 머리 부분에는 퀘이드 언어로 ""양의 지배자, 창고의 수호자""라고 쓰여있습니다. 사막 문양의 보석은 그 아래에 있어 운 나쁜 소유자가 도시 아래에서 포악한 양을 관리해야 했음을 보여줍니다. 지팡이의 끝 부분에는 수백 개의 이빨자국이 나있고 몇몇 이빨은 나무 표면에 박혀있습니다.
$ITM_W_STAFF_16	야수의 무기+	이 놀라운 지팡이는 하나의 상아로 만들어졌습니다. 이 정도의 뿔을 가진 괴물은 정말 두려움 그 자체입니다. 지팡이의 길이만큼 새겨진 조각들은 이름 모를 영웅의 이야기를 담고 있습니다. 애쉬, 노매드, 퀘이드 어느 쪽의 주제에도 속하지 않고 알아볼 만한 단어도 없기에 조각가와 괴물의 정체는 신비에 싸여있습니다.
$ITM_W_STAFF_17	사형집행자의 몽둥이+	이 커다란 지팡이는 철로 감싸져있고 한쪽 끝은 휘두를 때 탄력을 더하기 위해 속을 파 납으로 채워졌습니다. 이상한 에칭화들이 금속 표면을 장식하고 있습니다. 언어는 알 수 없지만 아마 북쪽에서 많이 쓰이는 말일 것입니다. 해골 아래 놓인 교차된 열쇠는 아마 간수나 사형집행자 등 칼이 어울리지 않는 인원들의 권위를 나타내고 있습니다. 휘두르는 쪽에 얼룩진 피는 그 권위가 자주 행사되었음을 보여줍니다.
$ITM_W_STAFF_18	불꽃 지킴이+	이 은도금된 지팡이는 수 세대를 거치며 변색되었습니다. 적게 훼손된 부분에는 오래된 퀘이드 글자가 쓰여있습니다. 하지만  어두워진 은과 방언의 연대로 인해 대부분은 판독할 수가 없습니다. 그중 ""불꽃을 잡는 자""라는 구절과 ""황홀... 소모""라는 말이 수차례 반복되고 있습니다. 지팡이의 양 끝은 탄 흔적이 쌓여 새까맣게 되었기에 퀘이드 제국의 불의 의식에 쓰였다는 추측이 가능합니다.
$ITM_W_STAFF_19	코조몬의 권장+	이 투박한 오크나무 지팡이는 애쉬 지역의 오래된 방언으로 코조몬 카스텐킴이란 이름을 가지고 있습니다. 그것은 셀레나드의 첫 제자의 물건이라는 의미입니다. 이 유물은 사제단 회의장이 퀘이드인 전쟁 말기에 약탈당하며 소실되었다고 여겨졌습니다. 권장을 장식하던 보석과 황금은 오래전에 벗겨졌지만 권장 자체는 손상되지 않았습니다. 수 세기 동안의 숭배와 몇 번의 화재가 원목을 칠흑에 가깝게 만들었지만 아직도 원래의 힘을 가지고 있습니다.
$ITM_W_STAFF_20	지팡이+	튼튼한 막대기입니다. 강화되어 더 강력해졌습니다.
$ITM_W_STAFF_21	양치기의 지팡이+	단순한 양치기의 지팡이입니다. 강화되어 더 강력해졌습니다.
$ITM_W_STAFF_22	오크나무 지팡이+	튼튼한 가죽 손잡이가 달린 잘 다듬어진 오크나무 지팡이입니다. 강화되어 더 강력해졌습니다.
$ITM_W_STAFF_23	몽둥이+	무게를 늘리기 위해 한쪽 끝을 파 납을 넣은 단단한 오크나무 지팡이입니다. 강화되어 더 강력해졌습니다.
$ITM_W_STAFF_24	철 나무 지팡이+	무척 희귀한 나무로 만들어진 훌륭한 지팡이입니다. 강화되어 더 강력해졌습니다.
$ITM_W_STAFF_25	철 도금 지팡이+	이 튼튼한 지팡이는 긴 철판으로 보강되어있습니다. 강화되어 더 강력해졌습니다.
$ITM_W_STAFF_26	순례자의 지팡이+	셀리니 수도승들이 여행자들에게 주는 수많은 지팡이 중의 하나입니다. 손잡이는 철판으로 감싸져있고 나무 표면에는 기도문이 새겨져 있습니다. 강화되어  더 강력해졌습니다.
$ITM_W_BOOK_1	충격 번개	번개가 적들에게 충격을 주고 잠시 마비시킵니다.
$ITM_W_BOOK_2	연쇄 번개	번개 사용 시 번개에 부여한 포인트만큼 추가적인 적을 공격합니다. 연쇄될 때 위력은 점점 감소합니다.
$ITM_W_BOOK_3	맹렬한 시작	새로 소환된 방어자들은 광분 효과를 얻습니다.
$ITM_W_BOOK_4	맹렬한 끝	체력이 1/4 이하인 방어자들은 광분 효과를 얻습니다.
$ITM_W_BOOK_5	심판의 빛	치유를 사용 시 모든 적을 실명 시킵니다.
$ITM_W_BOOK_6	영광의 빛	치유를 사용 시 모든 적에게 빛이 적용됩니다.
$ITM_W_BOOK_7	느린 시작	새로 나타난 적은 잠시 동안 느려지게 됩니다.
$ITM_W_BOOK_8	느린 끝	$MCG에게 접근하는 적은 느려지게 됩니다.
$ITM_W_BOOK_9	수정 지대	$MCG이(가) 약간의 수정에 둘러싸인 채 레벨을 시작합니다.
$ITM_W_BOOK_10	정신력 실드	$MCG이(가) 공격받을 때 HP 대신 정신력이 감소합니다. 수정 주문에 포인트를 부여할수록 더 적은 정신력이 소모됩니다.
$ITM_W_BOOK_11	폭발적인 시작	방어자를 소환하거나 부스트 시킬 때 작은 폭발이 일어납니다.
$ITM_W_BOOK_12	폭발적인 끝	방어자가 패배하면 작은 폭발이 일어납니다.
$ITM_W_BOOK_13	역병의 책	$MCG을(를) 제외한 모든 방어자는 자연치유되지 않고 보스를 제외한 모든 적은 계속 중독 상태가 됩니다.<N><N>아마 다음 모험에 가져가는 게 좋을 겁니다.
$ITM_W_BOOK_14	피의 책	$MCG 와 보스를 제외한 모든 방어자와 적들은 계속 출혈 상태가 됩니다.<N><N>아마 다음 모험에 가져가는 게 좋을 겁니다.
$ITM_W_BOOK_15	공동 상승의 책	얼음, 물, 불은 더 이상 상쇄되지 않습니다.<N><N>아마 다음 모험에 가져가는 게 좋을 겁니다.
$ITM_W_BOOK_16	잊힌 협곡	이 책은 마법 능력이 없는 자서전입니다. 전염병에서 살아남았으나 역병 지대에 갇힌 젊은 애쉬 사서의 이야기가 담겨 있습니다. 일지처럼 쓰여있고 숯, 차, 녹즙, 피 등으로 쓰인 많은 그림들이 그려져있습니다.<N><N>아마 다음 모험에 가져가는 게 좋을 겁니다.
$ITM_W_BOOK_17	대담함의 책	방어자들이 전투에서 한번 패하거나 복귀한 경우 다시 소환될 수 없습니다.
$ITM_W_BOOK_18	침묵의 책	$MCG이(가) 전투에서 주문을 사용하지 못 합니다.
$ITM_W_BOOK_19	모습의 책	극한 도전에서만 사용 가능:<N><N>적들은 때때로 그들의 상태를 새로운 모습으로 바꿉니다. 꽤 이상하군요.
$ITM_W_BOOK_20	익명의 책	극한 도전에서만 사용 가능:<N><N>방어자들이 익명이 됩니다. +3%의 회피 기회와 트롤에게 2배의 피해를 줍니다.
$ITM_W_BOOK_21	비밀의 책	책에 귀를 기울이면 부드러운 속삭임이 들려옵니다.<N><N>아마 다음 모험에 가져가는 게 좋을 겁니다.