flag	content
$ENTRY_JOURNAL_INDEX_TITLE	목차
$ENTRY_JOURNAL_INDEX_LEFT_00	일지 목록
$ENTRY_JOURNAL_INDEX_LEFT_10	Day 1: @여긴 대체 어디지?@
$ENTRY_JOURNAL_INDEX_LEFT_20	Night 1: @[berserker_hero]@
$ENTRY_JOURNAL_INDEX_LEFT_30	Day 3: @부록@
$ENTRY_JOURNAL_INDEX_LEFT_40	Night 3: @부록@
$ENTRY_JOURNAL_INDEX_LEFT_50	Day 3: @감옥@
$ENTRY_JOURNAL_INDEX_LEFT_60	Day 4: @연옥 세계@
$ENTRY_JOURNAL_INDEX_LEFT_70	Day 5: @[ranger_hero]@
$ENTRY_JOURNAL_INDEX_LEFT_80	Day 8: @부록@
$ENTRY_JOURNAL_INDEX_LEFT_90	Night 7: @카르스크	 불타다.@
$ENTRY_JOURNAL_INDEX_LEFT_100	Day 8: @렉세스@
$ENTRY_JOURNAL_INDEX_LEFT_110	Day 9: @[mcguffin_hero]@
$ENTRY_JOURNAL_INDEX_LEFT_120	Day 10: @오미잘의 죽음@
$ENTRY_JOURNAL_INDEX_LEFT_130	NIght 10: @수도원@
$ENTRY_JOURNAL_INDEX_LEFT_140	Day 11: @[healer_hero]@
$ENTRY_JOURNAL_INDEX_LEFT_150	Day 13: @[mage_hero]@
$ENTRY_JOURNAL_INDEX_LEFT_160	Day 14: @유목민@
$ENTRY_JOURNAL_INDEX_LEFT_170	Day 15: @낯선 꿈@
$ENTRY_JOURNAL_INDEX_RIGHT_00	Day 17: @사막의 보석@
$ENTRY_JOURNAL_INDEX_RIGHT_10	Day 18: @[knight_hero]@
$ENTRY_JOURNAL_INDEX_RIGHT_20	Day 19: @[knight_hero]의 편지@
$ENTRY_JOURNAL_INDEX_RIGHT_30	Night 19: @답장 : 후보 1@
$ENTRY_JOURNAL_INDEX_RIGHT_40	Day 20: @[knight_hero_pos]답장@
$ENTRY_JOURNAL_INDEX_RIGHT_50	Day 21: @[knight_hero_up]<RQ>의 편지@
$ENTRY_JOURNAL_INDEX_RIGHT_60	Night 21: @[berserker_hero] 녀석은 이 글을 보라@
$ENTRY_JOURNAL_INDEX_RIGHT_70	Night 22: @[dragon_hero]@
$ENTRY_JOURNAL_INDEX_RIGHT_80	Day 24: @부록@
$ENTRY_JOURNAL_INDEX_RIGHT_90	Day 25: @두 번째 꿈@
$ENTRY_JOURNAL_INDEX_RIGHT_100	Day 28: @젤레마의 죽음@
$ENTRY_JOURNAL_INDEX_RIGHT_110	Day 29: @세 번째 꿈@
$ENTRY_JOURNAL_INDEX_RIGHT_120	Day 35: @에즈티의 왕좌@
$ENTRY_JOURNAL_INDEX_RIGHT_130	Day 37: @틀레틀-메즈틀리@
$ENTRY_JOURNAL_INDEX_RIGHT_140	Day 39: @탈출?@
$ENTRY_JOURNAL_INDEX_RIGHT_150	Day 40: @젤레마를 따라@
$ENTRY_JOURNAL_INDEX_RIGHT_160	@후일담@
$ENTRY_JOURNAL_INTRO_TITLE	 
$ENTRY_JOURNAL_INTRO_LEFT_00	첫 번째 날 - 여긴 대체 어디지?
$ENTRY_JOURNAL_INTRO_LEFT_10	아마도 난 미쳐버린 것 같다. 하지만 내 눈앞에서 일어난 일들에 대해 기록은 해 둬야겠지. 판단은 이 글을 읽는 사람이 할 것이고	 나는 그저 내 병든 마음이 이해한 대로 사건을 기록할 것이다.<N>분명한 사실은	 나는 우리의 수도를 뒤덮은 역병에 걸렸으며 또한 이전의 다른 감염자들처럼 도시 밖으로 끌려나가 구덩이에 던져졌다는 것이다. 그곳에서 나는 아직도 꿈이 아니었을까 생각할 정도로 기이하고 공포스러운 사건들을 겪었다.<N>역병이 내 정신을 앗아갔고	 정신을 차렸을 때엔 어떤 어두운 장소에 서 있었다. 내 앞에는 또 다른 희생자가 있었다.
$ENTRY_JOURNAL_INTRO_RIGHT_00	그곳에 휘황찬란한 옥좌가 나타났고	 거기에는 내가 이전에 보지 못한 한 남자가 앉아있었다. 그는 머리부터 발끝까지 황금으로 이루어져 있었다. 나는 처음에는 그를 조각상으로 착각했지만	 곧 그는 자비로운 한마디 명령을 던졌다.<N>그의 목소리 역시 황금과도 같았으며 말 끝마디는 마치 천둥처럼 울려 퍼졌다. 그의 말은 내가 애쉬 왕국의 대 도서관에서도 한 번도 듣도 보도 못한 언어로 되어 있었지만	 내 몸은 그 명령에 반응했다. 내 피들이 내 몸을 뚫고 튀어나가 그와 하나가 될 것처럼 혈관 속에서 꿈틀거렸다. 지금도 그 생각을 하기만 하면 심장이 벅차오른다.<N> - [mcguffin_hero] 리브바
$ENTRY_JOURNAL_SLAK_TITLE	 
$ENTRY_JOURNAL_SLAK_LEFT_0_00	첫 번째 밤 - [berserker_hero]
$ENTRY_JOURNAL_SLAK_LEFT_0_10	[berserker_hero]에 대해 써보자면	 일단 수도에서 쓰던 고상한 말투는 제쳐두고 약간 투박한 어휘들을 사용해야 더 정확할 것 같다. <N>[berserker_hero] 놈은 개병신이다. 그냥 병신인데 성질은 개 같다고.<N>대가리엔 든 게 없는 놈이 냄새는 또 오질 나게 풍긴다. 말똥 두 무더기가 불타는 교미를 벌여서 자식을 낳는다면	 그 애새끼한테서 풍기는 썩는 냄새가 그놈 겨드랑이 암내하고 비슷할 거다. 아니 진짜라니까. 지금 뒤에 졸졸 따라붙은 걸어 다니는 시체들 냄새는 그냥 향수로 느껴질 정도다···.<N>하지만 [berserker_hero]의 겉모습만으로 사람을 판단하는 것은 섣부른 일이다. 놈의 성격은 또 어찌나 완벽한지 <LQ>위아래도 못 알아보는 개차반이 따로 없다.<RQ><N>어제는 지 발가락에 채인 돌멩이랑 15분 동안 말싸움을 하는 것까지 봤다. 그것도 지더라.
$ENTRY_JOURNAL_SLAK_RIGHT_0_00	정말 저런 동료와 함께 여행한다는 것은 축복이 아닐 수 없다니까.
$ENTRY_JOURNAL_SLAK_RIGHT_0_10	세 번째 날 - 부록
$ENTRY_JOURNAL_SLAK_RIGHT_0_20	보다 공평한 평가를 위해 덧붙이자면	 내가 본 사람 중에 쟤가 가장 용감하단 사실은 인정해야겠다. 뭐 웃옷은 아무것도 걸치기 싫다고 버티던 걸 생각하면 조금 감동이 덜하긴 하지만	 저 애의 온몸은 전투에서 생긴 흉터로 뒤덮여 있다. 그러니까 요점은 이렇다고 - 저 애의 행실이 조금 별나긴 하지만	 한편으론 미친 듯이 잘 싸우는 전사이기도 하단 거야. 나도 인정하긴 싫지만	 쟤랑 같이 있으니 참 좋다.
$ENTRY_JOURNAL_SLAK_RIGHT_0_30	어우 야	 나도 사랑해! 뽀뽀 쪽쪽<N><N><N>난 안자는데 그냥 누워있는 거야 엉덩이에 좋거든
$ENTRY_JOURNAL_SLAK_RIGHT_0_40	세상에	 얘가 글자를 읽고 쓸 줄도 안다니! 이 피비린내 풍기는 떠돌이 전투광 녀석이 대체 어디서 교육을 받은 거지?<N><N><N>P.S. 또 내 일기를 훔쳐 보기만 해 봐	 너 자는 동안에 머리를 날려버린다.
$ENTRY_JOURNAL_SLAK_LEFT_1_00	세 번째 날 – 두 번째 부록
$ENTRY_JOURNAL_SLAK_LEFT_1_10	좋아	 이건 적어놔야겠어	 [berserker_hero] 놈은 다 벗고 잔다. 이제부터 일기의 복수는 웬만하면 낮에 하려고 노력해야겠다.<N>그리고 흉터는 상체에만 있는 게 아니더라.<N><N>너 진짜 싫어.
$ENTRY_JOURNAL_SLAK_LEFT_1_20	뭐야 네 생각엔 칸이랑 차리사도 싸우지 않을 거라 보는 거야?
$ENTRY_JOURNAL_PRISON_TITLE	 
$ENTRY_JOURNAL_PRISON_LEFT_0_00	세 번째 날 - 감옥
$ENTRY_JOURNAL_PRISON_LEFT_0_10	3일 전까지만 해도 이 구덩이를 감옥이라고 생각했다. 아무리 밑바닥을 쳐도 그 밑엔 지하가 있는 법인데.<N> 우리를 여기 가두어놓고 있는 자는 오지말 카즈라는 자인데	 그는 잔혹하고 비정한 기분 나쁜 인간이다. 어떻게 하면 일개 양민이 그렇게 돌이킬 수 없을 지경으로 뒤틀릴 수 있는지 도저히 이해하지 못하겠다.<N>차라리 동쪽 구석에서 20년 동안 복수만 꿈꾸던 퀘이드인 이라면 이해를 하겠다. 가장 잔혹한 유목민 족장의 분노도 저 타락한 인간의 그것에 비하면 애교 수준일 거야.<N>그리고 저 사람 말하는 억양을 들어보면 수도 출신이란 말이야! 어떻게 신전 밑에서 그런 괴물이 자라날 수가 있지?
$ENTRY_JOURNAL_PRISON_RIGHT_0_00	지금 내 주위에는 마구잡이로 잡혀온 다른 포로들도 같이 앉아있다. 산적들	 깡패들	 남자	 여자	 어린아이들	 애쉬인	 유목민	 퀘이드인 등등. 우리 모두는 다들 놈의 손에 죽을 운명만 기다리고 있는 것이다.<N>놈이 데리고 있는 망령들의 울부짖음이 밤낮을 가리지 않고 끊임없이 들려온다. 이는 희생자들이 죽어가면서 부르짖는 단말마와 섞여 끔찍한 불협화음으로 변한다. 그리고 난 여기 무력한 채 그저 앉아있을 뿐이다! 차라리 이 희망도 없는 사람들과 콜로세움에 서 있었다면 마지막으로 발악이나 해 볼 기회라도 있었겠지.<N>오지말의 허세로 볼 때	 놈이 날 죽이는 걸 망설이고 있다는 사실은 뻔하다. 어쩌면 나 하나 잡자고 너무 많은 망령을 낭비하는 건 아닐까 두려워하고 있을지도 몰라 - 어쨌든 그 족속들은 잡아와서 가둬놓는 데에 좀 많이 힘든 애완동물이니. 또 이 졸렬한 제국을 유지하려면 저 걸어 다니는 시체들도 꽤나 필요한 거니까.
$ENTRY_JOURNAL_PRISON_LEFT_1_00	내 마음속에서는 계속 알 수 없는 조력자의 목소리가 메아리치고 있다. 오지말은 내 실력을 붉은 옷을 입은 인간에게 보이고 싶다고 한다. 대체 그 붉은 옷을 입은 인간은 누구지? 그리고 이 조력자는 또 누구고	 왜 날 그렇게도 살리고 싶어 하는 걸까?<N>질문은 끊임없이 이어지지만	 한 가지는 확실하다. 내가 휘두르는 칼끝은 오직 시체들만을 향해 있지만	 일단 오지말을 잡을 기회가 온다면 이런 신념도 충분히 바뀔 수 있단 거지.
$ENTRY_JOURNAL_HALFWAY_WORLD_TITLE	 
$ENTRY_JOURNAL_HALFWAY_WORLD_LEFT_0_00	네 번째 날 - 연옥 세계
$ENTRY_JOURNAL_HALFWAY_WORLD_LEFT_0_10	<LQ>'연옥 세계'<RQ> 이란 이름이	 내가 찾아낸 이 해괴한 세계를 가장 잘 표현하는 말일 것이다.<N>내가 아주 어렸을 적에	 케벌의 웅덩이에 빠져죽을 뻔한 적이 있었다. 정말 어떤 경험과도 비교하지 못할 아찔한 순간이었다. 그때와 똑같은 공포와 숨막히는 고통이 나를 엄습한다. 심장이 가슴을 찢고 튀어나올 것만 같다. 하지만 이번에는 날 끌어내 줄 아버지의 손같은 건 없다. 기어나올 곳도 없고	 그저 영원처럼 느껴질 죽음의 순간 뿐이다.<N>여기에 어떻게 오게 되는지는 아직도 수수께끼다. 내가 알고 있는 것이라곤	 꼭 필요할 때 오게 된다는 것 뿐이지. 여기에 있어도 내 동료들이 있다는 것은 느낄 수 있다. 보이진 않지만	 뭐 내 팔다리는 꼭 눈으로 봐야 달려있다는 걸 아나 뭐.
$ENTRY_JOURNAL_HALFWAY_WORLD_RIGHT_0_00	그냥 거기 있으니 부르면 된다는 사실만 알고 있을 뿐이다. 그렇게 강력한 힘은 아니다	 아기가 몸을 뒤집는 수준에 불과하지만	 내 한 목숨 구하기엔 충분하다. 이 두렵기만 한 연옥 세계를 돌아다니는 동안에는	 분명히 없는 것보다는 나은 힘인 것이다.
$ENTRY_JOURNAL_KETTA_TITLE	 
$ENTRY_JOURNAL_KETTA_LEFT_0_00	다섯번째 날 - [ranger_hero]
$ENTRY_JOURNAL_KETTA_LEFT_0_10	내 생각에 [ranger_hero]한테서 가장 마음에 드는 점은	 얘한테서 염소 냄새가 난다는 것이다.<N>그럼 유아적인 성정이나 만물을 백안시하는 어법에 암담한 빈정거림	 손버릇도 부정한데다 식사 예절도 제대로 숙지하지 못한 사람과 텐트를 같이 써야 되는 상황인데	 불쾌한 염소 냄새쯤이야 저런 것들에 비하면 아주 양호한 특징이 되는 것이다.<N> 가끔씩 밤에 남자애들이 쓰는 캠프 쪽에서 바람이 불면	 [berserker_hero]의 독특한 체취가 바람에 실려 올 때가 있다. 두 냄새가 어우러진 향기란 그야말로 신이 내린 향수가 아닐 수 없다. 아무래도 요새 밤에 잠이 잘 오는 이유는	 내 생존본능이 저 냄새의 결정체를 계속 맡고 있느니 그냥 기절하는 쪽을 택하기 때문이 아닌지 싶다.
$ENTRY_JOURNAL_KETTA_RIGHT_0_00	여덟 번째 날
$ENTRY_JOURNAL_KETTA_RIGHT_0_10	어젯밤에는 [ranger_hero]이(가) 나한테 유목민 사투리로 떽떽거리는 통에 깨고 말았다. 대충 번역해 보자면 <LQ>청소도구 여자	 그 남자는 광산!<RQ>정도 되겠는데. 그러더니 내 머리카락을 무더기로 잡아뜯더니	 자기 베개 속에 꽉꽉 채우고는 도로 잠들었다.<N>어쨌든 평소답지 않게 사과는 하더라. 심지어 말갈기로 내 머리에 난 땜질을 가릴 가발까지 만들어서 주었다. 대체 어떤 꿈을 꾸었길래 잠꼬대가 그렇게 심했는지 이해가 가지 않는다고 변명은 했지만. 나도 그냥 이해가 안 간 척 했다.
$ENTRY_JOURNAL_AZRA_BY_SLAK_TITLE	 
$ENTRY_JOURNAL_AZRA_BY_SLAK_LEFT_0_00	열 번째 날 - [mcguffin_hero] 새끼는 병신인가
$ENTRY_JOURNAL_AZRA_BY_SLAK_LEFT_0_10	일기장에 고상한 단어만 적어놓으면 내 뒷담을 까도 뭔 말인지 못 알아먹을 줄 알았냐?<N>이건 어때	 공주님? 우리도 여기다 네 뒷담 까는 일기나 쓰지 뭐!<N>[mcguffin_hero_up]년은 대체 뭐라고 해야 될까? 얼굴은 존나게 홀쭉한 게 꼭 물고기 면상을 닮은 것 같나? 목은 또 쓸데없이 길어서 비율이 아주 망했어 그냥. <N> 귀는 무슨 말라비틀어진 살구처럼 생긴 것이	 머리모양은 병신 같은 게 질기긴 또 오질 나게 질겨요. 지도 그렇게 깨끗하지도 않은 주제에 깔끔은 또 어찌나 떠는지.
$ENTRY_JOURNAL_AZRA_BY_SLAK_RIGHT_0_00	기분이 어때	 썅년아? 이제 누가 진짜 내 편인지 알았네.<N><N>사랑을 담아서	<N>[ranger_hero_up] 똥이나 쳐드세요 [berserker_hero_up] 야 내 이름은 왜 이렇게 길어 쓰기가 힘들어?
$ENTRY_JOURNAL_KARSK_BURNED_TITLE	 
$ENTRY_JOURNAL_KARSK_BURNED_LEFT_0_00	일곱 번째 밤 - 카르스크	 불타다.
$ENTRY_JOURNAL_KARSK_BURNED_LEFT_0_10	내게 죽음이란 낯선 존재가 아니다. 전염병이 수도를 휩쓸었던 9개월은 나에게서 순진무구한 어린 시절 같은 물건은 깡그리 벗겨내기 충분했다. 하지만 이런 나라 할지라도 그렇게 잔혹한 광경은 본 적이 없었다. 신전의 문 밖에서 불타고 있던 시체들의 안색조차 창백해질 광경이었다. <N>말문이 막힌다.<N>이제야 우리가 어떤 적과 마주하고 있는지 이해하겠다.
$ENTRY_JOURNAL_LAKSOS_TITLE	 
$ENTRY_JOURNAL_LAKSOS_LEFT_0_00	여덟 번째 날 - 락소스
$ENTRY_JOURNAL_LAKSOS_LEFT_0_10	렉세스에서 유목민들의 희한한 의식을 보게 되었다. 카라다라는 작지만 명문 있는 부족에서	 족장님이 자식을 얻게 되었다. 아기의 부모들은 두 개의 거대한 나무 우상 앞에 아이를 내려놓고 있었다.<N>족장은 작은 나무토막을 꺼내더니	 우상의 머리와 아기의 머리에 한 번씩 얹어놓았다. 그러더니 작은 칼로 나무토막을 조각하기 시작했는데	 그 부스러기를 온통 아이의 얼굴에 흘리는 것이었다. 일련의 작업이 끝나자	 족장은 동물의 힘줄에 이 조각을 매더니 아기의 목에 걸어주었다 <N> 아기는 우렁차게 울기 시작했고	 부족민들은 전형적인 유목민 식의 가무로 이 아기를 축복했다. 족장이 무엇을 조각했는지는 보지 못 했다.
$ENTRY_JOURNAL_LAKSOS_RIGHT_0_00	나중에 [ranger_hero]에게 이 의식이 대체 무슨 의미를 가지는 것이냐고 묻자	 그 애는 자기 목에서 작은 나뭇조각 여우를 꺼내 보여주었다. 또 말하길	 자신의 영령이 자신이 섬기는 부족 신들의 하수인이며	 태어났을 때 수호자이자 인도자로써 받은 것이라 하였다. 또한 죽을 때도 함께 묻혀 낙원으로 가는 안전한 길을 인도해준다는 것이었다. 부족신들은 세대가 바뀔 때마다 창조주의 자리를 내놓기 때문에	 개개인이 받는 영령은 모두 다른 모습을 띠게 된다는 것이었다. <N>그렇다면 자신의 영령을 잃는다는 것은 부족의 우상을 잃는 것과 똑같은 비극이 되는 것이냐고 묻자	 [ranger_hero]의 얼굴에는 미소가 떠오르더니 예전에 적들에게서 빼앗아 온 7개의 영령들을 보여주며	 이제 그들의 영혼은 낙원으로 가는 길을 스스로 찾을 때까지 억겁의 시간을 헤매야 할 것이라고 설명했다. 이런 짓을 같은 부족민들에게 저지르면 어떻게 되냐고 묻자	 그 애는 멍한 표정으로 나를 바라보더니 내 귀는 얼굴에 참 안 어울리게 크다고 하면 기분이 나쁘냐고 되묻고는	 염소 혀 구워 먹는 노래를 부르며 걸어가버렸다. 언제 저 머리를 돌로 한번 세게 쳐줘야겠다.
$ENTRY_JOURNAL_OZIMAL_DEAD_TITLE	 
$ENTRY_JOURNAL_OZIMAL_DEAD_LEFT_0_00	Day 10 – 오미잘의 죽음.
$ENTRY_JOURNAL_OZIMAL_DEAD_LEFT_0_10	오미잘이 죽는 광경을 본다면 상당히 만족스러운 기분을 느낄 줄 알았다. 전혀 그렇지 않았다.<N>그 자식은 멍한 눈을 치뜨고 우리가 맞서는 적들의 의지에 따르는 졸병에 불과하다. 심지어 죽어버리기 전에도 그랬다. 이 땅에서 잔혹한 정신병자 하나가 사라졌다. 하지만 여기 구덩이에서	 하나 없어진들 티라도 날까?
$ENTRY_JOURNAL_MONASTERY_TITLE	 
$ENTRY_JOURNAL_MONASTERY_LEFT_0_00	열 번째 밤 - 수도원
$ENTRY_JOURNAL_MONASTERY_LEFT_0_10	이 구덩이에서 고향 비슷한 것을 찾아보려는 시도 자체가 멍청하다는 것은 알고 있지만	 셀리니 수도원의 모습은 여전히 충격적이었다. 수도원은 사방을 틀어막고 불길한 기운을 내뿜고 있었다. 그건 차라리 요새에 더 가까웠다. 이런 대비가 필요하다는 사실은 이해하지만	 내가 나고 자랐던 수도원의 분수조차 이제는 알아보기 힘들었다. 경비병들조차 조화의 탄생지가 혼돈과 파괴로 더럽혀질까 염려하여 무기 대신 둔기를 들고 다니던 곳이었는데. <N>하지만 분수에 손을 담갔을 때야 비로소 내가 서 있는 바로 이곳은	 나 이전에도 수많은 신자들과	 선지자 셀레나드 역시 발디 뎠던 바로 그곳이라는 사실을 깨달았다. 나는 그저 보잘것없는 하인이요	 옛적 왕과 선지자들과도 그저 시간의 벽만을 사이에 둔 일개 인간인 것이다. <N><LQ>물은 계곡에서 안개로 흩어지고	 산에서 눈으로 내리며	 강에서 바다로 흘러간다. 이처럼 같은 정수에서 태어난 인간 역시 각각의
$ENTRY_JOURNAL_MONASTERY_RIGHT_0_00	시간과 장소에서	 이 거대한 우주의 권역 아래서 조화를 얻고자 그 삶을 바쳐야 하는 것이다.<RQ><N>대체 이 무법과 혐오가 판치는 대지에서	 조화와 지혜 따위는 너무나 멀어 보이는 영역에서 내가 맡은 역할이란 대체 무엇이란 말인가.<N>이 요새 수도원의 안에서	 갑자기 마음속에 평화가 찾아들어왔다. 그렇다면 이곳의 수도사들은 본질을 저버린 것이란 말인가? 설령 벽으로 사방을 틀어막고 전쟁과도 같은 방비를 한다 해도	 이는 그저 이 무법의 땅에서 셀레나드의 성령을 설파하기 위한 적응에 불과한 것이다.<N>어느 위대한 자는 말했다. <LQ>진실은 진실로 그 어떤 말로도 부를 수 있노라고.<RQ> 이 방벽들은 그저 구덩이의 말에 불과하다; 진실은 그 안에 진실로 남아있는 것이다.<RQ>
$ENTRY_JOURNAL_BAKAL_TITLE	 
$ENTRY_JOURNAL_BAKAL_LEFT_0_00	열한 번째 날 - [healer_hero] 장로
$ENTRY_JOURNAL_BAKAL_LEFT_0_10	존귀하신 [healer_hero] 사제님은 이 혼돈의 소굴에서 만난 한줄기 이성의 등불이다. 비록 지금의 여정이 너무나 촉박하여 대화를 나눌 시간은 너무 부족하나	 그 중간중간 나누는 몇 마디로도 나의 영혼에게 상당한 조력이 되어준다.<N>나 역시 내가 그분에게 조력이 되길 바란다. 사제님의 내면에는 그 자신을 갉아먹는 고통이 존재한다. 난 이제야 수행자의 잔잔한 얼굴 아래에 드리워진 그림자를 볼 수 있게 되었다. 지난날 군인이던 시절이 존재했단 것을 생각해보면	 어쩌면 당연한 일이다: 전장에서 얻은 흉터	 마음의 상처. 평생 지고 가야 할 짐들.<N>사제님께서는 사실 사제의 길을 걷지 않았다는 것을 수도원에서 알게 되었지만	 그렇더라도 나는 이 분을 계속 사제님이라 부르겠다. 사실상 사제님은 아무런 명령권도 없었다	 최소한 공식적으로는 주어지지 않았다는 말이다. 하지만 사제님의 동료 분들은 마치 상관이라도 모시듯이 이 분의 조언을 계속해서 구하며 따랐다. 대수도원장 역시 사제님과 단순히 가까운 동료 이상의 모습을 보였었다.
$ENTRY_JOURNAL_BAKAL_RIGHT_0_00	지금의 여정은 [healer_hero]님의 영혼에 동요와 원기를 동시에 불어넣는 것처럼 보인다. 마치 그 자신의 영혼이 스스로의 균형을 맞춰나가는 것처럼. 이제야 [ranger_hero]이(가) 사제님을 두려워하는지 알겠다. 그때나 지금이나 그분의 눈 속에서는	 우릴 뒤쫓는 추격자의 그것에나 비할만한 강렬한 투지를 볼 수 있다. 그저 [healer_hero]님께서	 언젠가 자신이 남들에게 베푸는 만큼의 안식을 스스로 찾으셨으면 하는 바람뿐이다.
$ENTRY_JOURNAL_WRENNA_TITLE	 
$ENTRY_JOURNAL_WRENNA_LEFT_0_00	열세 번째 날 - [mage_hero_fu]
$ENTRY_JOURNAL_WRENNA_LEFT_0_10	폴레몬이 묘사했던 퀘이드인들의 충성심은 한치의 과장도 없었다. [mage_hero]은(는) 정말이지<LQ>안색은 달보다 창백하고	 느껴지는 거리감은 달보다 두 배는 더 멀다.<RQ> 고지식한 면까지 따져보면 <LQ>수성까지도 가겠다.<RQ> 그렇게 미친 듯이 성깔이 마구 바뀌는 사람은 처음 본다. [berserker_hero]조차도 최소한 미쳤다는 점에서는 한결같으니까. [mage_hero]은(는) 분노한 바다와도 같다	 한순간 이 애의 지성이 악마적이라 느껴지더라도	 다음 순간에는 그저 구제불능의 순둥이로 변한다. 저건 아무리 봐도 뭔가 수상한 속내가 있어서 부리는 술수라고 생각이 들어도	 분명 내 추측이 들어맞았다고 확신하는 순간에는 갑자기 애들 같은 면모를 또 내보이며	 위험과 비합리의 극치를 달리는 미친 짓을 저지르기 시작하는 것이다.<N>나는 가끔 이 광기의 뒤에서 나랑 똑같은 여자아이를 볼 수 있다고 생각한다. 무섭고 외롭고 끔찍한 힘을 가진 슬픈 아이. 이 애도 내게서 자신을 보고 있을까?
$ENTRY_JOURNAL_NOMADS_TITLE	 
$ENTRY_JOURNAL_NOMADS_LEFT_0_00	열네 번째 날 - 유목민들
$ENTRY_JOURNAL_NOMADS_LEFT_0_10	유목민 부족들에게는 상당히 흥미로운 시선을 보낼 수 있었다. 애쉬의 도시들과 퀘이드 제국 사이의 대평원과 산지에서	 태어나 살아가는 사람들이라니. 켄트말 폴레몬은 동쪽으로 향한 위대한 여정 중에	 적어도 100여 개는 되는 종류의 부족들을 기록해 두었다. 뭐 나는 이들 중 상당수가 전쟁의 여파로 사라지고 말았다고 믿고 있지만. 여기 구덩이에서도 27개*는 되는 숫자의 부족들을 만나볼 수 있는 것인데	 저 바깥세상에서 살고 있을 사람들은 아마 추산하기도 불가능할 것이다.<N>그 이름대로 부족들은 유목민적인 삶을 영위해가고 있으며	 대평원을 가로질러 염소와 말을 키우며 살아가고 있는 것이었다. 이런 삶의 방식은 구덩이에선 거의 통용되지 않는다. 어쨌든 여기는 항상 경계와 방비를 유지하며 살아야 하는 곳이니까.
$ENTRY_JOURNAL_NOMADS_LEFT_0_20	*물론 완전한 부족들에 비하면 절반 정도밖에 기능하지 않는다.
$ENTRY_JOURNAL_NOMADS_RIGHT_0_00	제대로 된 부족들은 크러스크와 같은 마을을 형성해	 염소를 찾아다니거나 가장 기초적인 형태의 농업을 시작한다. <N>적응하지 못하는 유목민들(자신들의 부족이 없어졌거나 흩어져버린 사람들)은 렉세스같이 좀 더 도시적인 개척지에 정착하게 된다. 아니면 순찰자가 되어 구덩이의 마을들 사이에서 전령 역할을 하거나	 교역상들을 호위하는 일을 하게 되는 것이다.
$ENTRY_JOURNAL_DREAM1_TITLE	 
$ENTRY_JOURNAL_DREAM1_LEFT_0_00	열다섯 번째 날 - 이상한 꿈
$ENTRY_JOURNAL_DREAM1_LEFT_0_10	뭔가 꿈을 꾸었던 적도 상당히 오래전이 되었다. 연옥 세계를 공포스러운 감각은 나의 영혼을 완전히 사로잡아	 내가 자고 있는 동안에도 그 메아리만은 절절히 느끼도록 하는 것이었다. 하지만 내가 고열로 인해 헛것을 보던 그날 이후 처음으로	 난 어젯밤에 꿈을 꾸었다.<N>너무나 사실적인 꿈이었기 때문에	 오히려 내가 꿨던 그 어떤 악몽보다도 더 두려울 지경이었다. 실제로 꿈을 꾸는 동안에는 내가 살아왔던 23년의 세월의 기억은 흔적도 없이 사라져버렸다. <N>난 내가 아닌 채로 아주 높은 발코니에 서 있었다. 팔은 검고 잘 빠져있었으며	 피부는 괴상한 상징들로 덮여있는데다 금띠로 둘러져있었다. 내가 걸치고 있던 드레스는 수많은 보석들을 엮은 것이었고	 나라 하나를 가져와도 옷의 끝단이나 겨우 살까 말까 하는 값어치로 보였다.
$ENTRY_JOURNAL_DREAM1_RIGHT_0_00	달은 하늘에 낮게 걸려 있었다. 그 크기는 거대하고 붉게 불타고 있었다. 손만 뻗으면 금세라도 손가락으로 문지를 수 있을 것 같았다.<N>어떤 목소리가 나를 불러 뒤를 돌아보았다. 내 옆에는 남자가 한 명 서 있었다. 키는 아주 컸는데	 내가 지금까지 본 사람 중에 가장 컸다. 머리카락과 콧수염은 밤같이 어두운 색깔이었고	 아주아주 긴데다 금고리로 장식되어 있었다. 그는 자신의 존재만으로 세상 전체를 비좁고 흐릿한 장소로 바꾸어버렸다.<N>남자가 검은 보석 같은 눈으로 나를 바라보자	 난 우리는 하나라는 사실을 알아차렸다. 나는 불타는 달을 끌어내려 둘로 나누어 가졌다.<N>나는 곧이어 온몸을 떨면서 깨어났다. 손은 아직도 붉은 달을 쥐고 있는 것처럼 심장을 움켜쥐고 있었다. 너무도 강한 갈망이 나를 사로잡았기에 울음이 터져 나왔다. 그렇게 깨어난 순간만큼은	 다시 꿈속으로 돌아갈 수만 있다면 무슨 수라도 썼을 것이다.
$ENTRY_JOURNAL_DESERT_FORTRESS_TITLE	 
$ENTRY_JOURNAL_DESERT_FORTRESS_LEFT_0_00	열일곱 번째 날 - 사막의 보석
$ENTRY_JOURNAL_DESERT_FORTRESS_LEFT_0_10	항상 우리 숙적이 살고 있다는 동쪽의 도시는 어떻게 생겼을까 궁금했었다. 전쟁은 수도에 헤어 나올 수 없는 공포를 뿌리는 존재였고	 들리는 소식들이란 항상 오늘은 어떻게 패배하였느냐는 것뿐이었다. 거리는 불구가 되어버린 상이 용사들의 구걸과 비탄으로 가득 차 있었다.<N>실체도 없던 공포에 사로잡혀 살던 사람에게	 실제로 퀘이드의 도시를 목도한다는 것은 희한한 경험이었다. 나는 그 아름답고 기발한 설계에 전율했다. 하지만 무엇보다도 이 모든 풍경이 낯설지 않다는 감각이 가장 놀라웠다. <N>나는 도시의 삶을 세세히 훑어본다: 잘 닦인 도로에 깔려 다 닳아버린 조약돌	 어린애들 장난에 낙서가 되어버린 기념비. 시장의 좌판은 여느 도시의 그것과 똑같이 떠들썩하다.
$ENTRY_JOURNAL_DESERT_FORTRESS_RIGHT_0_00	우리 아버지가 길 저쪽 모퉁이에 앉아	 다른 양반들과 웃고 욕하며 떠드는 모습을 투영해 보는 일은 전혀 어렵지 않다···.<N>하지만 여기 사람들은 테레마 시를 파괴하고	 남녀노소를 가리지 않고 주민들을 살육했단 말이다
$ENTRY_JOURNAL_MARKOS_TITLE	 
$ENTRY_JOURNAL_MARKOS_LEFT_0_00	열여덟 번째 날 - [knight_hero]
$ENTRY_JOURNAL_MARKOS_LEFT_0_10	내가 동료랍시고 같이 몰려다니는 미친 연놈들한테 너무 익숙해져서	 이젠 제정신 같은 건 믿지도 않게 됐나 봐?<N>[knight_hero] 님은 공손하시고	 지적이며	 의지도 굳건하신데다	 가끔은 재치도 넘치신다 - 망할	 위생관념이란 것도 갖추고 있다니까. 장점을 하나하나 나열하자면 도대체 끝이 없다.<N>이건 뭔가 잘못된 거다! 뭔가 괴벽이라든가	 성깔이라든가	 비합리적인 사고방식이라도 있을 거야. 여정 중에 한가지 확실하게 배운 거라곤	 이 구덩이에는 정상 따위는 없다는 것이다. <N>콧수염이겠지	 안 그래? 단점이고 광기고 안 좋은 건 싹 다 그 콧수염 뒤에 숨겨두고 있는 게 틀림없어.
$ENTRY_JOURNAL_LETTER_MARKOS_1_TITLE	 
$ENTRY_JOURNAL_LETTER_MARKOS_1_LEFT_0_00	열아홉 번째 날
$ENTRY_JOURNAL_LETTER_MARKOS_1_LEFT_0_10	[mcguffin_hero] 리브바 아가씨께 애쉬를 다스리는 기사 [knight_hero_fu] 카샨티어가 감히 아룁니다.<N>아가씨	 아가씨께서 맡고 계신 일행의 지도자라는 책무에 지극한 경의를 표하나	 그 구성원의 선택에 대해서는 약간의 조언을 드리고자 합니다. 다시 말하자면 [mage_hero_fu] 랜 락스미와의 여정이 지속될 경우	 아가씨의 안녕은 물론이고 이 여정 전체의 안녕 역시 보장해 드리지 못한다는 것입니다.<N>숙녀분께서는 마법사에 대해 <LQ>그렇게 나쁜 애는 아녜요<RQ>라는 평가를 내려주셨으며	 또한 퀘이드 전쟁 역시 끝난지 오래라고 하셨습니다만	 제가 보장컨대 이 마법사는 아직도 그 전쟁을 치르고 있는 것 같습니다.  이제는 존재하지도 않는 전쟁에 광적으로 집착하고 있다는 것입니다. 여기에 그녀의 광기를 감시할 보고체계가 전혀 잡혀있지 않습니다. 만약 [mage_hero_fu]의 머리에 퀘이드 전쟁에서 승리하기 위해서는 모두가 자는 동안에 목을 따버려야한다는 생각이 드는 날엔	 저희 일행 중 다음날 태양을 볼 수 있는 자는 아무도 없을 것이라는 이야기입니다.
$ENTRY_JOURNAL_LETTER_MARKOS_1_RIGHT_0_00	이런 위험천만한 관계는 최대한 원만히 청산하는 편이 현명함을 감히 충고 드리는 바입니다.<N>당신의 미천한 종
[knight_hero_fu] 카샨티어	
$ENTRY_JOURNAL_LETTER_MARKOS_2_TITLE	 
$ENTRY_JOURNAL_LETTER_MARKOS_2_LEFT_0_00	열아홉 번째 밤 - [knight_hero_fu]님께 드릴 편지	 후보 1번
$ENTRY_JOURNAL_LETTER_MARKOS_2_LEFT_0_10	[knight_hero_fu] 기사님	<N>귀하의 편지께 답장을 드리며	 세 가지 점을 지적하고 싶어.<N>첫 번째	 바로 옆으로 대충 3미터밖에 떨어져 있지 않은 사람한테 왜 편지를 쓰시는 거지? 그냥 말을 해도 되잖아? 내 위생상태에 뭔가 문제가 있는 건가? 사람들이 내 흉이라도 봤어?<N>두 번째	 제발 아가씨라고 그만 좀 불러.<N>세 번째	 [mage_hero] 얘는 혼자 좀 내버려 둬	 안 그러면... 모르겠네	 구레나룻에 불이라도 붙여줄까.
$ENTRY_JOURNAL_LETTER_MARKOS_2_RIGHT_0_00	추신 - 귀밑머리 얘기는 농담이었어	 그거 없으면 엄청 우스워 보일 것 같기도 하고	 또 뒷얘기 하면서 놀릴 때 쓸 별명을 또 만들어야 하니까. 대충 콧수염짱짱맨 정도면 괜찮을라나. 그건 그렇고	 [mage_hero_fu] 얘는 요새 힘든 나날을 보내고 있으니까 누굴 귀찮게 하고 싶으시걸랑 그래도 싼 애들을 괴롭혀	 지금 내가 뭘 쓰고 있나 어깨너머로 훔쳐보고 있는 [berserker_hero_up]같은 애들 말이야. 내가 눈치를 못 챈 것 같나 본데 입에서 그렇게 똥내가 나는 멍청이는
$ENTRY_JOURNAL_LETTER_MARKOS_2_RIGHT_0_10	[knight_hero_up]씨 사랑해요. 당신의 코수염짱짱맨이랑 결혼하고 싶어요. 그래도 [berserker_hero_up]님보단 훨씬 안 멋지지만 그리고 그 치마 잘 어울려요. 깔깔깔 우리 결혼해요!!!! 
$ENTRY_JOURNAL_LETTER_MARKOS_3_TITLE	
$ENTRY_JOURNAL_LETTER_MARKOS_3_LEFT_0_00	스무 번째 날
$ENTRY_JOURNAL_LETTER_MARKOS_3_LEFT_0_10	[mcguffin_hero_fu] 아가씨께	<N>일단 저는 지난번에 귀하께서 보낸 편지를 받으려는 의도는 없었다는 사실을 말씀드리겠습니다. 그 편지를 보게 된 경위는 [berserker_hero_fu]님께서 전달해주셨기 때문이며	 그다음엔 캠프에서 뛰쳐나오더니 귀하에게 수프 국자로 사정없이 구타당하시더군요.<N>제가 드리고 싶은 말은	 그저 그 편지를 읽지 않은 채로 돌려드리겠단 말뿐입니다. 또한 그 수프 국자를 다시 쓰시려면 꼭 한번 씻어주시길 바라겠습니다. 감사합니다.<N>P.S. - 콧수염짱짱맨이라니? 진심이십니까? 그게 상상력을 최고로 발휘하신 결과물인가요?<N>-[knight_hero_fu] 카샨티어
$ENTRY_JOURNAL_LETTER_MARKOS_SLAK_TITLE	 
$ENTRY_JOURNAL_LETTER_MARKOS_SLAK_LEFT_0_00	스물한 번째 날
$ENTRY_JOURNAL_LETTER_MARKOS_SLAK_LEFT_0_10	야 [mcguffin_hero_up]	 나는 [knight_hero_up]이야. 네 아이를 가지고 싶어. 왜냐하면 나는 아가씨 거든. 그래서 치마를 입는 거야. 그리고 [berserker_hero_up]님은 너무 쩌는 것 같아.<N>사랑을 담아서<N>진짜 [knight_hero_up]임
$ENTRY_JOURNAL_LETTER_AZRA_SLAK_TITLE	 
$ENTRY_JOURNAL_LETTER_AZRA_SLAK_LEFT_0_00	스물한 번째 밤
$ENTRY_JOURNAL_LETTER_AZRA_SLAK_LEFT_0_10	[berserker_hero_fu]에게 고한다.<N>이걸 읽고 있단 얘긴 네가 또 내 텐트에 숨어들어와서 일기를 훔쳐보고는	 딴 사람 흉내를 내면서 낙서를 갈기고 있단 얘기겠지. 뭐	 이번엔 그렇게 못할 거야. 네 뒤에 텐트가 팔랑이는 게 보여? 누가 저 뒤에서 텐트를 팔랑이고 있을까? <N>힌트 하나 줄게: 그건 수프 국자고	 국자는 널 되게 싫어하는 것 같아.
$ENTRY_JOURNAL_LETTER_AZRA_SLAK_LEFT_0_20	껄껄 거의 믿을뻔했네. 그건 그렇고 내 이름은 [knight_hero_up]이야. 예쁜 드레스 입는 걸 좋아하고	 또
$ENTRY_JOURNAL_NIRU_TITLE	 
$ENTRY_JOURNAL_NIRU_LEFT_0_00	스물두 번째 밤 - [dragon_hero]
$ENTRY_JOURNAL_NIRU_LEFT_0_10	용에 대한 얘기는 많이 들었었다. 내 사촌 동생은 어린 시절에 용에 푹 빠져있었기 때문에	 내가 도서관에서 찾을 수 있던 전설이란 전설은 가리지 않고 모조리 읽어댔던 것이다. 심지어 폴레몬의 저서인 '유목민 전설에 대한 과학적 접근'따위 같은 것도. 물론 사촌은 이 이야기들을 어린아이식으로 재해석해서 내게 도로 들려주곤 했었다	 인과는 뒤집히고 내용은 섞인데다 숨도 안 쉬고 줄줄 읊어주긴 했지만. 이런 이야기들의 질은 둘째치더라도	 그 소재와 주제들은 상당히 괜찮은 것이라 내 의식 속 한구석에 항상 자리 잡고 있었다. 이제 피와 살로 이루어진 진짜 용을 내 동료로 맞이하게 되자	 그 어린애가 읊어주었던 용 이야기들이 다시금 떠오른다.<N>지금까지 헤쳐온 여정을 살펴보면	 내 예상이란 이론과 실제가 맞부딪히는 순간에는 상당한 오류에 불과해진다는 것을 배우게 되었다. 하지만 이번 경우에는 그게 좀 심하다. [dragon_hero] 이 양반은 신성성의 상징은 개뿔 뚱뚱하고 욕심쟁이에 이기적이고 콧대 높은 과체중 도마뱀에 불과한 것이다.
$ENTRY_JOURNAL_NIRU_RIGHT_0_00	하지만 그리도 강대한 생명체는 진실로 위험한 법이다. 용은 눈 하나 깜짝하지 않고 일행을 통째로 삼키거나	 자기를 귀찮게 하는 존재는 아무렇지도 않게 죽일 수도 있을 것이며	 한낱 <LQ>미물에 불과한<RQ> 필멸자에게 관대하게 굴 수도 있을 것이다.<N>완전성이란 곧 무지의 극치이기도 하다. [dragon_hero]의 마음속에는 <LQ>용 크기의 보물 잔<RQ>에 대한 엄청난 갈망이 있다. 한 번이라도 애쉬의 언어를 배워본 적이 있다면	 이 전설 속 보물이 사실은 <LQ>위대한 래다말의 변기<RQ>정도로 현실성 없는 물건이란 저술들을 읽어냈을 것이다. 가끔씩 용이 내뿜는 기세에 눌려 숨이 막힐 지경이 되면	 이 강대한 용이 <LQ>그 보물 잔<RQ>을 어떻게 가지고 놀지 상상해보는 수밖에 없다.
$ENTRY_JOURNAL_NIRU_LEFT_1_00	스물네 번째 밤 – 부록
$ENTRY_JOURNAL_NIRU_LEFT_1_10	비록 그 성격이 이중인격처럼 극과 극으로 갈라지기는 하지만	 [dragon_hero]은(는) 정말 자애로운 어머니다.<N>가끔씩이 엄마 용이 자기 혈족의 아이들이 잘 지내고 있을지 전전긍긍하는 모습을 보고 있자면	 우리 엄마의 모습을 떠올리지 않을 수 없다. 나 따위는 자연스럽게 홀랑 태우거나 꿀꺽 삼키거나 할 수 있을 저런 거대한 괴물에게서 이런 기분을 받는 것은 희한한 일이지만	 그렇게 느껴지는 걸 어쩌겠는가.<N>이런 싸구려 동정이 날 죽일 수도 있다는 사실은 알고 있다. 하지만 자기 자식들을 망령들에게 빼앗긴 엄마가 느낄 슬픔을 내가 어찌 헤아릴 수 있을까. 저런 강대한 존재조차도 우리 시대를 덮친 이 비극에서는 자유로울 수 없던 것이다.
$ENTRY_JOURNAL_DREAM2_TITLE	 
$ENTRY_JOURNAL_DREAM2_LEFT_0_00	스물다섯 번째 날 – 두 번째 꿈
$ENTRY_JOURNAL_DREAM2_LEFT_0_10	어젯밤 그 꿈을 다시 꾸었다. 내용은 달랐지만	 분명 같은 꿈이라고 단언할 수 있다 - 최소한 꾸는 사람은 같았다.<N>이번에는 거대한 홀에 서 있었다. 벽은 내 머리 위로 쭉 뻗어올라가고 있었고	 어찌나 높은지 천장에는 구름이 덮여있었다. 벽면은 금빛으로 빛나고 있었으며	 눈이 닿는 곳마다 아름다운 보석으로 장식되어 있었다. 내 손에는 잔이 들려 있었는데	 뭔가 빛나는 물질로 상감이 되어 있었고	 색은 어두운 와인빛에 촉감은 차가웠다. <N>주위의 모든 것이 온통 경이로운 것들이었지만	 그중에서도 내 손에 든 잔이 가장 귀중하게 여겨졌기에. 그 안에 든 무언가가 쏟아지지 않게 주의하며 조심스레 들고 있었다. 갑자기 주위가 온통 어두워지더니 더러운 천민들이 홀로 밀고 들어왔다. 놈들은 나를 붙잡고는 욕설을 내뱉으며 내 손에서 잔을 빼앗아가버렸다. 나는 노성을 지르고는 망토 안에서 날카로운 단검을 꺼내	 놈들을 찔러대어 홀을 온통 피 칠갑하고 말았다.
$ENTRY_JOURNAL_DREAM2_RIGHT_0_00	그렇게 죽어나가면서도 천민들은 나를 홀 밖으로 밀어내	 비좁은 대기실로 처넣어버렸다. 나는 싸웠지만	 날 둘러싼 짐승들 역시 내게 맞섰다. 내가 쓰러져버리자	 놈들은 날 밟고 넘어가 벽에 붙어있던 빛나는 보석들을 탐욕스레 뜯어내기 시작했다.<N>오랫동안 누워있었던 것 같다. 내가 죽었다고 생각하고 있었다. 다시 두 발로 일어섰을 때	 홀은 이미 비어있었다. 벽들은 온통 뜯겨나가 무너져 있었고	 모든 것이 그을음과 불결한 것으로 덮여 있었다. 잔은 어디에도 없었다. 영겁의 시간 동안 울부짖으며 홀 전체를 헤맸지만	 나는 그저 혼자였다. 잔은 빼앗겨버렸다.<N>난 폐허에 주저앉아 울음을 터뜨렸다.
$ENTRY_JOURNAL_ZELEMIR_DEAD_TITLE	 
$ENTRY_JOURNAL_ZELEMIR_DEAD_LEFT_0_00	스물여덟 번째 날 – 젤레마의 죽음
$ENTRY_JOURNAL_ZELEMIR_DEAD_LEFT_0_10	왕을 죽이자 오묘한 기분이 들었다. 이게 분명 합리적인 행동이라는 사실은 이해한다. 하지만 그렇다 해도 나는 손에 애쉬 왕가의 피를 묻힌 것이다. 왕은 분명 본분을 저버리고	 모든 존재들의 운명을 위험으로 몰아넣기는 했다. 그렇지만 나는 감정적인 느낌에 계속 사로잡힌다.<N>[mage_hero]의 감정은 기쁨과 분노 사이에서 널뛰고 있는 것처럼 보인다. 다시 한번 더 죽이기라도 할 것처럼 그 이름을 계속 저주하고 있다. 지난 몇 주간의 여정을 돌이켜본다면	 그 바람이 완전히 헛된 소망은 아닌 것 같다.<N>지금 내 머릿속에 들어차 있는 생각이란	 망령 놈들이 아직도 우릴 뒤쫓고 있다는 것뿐이다. 놈들의 지도자와 창조주는 죽었다. 그들의 의지가 어떻게 아직도 놈들을 이끄는 걸까?<N> 질문을 던지긴 했지만 대답은 이미 알고 있다	 그저 인정하기가 싫을 뿐이다. 이건 그의 의지가 아니다. 느낌이 다르다. 놈들을 이끄는 또 다른 손이 있다.
$ENTRY_JOURNAL_ZELEMIR_DEAD_RIGHT_0_00	젤레마가 내뱉었던 괴이한 힘이 느껴진다. 이건 피의 희생으로 봉인된 악	 에즈티-테네크다.
$ENTRY_JOURNAL_DREAM3_TITLE	 
$ENTRY_JOURNAL_DREAM3_LEFT_0_00	스물아홉 번째 날 – 세 번째 꿈
$ENTRY_JOURNAL_DREAM3_LEFT_0_10	어젯밤 또 꿈을 꾸었다.<N>어느 폐허에 서 있었다. 내 앞에는 거대한 수정이 있었는데	 그 높이가 하늘로 30미터는 치솟는 물건이었다. 나는 울고 있었다. 눈물이 내 몸을 타고 흘렀다. 눈물은 내가 걸친 장신구와 부적들을 가로질러	 땅으로 스며들었다. 눈물은 멈추지 않고 땅 위를 달려 수정까지 흘러갔고	 나는 그제야 이게 눈물이 아니라 피가 흐르는 것임을 깨달았다.<N>발 밑에는 온통 시체들이었다. 남자	 여자	 그리고 아이들. 그들의 살점을 내 손에 발랐다. 나는 몸을 돌려 내 뒤에 도열해 있던 군단을 보았다. 이들은 내 명령만을 기다리고 있었다.<N>나는 시뻘건 팔을 쳐들고는 우레와 같은 목소리로 외쳤다.
$ENTRY_JOURNAL_DREAM3_RIGHT_0_00	군대 역시 울부짖었다. 내가 한 번도 들어보지 못한 언어였지만	 나는 곧잘 그것이 무슨 뜻인지 알았다. 그들은 피를 갈구하고 있었다. 울부짖음은 점점 커지더니	 끝내 땅을 뒤흔들었다.
$ENTRY_JOURNAL_THRONE_ROOM_TITLE	 
$ENTRY_JOURNAL_THRONE_ROOM_LEFT_0_00	서른다섯 번째 날 – 에즈티의 왕좌
$ENTRY_JOURNAL_THRONE_ROOM_LEFT_0_10	[berserker_hero] 녀석이 왕좌 위에 아주 편안하게 앉아있다. 에즈티-테네크의 왕좌 말이다. <N>처음에는 이런 행동에 약간 불편함을 느끼긴 했다. 근데 그럴 필요가 뭐 있어? 저런 악의 수장을 뭣하러 존중해줘야 하지? 이 황금 사람은 신성을 손에 쥔 깡패에 불과하다. 이건 차라리 동정심이 느껴지는 악이다. 스스로를 채찍질하여 위대한 자를 따라가려는 악이다. 이 장소를 다 보라고	 궁전 전체가 그저 스스로 만들어내는 허상을 유지하기 위해 지어진 것이다. 나를 보자	 그것은 비명을 지른다. 내가 바로 진정한 권능의 얼굴이다. 유일신 에즈티-테네크이다. 놈의 수정 감옥에 갇혀있던 불구자다.<N>하지만 나의 또 다른 이면은 그걸 이해하고 있다. 이 홀을 걸어내려가는 또다는 내가	 신성을 완전히 이해한 내가 있다. 나는 그 옆에 앉아	 우민들을 심판한다. 신들이 부르는 소리가 들린다.
$ENTRY_JOURNAL_THRONE_ROOM_RIGHT_0_00	이런 느낌이었나. 내 꿈에 나타나던 기분이	 나를 능멸하던 그 순간이. 난 놈이 바라던 자신의 모습과	 현실에서의 시궁창을 모두 목도한 것이다.
$ENTRY_JOURNAL_ANTIAZRA_TITLE	 
$ENTRY_JOURNAL_ANTIAZRA_LEFT_0_00	서른일곱 번째 날 – 틀레틀-메즈틀리
$ENTRY_JOURNAL_ANTIAZRA_LEFT_0_10	대체 보물방에서 무슨 일이 일어난 것인지 제대로 이해하지 못하겠다.<N>난 나 자신이 죽는 걸 봤다; 그게 진짜 나는 아니더라도 말이다. 불타는 달 틀레틀-메즈틀리가 죽었다.<N><LQ>내가 이 사람이었던 적이 있었다고<RQ> 말하는 건 상당히 괴상한 일이다. 하지만 사실인걸. 그 권능	 그 상실. 그리고 응징. 나는 그녀로 살았었다	 뭐 최소한 지금의 그녀를 만들었던 순간을 살았다. 이제는 그녀를 부정하는 희생의 순간을 보게 된 것이다.
$ENTRY_JOURNAL_ESCAPE_TITLE	 
$ENTRY_JOURNAL_ESCAPE_LEFT_0_00	서른아홉번째 날 - 탈출?
$ENTRY_JOURNAL_ESCAPE_LEFT_0_10	젤레마가 돌아왔다. 놈이 내놓은 제안은 간사하기 짝이 없었다: 우리에겐 자유를 주고	 세상에는 구원을 안겨주겠단다. 그 대가는 몇 천의 생명뿐이다. 어차피 피바다인데 몇 방울 더 떨어져봐야 티라도 나겠느냐.<N>[dragon_hero]의 반응은 격렬했고	  [mage_hero]은(는) 진짜 거품을 물었다.<N>탈출이다!<N>무엇을 선택하든 위험은 산더미처럼 쌓여있다. 젤레마에 목숨을 바쳐 맞서느냐	 그럼 에즈티-테네크 앞에 바쳐질 수 천의 목숨들은 풀려날 것이다. 세상의 운명을 위험에 처하게 하느냐! 하지만 그럴 경우에는 내 영혼을 희생해야 하게 된다.<N>나는 애쉬에서 죽을 수 있기만을 바란다. 다른 선택지가 있기만을 또 바란다.
$ENTRY_JOURNAL_FOLLOWING_ZELEMIR_TITLE	 
$ENTRY_JOURNAL_FOLLOWING_ZELEMIR_LEFT_0_00	마흔 번째 날 – 젤레마를 따라서
$ENTRY_JOURNAL_FOLLOWING_ZELEMIR_LEFT_0_10	더 이상 젤레마의 방법이 미친 것이라고 말하기가 힘들다. 정말 심사숙고해서 만들어낸 합리적인 해결책이다 - 전략의 대가가 짜낸 저주의 해법인 셈이다.<N>그리고 혐오스러운 방법이기도 하다.<N>무고한 사람들을 죽여가면서 혼돈에 맞섰던 인간이	 이제 자기 자신의 신념마저 저버리고 있다.<N>이미 놈과는 한번 싸워본 적이 있다. 이 사람들을 지켜야 하기에 몇 번이고 더 싸울 수도 있다. 죽을 각오를 다해서.
$ENTRY_JOURNAL_EPILOGUE_TITLE	 
$ENTRY_JOURNAL_EPILOGUE_LEFT_0_00	후일담
$ENTRY_JOURNAL_EPILOGUE_LEFT_0_10	그냥 <LQ>이제 나를 죽이려 드는 사람은 없다<RQ>고 말하는데	 왜 이렇게 이상한 기분이 드는지 모르겠다.<N>사실 나도 정말 그 말을 믿고 있는지 확신이 서지 않는다. 도서관 홀에서도 혹시나 살인마 양이 돌진해 오지 않나 기다리곤 한다. 기껏해야 쥐가 좀 돌아다니고 말지만	 그 녀석도 이내 '폴레몬의 올바른 식물 기르기' 쪽으로 숨어버리고 만다.<N>[knight_hero]님은 도서관에 상당히 익숙한 풍경이 되셨다. 지난달에는 내가 찾을 수 있는 군사학 도서란 모조리 섭렵하시고는	 그다음엔 합리주의 분야로 진출하시더니	 이제는 내가 뽑아다 주는 책이라면 뭐든 잘 읽으신다. 내 생각에 지난번에 보시던 책은 분명 내가 손에 대충 잡히는 대로 꺼내준 앵무새 기르기 책이었다. 그러더니 읽으란 책은 안 읽고 온종일 나랑 얘기만 하시는 거다. 그분께서도 뭔가 미친 구석이 있다는 사실은 알고 있었다.
$ENTRY_JOURNAL_EPILOGUE_RIGHT_0_00	그래도 책장을 정리하는 동안 누군가 말을 걸어준다는 것은 참 좋다. 전염병이 기승을 부리던 시기에	 너무나 많은 책들이 한낱 땔감으로 불타버렸다. 도서관은 말 그대로 죽어있었다. 내가 막 도착했을 때에는 책꽂이 대부분이 뼈대만 남기고 텅 비어있던 것이다.<N>[knight_hero] 님께서는 유목민 상인들로부터 책을 꽤 사서는 기부해주셨고	 어제는 또 수수께끼의 발신인으로부터 소포를 받았다. 소포에는 <LQ>엄청 지루한 일을 하고 사시는 [mcguffin_hero_up] 꺼임 내 거는 죽이고 막 그런건데<RQ>라고 쓰여있더라.<N>소포 안에는 적어도 3세기는 묵었을	 엄청나게 희귀한 서쪽 판본들이 들어있었다. 뭐 책표지마다 괴물을 때려잡는 막대 인간이 엄청 허접하게 그려져있고	 그 밑에는 <LQ>'나'<RQ>라고 쓰여있긴 했지만. 이 책들은 모두 새단장한 동관에 꽂혀서 후대까지 이어질 것이다. <N>내 오랜 동료들에게 어떻게 보답해야 할지 모르겠다.
$ENTRY_JOURNAL_EPILOGUE_LEFT_1_00	지금 돌이켜보면 두 달밖에 되지 않는 시간이었다. 하지만 두 달이란 [berserker_hero]이나 [ranger_hero] 같은 애들에게는 수백 가지 모험을 즐길 수 있는 시간인 것이다.<N>[mage_hero]에 대한 소식은 거의 듣지 못 했다	 하지만 요즈음 유목민 상인들 사이에서는 <LQ>'폐허의 미친 여황제'<RQ>에 대한 소문이 도는 것으로 보아	 요새도 재정복 전쟁을 잘 치르고 있나 보다	하고 생각할 뿐이다.<N>가끔씩은 그 애가 어떻게 되진 않을까 두려운 생각이 들기도 한다. 역병도 사라지고 망령도 없어진 이 때	 Quaid 제국은 이제 온갖 잡놈들에게 젖과 꿀이 흐르는 기회의 땅으로 보일 것이다. 북쪽 왕국은 얘길 안 해도 알겠지. 하지만 만약 온 세상을 상대로 맞서 싸우면서도 웃을 수 있는 사람이 있다면	 그건 바로 [mage_hero]일 것이다.<N>[healer_hero]님께선 수도원으로 돌아가셨다. 가끔씩 그분께서 보내주시는 편지를 받는데	 구덩이가 조금씩 어떻게 변해가는지를 세세하게 설명하시는 내용이다. 교역상과 여행자	 그리고 순례자들이 조금씩 돌아오기 시작했다고 한다. 뭐 그 땅이 구덩이라는
$ENTRY_JOURNAL_EPILOGUE_RIGHT_1_00	오명을 벗으려면 아직 시간이 걸리겠지만. 어쩌면 조만간 장로님의 초대를 받아 방문을 해봐야겠다. 이 도시도 재건 중이니	 조금 있으면 내가 버티지 못할 빡빡한 도시생활이 날 덮칠 것 같으니까.<N>내 눈이 다시금 드넓은 대지와 저 먼 지평선을 갈망하고 있다. 어쩌면 내 안에 모험가 기질이 남아있긴 한가보다. 분명 [knight_hero]님과 그 호위들이 내게 따라붙을 테니	 여행은 위험하지도 않을 터이다. 뭐 기사님을 잘 구슬려서 노래도 부르게 시키면 지루하지도 않을 테고.<N>[dragon_hero]님도 이 <LQ>필멸자<RQ>의 세계에서 완전히 모습을 감추셨다고는 생각한다. 하지만 확신은 서지 않는다. 지난주에는 도서관 지붕에서 금박을 입힌 책들이 발견되었던 것이다. 아주아주 숙련된 벽 타기 꾼이 올라가서야	 그 높은 높이에 있는 짐 더미들을 겨우겨우 안전하게 가지고 내려올 수 있었다. 이 수수께끼의 후원자께서 분명 날 수 있는 재능을 되찾으셨다고 믿고 싶다	 그건 이 '자칭 신'께서 아이들을 같이 키울 남편분을 찾으셨단 뜻일 테니. 
$ENTRY_JOURNAL_EPILOGUE_LEFT_2_00	정말 정말 행복한 상상이라 머리에서 떨어지질 않는다.<N>우리 일행이 아니었던 사람들과 이야기하기는 좀 이상하다. 우리 이야기가 다 거짓말이라고 조롱하는 사람이 아니면	 피난민들 사이에 도는 쓸데없이 과장된 이야기를 믿는 사람밖에 없으니.  <N>오늘 아침에는 꼬마 둘이 거리에서 나를 불러 세우더니 자기들을 괴롭힌 깡패 녀석의 얼굴을 녹여달라고 부탁하더라. 녹여달라는 건 맨날 얼굴이지. 그 녀석을 한번 째려봐줬더니 바지를 갈아입으러 도망가버렸다. 꼬맹이들한테 놀림을 받는 게 얼굴이 녹아버리는 것보단 낫겠지. 다른 사람들도 내 앞에 줄줄이 서서는 물집을 치료해달라	 당나귀를 축복해달라	 이웃이 화나게 하는데 저주 좀 해달라 등등···. 끝나려면 아직 멀었다.<N>어쩌면 이게 [knight_hero]님께서 도서관을 자주 찾으시는 것이 반가운 이유 일련 지도 모르겠다.
$ENTRY_JOURNAL_EPILOGUE_RIGHT_2_00	우리가 겪었던 모험에 대해서는 절대 이야기하지 않는다. 하지만 우리 일행도 아니었던 사람과 추억을 나눌 순 없다고 버티면 다들 이해해준다. <N>언젠가 다 같이 다시 만날 수 있는 날이 올까?<N>-[mcguffin_hero] 야키 리브바
$ENTRY_JOURNAL_EPILOGUE_RIGHT_2_10	일기를 좀 더 찾기 어려운 데다가 숨겨놓지 그랬냐. 하하. 내가 좀 잘나서 그런 건 아니고	 내 이름은 [knight_hero_up]이고	 난 정말 그렇게 멋진 놈이 아니야. 난 머리에 예쁜 꽃들을 꽂고 다니길 좋아하고	 프릴 빛깔 보라색 스커트를 입고 춤추며 노래하지.. 라라라랄라라라라~<N>그리고 솔직히 [knight_hero_up] 말인데	 이거 너한테 내가 직접 말을 해줘야겠냐.
$ENTRY_JOURNAL_EPILOGUE_RIGHT_2_20	난 아직 수프 국자를 쥐고 있단다.