flag	content	comment
$BASE_ATTACK	Base attack
$BATTLE_STARTING_FORMATION_TEXT	Use the same starting formation as last time?
$BATTLE_FREE_MOVE	Finger pointer
$BATTLE_MOVE	Move
$BATTLE_MOVE_MOUSE	Move mouse
$BATTLE_FINE_MOVE	Move slow
$BATTLE_TILE_MOVE	Move tile
$BATTLE_BACK	<RE>$MISC_BACK
$BATTLE_SPELLS	<RE>$STAT_DESC_SPELLS
$BATTLE_SELECT_UNIT	Select Unit
$BATTLE_MENU	<RE>$MISC_MENU
$BATTLE_MAP	map
$BATTLE_DEFENDERS	<RE>$MISC_DEFENDERS
$ACTIONS_BATTLE_MENU_MOVE	<RE>$BATTLE_MOVE
$ACTIONS_BATTLE_FREE_MOVE	<RE>$BATTLE_FREE_MOVE
$ACTIONS_BATTLE_FINE_MOVE	<RE>$BATTLE_FINE_MOVE
$ACTIONS_BATTLE_TILE_MOVE	<RE>$BATTLE_TILE_MOVE
$ACTIONS_BATTLE_SELECT	<RE>$BATTLE_SELECT_UNIT
$ACTIONS_BATTLE_BACK	<RE>$BATTLE_BACK
$ACTIONS_BATTLE_DEFENDERS	<RE>$BATTLE_DEFENDERS
$ACTIONS_BATTLE_SPELLS	Spells
$ACTIONS_BATTLE_MENU	<RE>$BATTLE_MENU
$ACTIONS_BATTLE_SPEED_MINUS	Speed down
$ACTIONS_BATTLE_SPEED_PLUS	Speed up
$ACTIONS_BATTLE_PAUSE	<RE>$MISC_PAUSE
$ACTIONS_BATTLE_CYCLE_PREVIOUS	Previous defender
$ACTIONS_BATTLE_CYCLE_NEXT	Next defender
$ACTIONS_BATTLE_SPELL_SPAM	Spell repeat
$ACTIONS_MAP_MOVE	Move cursor
$ACTIONS_MAP_SELECT	<RE>$MISC_SELECT
$ACTIONS_MAP_EXIT	<RE>$MISC_EXIT
$ACTIONS_MAP_MENU	<RE>$MISC_MENU
$ACTIONS_MAP_JOURNAL	<RE>$MISC_JOURNAL
$ACTIONS_MAP_MOVE_MAP	Move on map
$ACTIONS_MAP_SCROLL_MAP	Scroll map
$ACTIONS_CUTSCENE_SKIP	<RE>$MISC_SKIP
$ACTIONS_CUTSCENE_NEXT	<RE>$MISC_NEXT
$ACTIONS_CUTSCENE_PREVIOUS	<RE>$MISC_PREVIOUS
$BONUS_DEFENSE	Bonus defense
$BOOK_COOL_MULT	Spell cooldown time x<X>
$BOOK_COOLDOWN_OP	Spell cooldown time <X>
$BOOK_COST_MULT	Spell cost x<X>
$BOOK_COST_OP	Spell Cost <X>
$BOOK_PSI_TAX	PSI Tax: <X>
$CONFIRM_QUIT_TEXT	<RE>$CONFIRM_RESTART_TEXT	COMMENT: this is a redirect, the text for $MISC_PLEASE_WAIT will be duplicated here. The <RE> invocation at the beginning of the string signals a redirect, and will not show up in the final text
$CONFIRM_QUIT_TITLE	Quit the battle?
$CONFIRM_RES_CHANGE	Resolution changed.<N>Do you like it?<N><N>REVERTING IN <SECONDS> SECONDS.
$CONFIRM_RESTART_TEXT	You'll forfeit all experience & money earned so far.
$CONFIRM_RESTART_TITLE	Restart the battle?
$DATA_DUMP_AUDIO	Exporting audio...
$DATA_DUMP_BACKGROUNDS	<RE>$DATA_DUMP_BKG
$DATA_DUMP_BKG	Exporting background images...
$DATA_DUMP_CUTSCENE	Exporting cutscene images...
$DATA_DUMP_CUTSCENES	<RE>$DATA_DUMP_CUTSCENE
$DATA_DUMP_DATA	Exporting data files...
$DATA_DUMP_EMBED	Exporting embedded graphics...
$DATA_DUMP_IMAGES	Exporting data images...
$DATA_DUMP_LOCALES	Exporting locales...
$DATA_DUMP_MAP_FILES	Exporting map files...
$DATA_DUMP_MAP_IMAGES	Exporting map images...	COMMENT: <N> means a line break. <N> works too, but not <N> or <n>
$DATA_DUMP_MAPS	<RE>$DATA_DUMP_MAP_FILES
$DATA_DUMP_MOD_INFO	Exporting mod info...
$DATA_DUMP_MUSIC	Exporting music...
$DATA_DUMP_SFX	Exporting sound effects...
$DATA_DUMP_SPRITES	Exporting sprites...
$DATA_DUMP_TABLES	Exporting data tables...
$DECIMATE_BY	Decimate by <PERCENT>%
$DEMO_OVER_ACTS	Acts<N>III & IV
$DEMO_OVER_DONT_FORGET	Don't forget your save file!
$DEMO_OVER_ENORMOUS	Click the enormous button to continue your quest!
$DEMO_OVER_ENORMOUS_2	Click an enormous button to continue your quest!
$DEMO_OVER_EXPORT_HOW	Export your save file with this button.
$DEMO_OVER_FULL_GAME	Get the FULL GAME!
$DEMO_OVER_FULL_GAME_SHORT	FULL<N>GAME!
$DEMO_OVER_PLAY	Keep Playing!
$DEMO_OVER_PLEASE_WAIT	<RE>$MISC_PLEASE_WAIT
$DEMO_OVER_THANKS	Thanks for Playing!	COMMENT: <MCG> is a variable. In this exact string, the game expects this exact variable, and will replace <MCG> with Azra's name. Any other variable is ignored and will appear as-is.
$DEMO_OVER_USE_IT	Use it to continue from where you left off!
$EN_SPELL_DRAGON_FIRE_1_DESC	<DMG> DMG
$EN_SPELL_DRAGON_FIRE_2_DESC	<LOW>-<HIGH> DMG
$EN_SPELL_FRENZY_DESC	<PLUS><PERCENT> speed for <SEC> sec
$EN_SPELL_HEAL_DESC	Heal: <PERCENT> HP
$END	end
$ERROR_CONTEXT	context
$ERROR_MESSAGE	message
$ERROR_NUMBER	Error #
$ERROR_STACK	stack trace
$ERROR_TITLE	An Error Has Happened!
$FB_HARD_SELL_NO	I said never!
$FB_HARD_SELL_TEXT	You sure about that?<N>Look! It's so shiny!
$FB_HARD_SELL_YES	Well... okay.
$FB_LIKE_US_NO	Hahaha. No.	COMMENT: The game will put Zelemir, Tletl-Meztli, or any other alternate mcguffin's name where <ALLY> appears.
$FB_LIKE_US_TEXT	Like us on Facebook and<N>get this FREE prize!
$FB_LIKE_US_YES	Okay!
$FB_PERSISTENT_OK	Victory is mine!
$FB_PERSISTENT_TEXT	Okay, you win!<N>You can have it anyway :)
$FB_REBEL_TEXT	That's right, stick it to the man!<N>Have this instead.
$FB_SECOND_PITCH	You can still get this<N>by liking us on Facebook!
$FB_SECOND_PITCH_NO	Never!
$FB_SECOND_PITCH_YES	Okay!
$FB_THANKS_OK	Okay
$FB_THANKS_SUCKS	Facebook Sucks
$FB_THANKS_TEXT	Thanks for liking us on Facebook!<N>You already got the prize!
$FB_THIS_ITEM_WILL_NOW	This item will now always appear in any player's inventory.
$FLAV_DESC_ARMOR_BREAK_AMT_GRTR_1	Destroys <AMT_2DIG><EXTRA> points of armor for every point of DMG in attack.
$FLAV_DESC_ARMOR_BREAK_AMT_LESS_1	Destroys 1 point of armor for every <INV_AMOUNT><EXTRA> points of DMG in attack.
$FLAV_DESC_ARMOR_BREAK_DIRECT	Attack destroys <AMTDMG><EXTRA> points of armor.
$FLAV_DESC_ARMOR_BREAK_SHORT	Attack destroys several points of armor.	COMMENT: There are 4 variants here to handle the various pluralizations
$FLAV_DESC_ARMOR_PIERCE_AMT_GRTR_1	Ignores <AMT_1DIG><EXTRA> points of armor for every point of DMG in attack.
$FLAV_DESC_ARMOR_PIERCE_AMT_LESS_1	Ignores 1 point of armor for every <INV_AMOUNT><EXTRA> points of DMG in attack.
$FLAV_DESC_ARMOR_PIERCE_DIRECT	Attack ignores <AMTDMG><EXTRA> points of armor.
$FLAV_DESC_ARMOR_PIERCE_SHORT	Attack ignores several points of armor.
$FLAV_DESC_AUTO_KILL	Foes below <PERCENT>%<EXTRA> HP automatically die.
$FLAV_DESC_AUTO_KILL_SHORT	Sufficiently weak foes automatically die.
$FLAV_DESC_BLEED	Foe takes <PERCENT>%<EXTRA> more damage from future hits for <TIME><EXTRA_TIME> sec.
$FLAV_DESC_BLEED_SHORT	Foe temporarily takes more damage from future hits.
$FLAV_DESC_BLINDED	Enemy attacks miss <PERCENT>% <EXTRA>of the time for <TIME><EXTRA_TIME> sec.
$FLAV_DESC_BLINDED_SHORT	Enemy attacks lose accuracy for a few seconds.
$FLAV_DESC_BURN	Foe takes <AMTDMG><EXTRA> dmg/sec for <TIME><EXTRA_TIME> sec. Cancelled by ice.
$FLAV_DESC_BURN_SHORT	Foe takes damage over a short time. Cancelled by ice.
$FLAV_DESC_CHILL	Foe is slowed by <PERCENT>%<EXTRA> for <TIME><EXTRA_TIME> sec. Cancelled by burn.
$FLAV_DESC_CHILL_SHORT	Foe is slowed down for a few seconds. Cancelled by burn.
$FLAV_DESC_CONFUSED	Foe walks backwards for <TIME><EXTRA_TIME> sec.
$FLAV_DESC_CONFUSED_SHORT	Foe walks backwards for a few moments.
$FLAV_DESC_CRITICAL	Damage = <AMT_1DIG>x<EXTRA> normal.
$FLAV_DESC_CRITICAL_SHORT	Damage is greater than normal.
$FLAV_DESC_DISEASE	Foe's regeneration is reduced by <PERCENT>%<EXTRA>.
$FLAV_DESC_DISEASE_SHORT	Foe's regeneration is reduced.
$FLAV_DESC_FREEZE	Foe can't move for <TIME><EXTRA_TIME> sec. Cancelled by burn.
$FLAV_DESC_FREEZE_SHORT	Foe can't move temporarily. Cancelled by burn.
$FLAV_DESC_INSPIRE	Friends deal <M_MULT_PERCENT>%<EXTRA> more damage for <TIME><EXTRA_TIME> sec.
$FLAV_DESC_INSPIRE_SHORT	Friends temporarily deal more damage.
$FLAV_DESC_KNOCK_BACK	Foe is pushed back <AMT_1DIG><EXTRA> tiles.
$FLAV_DESC_KNOCK_BACK_SHORT	Foe is pushed back a few tiles.
$FLAV_DESC_LIGHT	DARK foes take +<AMT_2DIG>x<EXTRA>DMG & are easier to hit for <TIME><EXTRA_TIME> sec.
$FLAV_DESC_LIGHT_SHORT	DARK foes take extra damage, & are easier to hit.
$FLAV_DESC_POISON	Foe takes <PERCENT>%<EXTRA> of attack's dmg every second for <TIME><EXTRA_TIME> sec.	COMMENT: Font size and x/y offsets for options menu button labels
$FLAV_DESC_POISON_DIRECT	Foe takes <AMTDMG><EXTRA> dmg every second for <TIME><EXTRA_TIME> sec.
$FLAV_DESC_POISON_SHORT	Foe takes damage over a short time.
$FLAV_DESC_SINGLE_STUN	Foe can't move for <TIME><EXTRA_TIME> sec. Can only be inflicted once.
$FLAV_DESC_SINGLE_STUN_SHORT	Foe can't move for a few seconds. Can only be inflicted once.
$FLAV_DESC_SLOW	Foe is slowed by <PERCENT>%<EXTRA> for <TIME><EXTRA_TIME> sec.	COMMENT: hide/show accessibility box graphic, offset for 'absence' text, offset for 'speed' text
$FLAV_DESC_SLOW_SHORT	Foe is slowed temporarily.
$FLAV_DESC_STRIKE_THROUGH	Attack can hit up to <INTI><EXTRA> foes.
$FLAV_DESC_STRIKE_THROUGH_SHORT	Attack can hit multiple foes.
$FLAV_DESC_STUN	Foe can't move for <TIME><EXTRA_TIME> sec.
$FLAV_DESC_STUN_SHORT	Foe can't move temporarily.
$GETSCRAP1	A pile of junk, rags, broken tools, and sharp pieces of jagged, rusted metal.<N><N>Who could possibly want any of this?
$GETSCRAP2	Apparently, denizens of the pit use this junk as currency.
$HERO_BLURB_BAKAL	A soft-spoken old monk, seeking forgiveness for his sins...
$HERO_BLURB_KETTA	A nomad huntress, cynical and world-weary...
$HERO_BLURB_MARKOS	A battle-hardened knight, weary from the endless struggle...
$HERO_BLURB_NIRU	Violent and mysterious, this dragon shares no secrets...
$HERO_BLURB_SLAK	A strange young man, both brave and unstable...
$HERO_BLURB_WRENNA	The last princess of Quaid, hungry to avenge her fallen kingdom...
$LQ	“
$MAP_TEXT_HERMIT	Hermit
$MAP_TEXT_LAIR	Lair
$MAP_TEXT_PRISON	Prison
$MAP_TEXT_SHRINE	Shrine
$MAP_TEXT_TREASURE	Cave
$MAP_TEXT_UNKNOWN	???
$MCGUFFIN_LEARN_SPELL	<MCG> learned a new spell!
$MISC_1_FOE	1 foe
$MISC_1_FRIEND	1 friend
$MISC_ABSORB_X	absorb <X>
$MISC_ABSORB_X_RESIST_Y	absorb <X>, resist <Y>%
$MISC_ACCEPT	accept
$MISC_ACCEPT_AND_CLOSE	Accept & close
$MISC_ACHIEVEMENT!	Achievement!
$MISC_AWARD!	Award
$MISC_ADJUST_REWARDS	100% is the default amount, adjust up or down to change your rewards.
$MISC_ADVANCED	advanced
$MISC_ADVANCED_SHORT	adv.
$MISC_ALL_FOES	All foes in range
$MISC_ALL_FOES_IN	All foes in <TILES> tiles
$MISC_ALL_FRIENDS	All friends in range
$MISC_ALL_FRIENDS_IN	All friends in <TILES> tiles
$MISC_ALL_TARGETS	Targets in range
$MISC_ALL_TARGETS_IN	Targets in <TILES> tiles
$MISC_AMOUNT	amount
$MISC_AMOUNT_SHORT	amount
$MISC_ANONYMOUS	anonymous
$MISC_ARE_YOU_SURE	Are you sure?
$MISC_ARMOR	armor
$MISC_ARMOR_PLURAL	<RE>$MISC_ARMOR
$MISC_ARMOR_SINGULAR	<RE>$MISC_ARMOR
$MISC_ARMOR_SHORT	ARMR
$MISC_ASSIGN_POINTS	Assign<N>Points
$MISC_ATTACK	attack
$MISC_ATTACK_SHORT	ATK
$MISC_BACK	back
$MISC_BASE_ATTACK	base attack
$MISC_BATTLE	Battle
$MISC_BEGIN	begin
$MISC_BONUS	Bonus
$MISC_BONUS_DEFENSE	base defense
$MISC_BOOST	boost
$MISC_BOOST_X	boost <X>
$MISC_BREAK_HERO_MODE_TEXT	You've chosen to play in <LQ>Hero Mode<RQ>, which forbids recruiting generic characters. Leave this mode and recruit a character anyway?
$MISC_BREAK_HERO_MODE_TITLE	Leave Hero Mode?
$MISC_BUY	buy
$MISC_CANCEL	cancel
$MISC_IGNORE	Ignore
$MISC_CANT_AFFORD	Can't Afford
$MISC_CANT_EQUIP!	Can't Equip
$MISC_CASUAL	casual
$MISC_CASUAL_SHORT	casual
$MISC_CHANCE	chance
$MISC_CHANGE	Change
$MISC_CLICK_HERE	click here
$MISC_CLOSE	close
$MISC_COMPLETE	complete
$MISC_COMPLETE!	complete!
$MISC_CONFIG_DIR	Config. folder
$MISC_CONFIRM	confirm
$MISC_CONFIRM_CHANGE	Confirm Change
$MISC_CONFIRM_RECRUIT	Confirm Recruit
$MISC_CONTINUE	continue
$MISC_COST	cost
$MISC_COST:	cost:
$MISC_COUNTER	counter
$MISC_CREDITS	Credits
$MISC_CURRENT_SAVE	Current Save File:
$MISC_CUSTOM_SETTINGS	Customize...
$MISC_DAMAGE	damage
$MISC_DAMAGE_RESIST	DMG resist
$MISC_DAMAGE_SHORT	DMG
$MISC_DARK	dark
$MISC_DARK_DESC	(evades 75% of attacks)
$MISC_DEATH_SPLASH	death splash
$MISC_DEF_SHORT	DEF
$MISC_DEFAULT	Default
$MISC_DEFAULT_SETTINGS	Default (recommended for new players)
$MISC_DEFEAT	Defeat
$MISC_DEFEND	defend
$MISC_DEFENDER	defender
$MISC_DEFENDERS	defenders
$MISC_DEFENSE	defense
$MISC_DEFENSE_ABS	defense
$MISC_DEFENSE_SHORT	DEF
$MISC_DELETE_ACHIEVEMENT	Delete Achievement?
$MISC_DELETE_BOTH_GOG_ACHIEVEMENT	Delete local & GOG achievements
$MISC_DELETE_BOTH_STEAM_ACHIEVEMENT	Delete local & Steam achievements
$MISC_DELETE_LOCAL_ACHIEVEMENT	Delete local achievement only
$MISC_DEMO_VERSION	Demo Version
$MISC_DEMO_VERSION_DESC	This is the public demo of Defender's Quest: Valley of the Forgotten, Deluxe Edition.<N><N>It contains about 20% of the entire game, and lets you export your save files should you choose to buy the full version, so that you don't lose any progress.
$MISC_DESCRIPTION	description
$MISC_DISABLED	disabled
$MISC_DOWNLOAD	download
$MISC_UPLOAD	upload
$MISC_DQ_NEWS	Get NEWS!
$MISC_DQ_SITE	DefendersQuest.com
$MISC_EASIER	easier
$MISC_EASY	normal
$MISC_EASY_SHORT	normal
$MISC_EMPTY	Empty
$MISC_ENABLED	enabled
$MISC_ENEMY_LEVELS	Enemy levels
$MISC_ENTER	enter
$MISC_ENTER_TEXT	Enter Text:
$MISC_EQUIP	equip
$SHOP_EQUIP	<RE>$MISC_EQUIP	The word 'equip' that appears on the button in the shopping screen in towns
$EQUIP_THE_THING	<RE>$MISC_EQUIP	The word 'equip' that appears on the button in the equip menu in the party screen, to actually put the item on your character
$GO_TO_EQUIP_MENU	<RE>$MISC_EQUIP	The word 'equip' that appears on the button in the skills menu in the party screen, to switch to the equip menu
$MISC_SLOT	slot
$MISC_ERROR	error
$MISC_ERROR_INVALID_MOD_NAME	Invalid mod name!
$MISC_ERROR_MOD_BAD	That mod is incompatible with this version of the game. Sorry!
$MISC_ERROR_MOD_EXISTS	A mod with that name already exists!
$MISC_ERROR_UNKNOWN	Unknown error. Sorry!
$MISC_ERROR_UNZIP	Couldn't unzip the mod. Change your mod path in the options menu, or check your hard drive space.
$MISC_ERROR!	error!
$MISC_EVADE	evade
$MISC_EVADE_SHORT	EVA
$MISC_EVASION	evasion
$MISC_EXIT	exit
$MISC_EXPERIENCE	experience
$MISC_EXTREME	extreme
$MISC_EXTREME_SHORT	extr.
$MISC_FAIL_TT_TEXT	How much experience and scrap is withheld from your rewards if you fail a battle.<N>-50% is the default amount, adjust up or down to change the penalty.
$MISC_FAIL_TT_TITLE	<RE>$UI_ACCESS_FAILURE_PENALTY
$MISC_FAST	fast
$MISC_FOE_PLURAL	foes
$MISC_FOE_SINGULAR	foe
$MISC_FRIEND_PLURAL	friends
$MISC_FRIEND_SINGULAR	friend
$MISC_GAIN	gain
$MISC_GAME_DATA	Game Data
$MISC_GOLD	scrap
$MISC_GOLD_TT_TEXT	Scrap (money) you get after a battle.<N><RE>[$MISC_ADJUST_REWARDS]
$MISC_GOLD_TT_TITLE	Scrap
$MISC_GOLD:	scrap:
$MISC_HARD	<RE>$MISC_EXTREME
$MISC_HARD_SHORT	<RE>$MISC_EXTREME_SHORT
$MISC_HARDER	harder
$MISC_HEAL	heal
$MISC_HERO_MODE	Hero Mode
$MISC_HERO_MODE_TEXT	Recruiting generic characters is forbidden.<N>Absolutely NOT recommended for first playthroughs!<N><N>NOTES:<N>You can change your mind later by trying to recruit a character and dismissing the warning that pops up.<N><N>We strongly recommend setting XP and Scrap gain to 300% when using hero mode.<N><N>Finally, this setting isn't required for "Hero Mode" achievements -- the absence of generic characters is enough.
$MISC_HERO_MODE_TEXT_SONY	Recruiting generic characters is forbidden.<N>Absolutely NOT recommended for first playthroughs!<N><N>NOTES:<N>You can change your mind later by trying to recruit a character and dismissing the warning that pops up.<N><N>We strongly recommend setting XP and Scrap gain to 300% when using hero mode.<N><N>Finally, this setting isn't required for "Hero Mode" awards -- the absence of generic characters is enough.
$MISC_HERO_MODE_TITLE	<RE>$MISC_HERO_MODE
$MISC_HIRE	HIRE!
$MISC_HIRE_Q	Hire <NAME> the <CLASS> for<N><SCRAP> scrap?
$MISC_HP	hit points
$MISC_HP_SHORT	HP
$MISC_IMMUNE_TO	Immune to <SOMETHING>
$MISC_INFO	info
$MISC_JOURNAL	Journal
$MISC_LANGUAGES	Languages
$MISC_LEADER	leader
$MISC_LEAVE	leave
$MISC_LEVEL	level
$MISC_LEVEL_SHORT	LVL
$MISC_LEVEL_SHORT_X	LVL <X>
$MISC_LEVEL_PARTY_GEM	Level	Appears on character blocks in the party screen
$MISC_LEVEL_WAVE_BLOCK	Level	Appears on enemy wave blocks in battle
$MISC_LEVEL_SUPER_SHORT	L
$MISC_LEVEL_UP!	LEVEL UP!
$MISC_LEVEL_UPX	LEVEL UPx
$MISC_LEVEL_X	Level <X>
$MISC_LOADING	Loading...
$MISC_LOADING_PERCENT	Loading...<PERCENT>%
$MISC_LOCKED	locked
$MISC_LVLUP	LVLUP
$MISC_MAKE_CHANGE	Make these changes?
$MISC_MAX	MAX
$MISC_MEDIUM	<RE>$MISC_ADVANCED
$MISC_MEDIUM_SHORT	<RE>$MISC_ADVANCED_SHORT
$MISC_MENU	menu
$MISC_PAUSE	pause
$MISC_MISS	miss
$MISC_MODS	Mods
$MISC_MORE	more...	COMMENT: moves the 'cycle defenders' text and associated buttons
$MISC_MOVIES	Movies
$MISC_NEED_PSI	NEED<N>PSI
$MISC_NEW_GAME_SETTINGS	New Game Settings
$MISC_NEXT	next
$MISC_NO	no
$MISC_NO_AFFORD	CAN'T AFFORD
$MISC_NO_CHANGE	no change
$MISC_NO_HARDWARE	Your system does not support hardware acceleration. The game will still run, but you might want to turn down the graphics settings if it seems slow.
$MISC_NOBODY	Nobody
$MISC_NOM!	NOM!
$MISC_NONE	none
$MISC_NONE_DEFAULT	None *
$MISC_NORMAL	normal
$MISC_NORMAL_SHORT	normal
$MISC_NOTHING	nothing
$MISC_NOTHING_TO_EQUIP	Nothing to equip!
$MISC_NOTHING!	nothing!
$MISC_OF_DAMAGE	of DMG
$MISC_OK	ok
$MISC_OKAY	okay
$MISC_OPTIONS	Options
$MISC_OTHER	Other
$MISC_PARTY	Party
$MISC_PASS	pass
$MISC_PERFECT	perfect
$MISC_PERFECT_BONUS	Perfect Bonus:
$MISC_PERFECT!	perfect!
$MISC_PHASES	phases
$MISC_PLEASE_ENTER_A_NAME!	Please enter a name!
$MISC_PLEASE_WAIT	Please Wait...
$MISC_PLUS_X_STAT	<PLUS><X> <STAT>
$MISC_PLUS_X_TO_ARMOR_ABS	<PLUS_OR_MINUS><X> to ARMOR
$MISC_PLUS_X_TO_ATTACK	<PLUS_OR_MINUS><X> to ATTACK
$MISC_PLUS_X_TO_ATTACK_SPEED	<PLUS_OR_MINUS><X> to SPEED
$MISC_PLUS_X_TO_DEFENSE_ABS	<PLUS_OR_MINUS><X> to DEFENSE
$MISC_PLUS_X_TO_HP	<PLUS_OR_MINUS><X> to HP
$MISC_PLUS_X_TO_RANGE	<PLUS_OR_MINUS><X> to RANGE
$MISC_PLUS_X_TO_REGEN_ABS	<PLUS_OR_MINUS><X> to REGENERATION
$MISC_PLUS_X%_TO_ARMOR_MULT	<PLUS_OR_MINUS><X> to ARMOR_MULT
$MISC_PLUS_X%_TO_DEFENSE_MULT	<PLUS_OR_MINUS><X>% to DEFENSE
$MISC_PLUS_X%_TO_DODGE	<PLUS_OR_MINUS><X> to EVASION
$MISC_PLUS_X%_TO_EVADE	<RE>$MISC_PLUS_X%_TO_DODGE
$MISC_PLUS_X%_TO_REGEN_MULT	<PLUS_OR_MINUS><X>% to REGENERATION
$MISC_PORCUPINE	thorns
$MISC_PREV	prev
$MISC_PREVIOUS	previous
$MISC_PROBLEM?	problem?
$MISC_PSI	psi
$MISC_PSI_SHORT	psi
$MISC_CHANGE_USER	Change User
$MISC_WRONG_USER	Something is wrong with the current signed in user.
$MISC_SIGN_IN	Sign in
$MISC_QUIT	quit
$MISC_QUIT	quit
$MISC_QUIT_BATTLE	quit battle
$MISC_RANDOM	random
$MISC_RANGE	range
$MISC_RANGE_SHORT	RNG
$MISC_RECRUIT	recruit
$MISC_REFUSE	refuse
$MISC_REGEN	regen
$MISC_REGEN_LONG	regeneration
$MISC_REGEN_SHORT	REG
$MISC_RESET	Reset
$MISC_RESIST	resist <SOMETHING>
$MISC_RESIST_X	resist <X>%
$MISC_RESTART	restart
$MISC_RESTART?	Restart?
$MISC_RESTORE_DEFAULTS	Restore Defaults
$MISC_RESTORE_DEFAULTS_2	<RE>$MISC_RESTORE_DEFAULTS
$MISC_REWARD	Reward:
$MISC_SAVE_DATA	Save Data
$MISC_SAVE_ERROR_TEXT	Autosave just failed, check your file permissions?<N>We'll try again later.
$MISC_SAVE_ERROR_TITLE	Autosave Error!
$MISC_SAVE_FIXED_TEXT	Autosave succeeded, looks like you fixed whatever was wrong.<N>We'll shut up now.
$MISC_SAVE_FIXED_TITLE	Autosave Working!
$MISC_SAVED	saved
$MISC_SAVED!	Saved!
$MISC_SCRAP	scrap
$MISC_SECOND	second
$MISC_SECOND_SHORT	sec
$MISC_X_SECOND_SHORT	<X> sec
$MISC_SECONDS	seconds
$MISC_SECONDS_SHORT	secs
$MISC_SELECT	Select
$MISC_SELECT_CHALLENGE	Select Challenge:
$MISC_SELL	sell
$MISC_SEND_NEXT	Send NEXT
$MISC_SKILL	skill
$MISC_SKILLS	skills
$MISC_INSPECT	inspect
$MISC_SKIP	skip
$UI_GAMEPLAY_SKIP	<RE>$MISC_SKIP
$MISC_SLOW	slow
$MISC_SPAWNS	spawns
$MISC_SPECIAL	special
$MISC_SPEED	speed
$MISC_SPEED_SHORT	SPD
$MISC_SPELL	spell
$MISC_SPLASH_DAMAGE	Splash
$MISC_SPLASH_LINE	<AMT> dmg, <TILES> tiles
$MISC_SPLASH_TILES	tiles
$MISC_STATS	stats
$MISC_STATUS	status
$MISC_STRANGER	stranger
$MISC_STRENGTHS	strengths
$MISC_SWIMS	swims
$MISC_TALK	talk
$MISC_THORNS	thorns
$MISC_THRESHOLD	threshold
$MISC_TIPS	Tips
$MISC_TO	to
$MISC_TOWN	Town
$MISC_TRY_AGAIN	Try Again
$MISC_TYPES	Types
$MISC_UNDO	undo
$MISC_UNDO_ALL	undo all
$MISC_UNEQUIP	unequip
$MISC_UNIQUE	unique
$MISC_UNKNOWN	unknown
$MISC_UNSAVED	unsaved
$MISC_UP_TO_X_FOES	Up to <NUM> <FOE>
$MISC_UP_TO_X_FRIENDS	Up to <NUM> <FRIEND>
$MISC_UPGRADE	upgrade
$MISC_VERSUS	versus
$MISC_VICTORY	Victory
$MISC_VS	vs
$MISC_WAIT	WAIT
$MISC_WALKS_ON	walks on
$MISC_WARNING	Warning!
$MISC_WAVE_X	Wave <X>
$MISC_WAVES	Waves
$MISC_WEAKNESSES	weaknesses
$MISC_WEAPON_SINGULAR	weapon
$MISC_WEAPON	<RE>$MISC_WEAPONS
$MISC_WEAPONS	weapons
$MISC_WEAPON_PLURAL	<RE>$MISC_WEAPONS
$MISC_ACCESSORY_SINGULAR	<RE>$MISC_ACCESSORY
$MISC_ACCESSORY	accessory
$MISC_ACCESSORIES	accessories
$MISC_ACCESSORY_PLURAL	<RE>$MISC_ACCESSORIES
$MISC_X_FOES	<NUM> foes
$MISC_X_FRIENDS	<NUM> friends
$MISC_X_HITS_FOE	<NUM> per foe
$MISC_X_HITS_FRIEND	<NUM> per friend
$MISC_X_HITS_TARGET	<NUM> per target
$MISC_X_HITS_TOTAL	<NUM> total
$MISC_X_MORE	<X> more...
$MISC_X_PSI	<X> PSI
$MISC_XP	xp
$MISC_XP_TT_TEXT	Experience points you get after a battle.<N><RE>[$MISC_ADJUST_REWARDS]
$MISC_XP_TT_TITLE	Experience
$MISC_YES	yes
$MISC_YOU_SURE	Are you sure?
$NEW_GAME_PLUS_NOTE	Go to the save screen and select NEW GAME+ on your old save slot.
$PARTY_1_NEW_ACHIEVE	1 new achievement!
$PARTY_ACHIEVE_PLURAL	achievements
$PARTY_ACHIEVE_SINGULAR	achievement
$PARTY_ATTACK	Attack:<T>
$PARTY_CANT_ARMOR	Can't<N>use<N>ARMOR
$PARTY_CANT_WEAPON	Can't<N>use<N>WEAPONS
$PARTY_CHANGE_NAME	Rename
$PARTY_CHARACTER	character
$PARTY_CHARACTERS	characters
$PARTY_CONFIRM_CHANGES	Confirm Changes
$PARTY_CONFIRM_POINTS_1_1	Permanently assign 1 skill point to 1 character?
$PARTY_CONFIRM_POINTS_1_X	Permanently assign 1 skill point to <CHARS> characters?
$PARTY_CONFIRM_POINTS_TITLE	Confirm Skill Points
$PARTY_CONFIRM_POINTS_X_1	Permanently assign <POINTS> skill points to 1 character?
$PARTY_CONFIRM_POINTS_X_X	Permanently assign <POINTS> skill points to <CHARS> characters?
$PARTY_DEFEATED_WAVE_X	Defeated wave <X>
$PARTY_DEFEND	Defend:<T>
$PARTY_EVADE	Evade:<T>
$PARTY_FAIL_PENALTY	Fail penalty
$PARTY_FAILED	Level Failed!
$PARTY_FAILED_DESC	<MCG> was slain.
$PARTY_FROM_BATTLE	From battle
$PARTY_GO_TO_MAP	Go to Map
$PARTY_HP	HP
$PARTY_NO_AFFORD	You can't afford that!<N>Cost: <COST><N>Scrap: <SCRAP>
$PARTY_NO_NEW_ACHIEVE	No new achievements.
$PARTY_NO_POINTS	There's no skill points to re-assign!
$PARTY_PASSED	Level Passed!
$PARTY_PASSED_ALLY_DEAD_DESC	<ALLY> was slain,<N>but <MCG> survived.
$PARTY_PASSED_DESC	<MCG> survived the battle,<N>with injuries.
$PARTY_PASSED_WORD	Passed
$PARTY_PASSED+	Level Passed!+
$PARTY_PASSED+_DESC	<MCG> was injured!<N><ALLY> survived!
$PARTY_PASSED++	Level Passed!++
$PARTY_PASSED++_DESC	<MCG> was injured!<N><ALLY> survived unharmed!
$PARTY_PERFECT	PERFECT!
$PARTY_PERFECT_ALLY_DEAD_DESC	<MCG> was unharmed, but <ALLY> perished.
$PARTY_PERFECT_DESC	<MCG> survived unharmed!
$PARTY_PERFECT_WORD	Perfect
$PARTY_PERFECT+	PERFECT!+
$PARTY_PERFECT+_DESC	<MCG> was unharmed!<N><ALLY> was injured!
$PARTY_PERFECT++	PERFECT!++
$PARTY_PERFECT++_DESC	<MCG> and <ALLY><N>were unharmed!
$PARTY_POINT	point
$PARTY_POINTS	points
$PARTY_PSI	PSI
$PARTY_RANGE	Range:<T>
$PARTY_RE_ASSIGN	Re-assign all of <NAME>'s skills?<N>Cost: <COST><N>Scrap: <SCRAP>
$PARTY_REACHED_WAVE_X	Reached wave <X>
$PARTY_REDESIGN	Redesign
$PARTY_REGEN	Regen:<T>
$PARTY_RENAME	Rename
$PARTY_RESET_POINTS	Reset pts
$PARTY_RESET_POINTS2	<RE>$PARTY_RESET_POINTS
$PARTY_RETURN_TOWN	Return to Town
$PARTY_SPEED	Speed:<T>
$PARTY_TOTAL	Total
$PARTY_WELL_DONE	WELL DONE!
$PARTY_X_NEW_ACHIEVE	<NUM> new achievements!
$PARTY_X_PTS	<X> pts
$PARTY_XP	XP
$REWARD_FINISH	Ends the game
$REWARD_GOLD	<PLUS> <GOLD> SCRAP
$REWARD_NEXT_LEVEL	Unlocks next level
$REWARD_NO_GOLD	Nothing!
$REWARD_NO_XP	Nothing!
$REWARD_QUEST	Quest completed
$REWARD_XP	<PLUS> <XP> XP
$RQ	”
$SAVE_SLOT_DELETE	Delete
$SAVE_SLOT_DELETE_TEXT	Permanently deletes this save slot from your computer. You know what you're doing, right?
$SAVE_SLOT_DELETE_TITLE	Delete save slot
$SAVE_SLOT_EXPORT	Export
$SAVE_SLOT_EXPORT_TEXT	Backup your save slot to a simple text file.
$SAVE_SLOT_EXPORT_TITLE	Export save to file
$SAVE_SLOT_IMPORT	Import
$SAVE_SLOT_IMPORT_TEXT	Browse your computer for a Defender's Quest save file to use.
$SAVE_SLOT_IMPORT_TITLE	Import save from file
$SAVE_SLOT_NEW_GAME	New Game
$SAVE_SLOT_NEW_GAME_PLUS	New Game+
$SAVE_SLOT_NEW_GAME_PLUS_TEXT	Starts a new, more challenging quest, while keeping all of your experience, skills, and equipment. New Game+ features new enemy types, new sidequests, more powerful equipment, and a greatly expanded journal. <N><N>NOTE: Party progress is SHARED between your original game and New Game+. You can freely go back and forth between them at any time without losing anything.
$SAVE_SLOT_NEW_GAME_PLUS_TITLE	Start a New Game+
$SAVE_SLOT_PLAY	Play
$SAVE_SLOT_PLAY_PLUS	Play+
$SAVE_SLOT_PLAY_PLUS_TEXT	Party progress is SHARED between your original game and New Game+. You can freely go back and forth between them at any time without losing anything.
$SAVE_SLOT_PLAY_PLUS_TITLE	Resume New Game+
$SKILL_DESC_ADDS_CHANCE_TO_ALL	Adds <PERCENT>%<EXTRA> chance of <FLAV>* to all attacks.
$SKILL_DESC_ADDS_CHANCE_TO_ONE	Adds <PERCENT>%<EXTRA> chance of <FLAV>* to <LQ><ATTACK><RQ>.
$SKILL_DESC_ADDS_TO_ALL	Adds <FLAV>* to all attacks.
$SKILL_DESC_ADDS_TO_ONE	Adds <FLAV>* to <LQ><ATTACK><RQ>.
$SKILL_DESC_COOLDOWN	Cooldown
$SKILL_DESC_DMG	Dmg
$SKILL_DESC_EFFECT	Effect
$SKILL_DESC_HEAL	Heal
$SKILL_DESC_HITS	Hits
$SKILL_DESC_HITS_NUM	# Hits
$SKILL_DESC_PSI_COST	Psi Cost
$SKILL_DESC_SPECIAL	Special
$SKILL_DESC_SPLASH	Splash
$SKILL_DESC_TARGET	Target
$SKILL_DESC_TOTAL_BONUS	Total bonus to <STAT>*<N>becomes +<AMOUNT><EXTRA>.
$SPECIAL_IMPROVES	Improves <FLAVOR>:
$SPECIAL_PLUS_FLAV	Adds <FLAVOR>:
$SPECIAL_SAVE_VS	Save vs. <FLAVOR> if HP >= <PERCENT>%
$STAT_DESC_ARMOR	ARMOR<N>Amount of damage absorbed.
$STAT_DESC_ARMOR_ENEMY	ARMOR<N>Amount of damage absorbed.
$STAT_DESC_ATTACK	ATTACK<N>Makes techniques do more damage.
$STAT_DESC_ATTACK_ENEMY	ATTACK<N>Damage inflicted by enemy's best attack.
$STAT_DESC_BARRIER	BARRIER<N>Layers of protection from damage. Only extremely powerful magic can lower this.
$STAT_DESC_DEFENSE	DEFENSE<N>Amount of damage absorbed.
$STAT_DESC_DEFENSE_ENEMY	ARMOR<N>Amount of damage absorbed.
$STAT_DESC_EVADE	EVADE<N>Chance of avoiding enemy attacks.
$STAT_DESC_EVADE_ENEMY	EVADE<N>Chance of avoiding attacks.
$STAT_DESC_FINAL_HIT	FINAL HIT<N>How much damage <FINAL_HIT_TARGET> receives when enemy reaches the end.
$STAT_DESC_HP	HIT POINTS<N>If it reaches 0, you're knocked out of battle.
$STAT_DESC_PHASING	PHASING<N>Periodically phases in and out;Can't be targetted or hit when phased out.<N>Pattern is tiles (in, out).
$STAT_DESC_RANGE	RANGE<N>Size of attack radius.
$STAT_DESC_RANGE_ENEMY	RANGE<N>Size of attack radius.
$STAT_DESC_REGEN	REGENERATION<N>How fast HP recovers in HP/sec.
$STAT_DESC_REGEN_ENEMY	REGENERATION<N>How fast HP recovers in HP/sec.
$STAT_DESC_SPAWN	SPAWNS:<N>
$STAT_DESC_SPEED	SPEED<N>Attack cooldown speed:<N>Every <SPEED_SHOW_MULT> points increases cooldown speed by 1x
$STAT_DESC_SPEED_ENEMY	SPEED<N>How fast an enemy moves and attacks. 1 point = 1 tile per second.
$STAT_DESC_SPELLS	SPELLS
$STAT_DESC_STRONGS	STRENGTHS
$STAT_DESC_THORNS	THORNS<N>Deals this much damage to a melee attacker.
$STAT_DESC_WEAKS	WEAKNESSES
$STAT_DESC_XP	EXPERIENCE<N>
$STATE_CRASH_DETAILS	Details:
$STATE_CRASH_PROMPT	What would you like to do?
$STATE_CRASH_SEND	Send report<N>to developer
$STATE_CRASH_SHOW_DUMP	Show crash<N>dump files
$STATE_CRASH_TITLE	Critical Error!
$STATUS_DESC_ANONYMOUS	<PLUS><PERCENT>% chance to dodge.
$STATUS_DESC_BLEED	Takes +<PERCENT>% DMG.
$STATUS_DESC_BLINDED	Attacks miss <PERCENT>% of the time.
$STATUS_DESC_BURN	<AMT_1DIG> DMG/sec<N>Cancelled by ice.
$STATUS_DESC_CHILL	-<PERCENT>% speed.<N>Cancelled by fire.
$STATUS_DESC_DARK	Dodges non-area attacks <PERCENT>% of the time.
$STATUS_DESC_DARK_FRENZY	<RE>$STATUS_DESC_FRENZY
$STATUS_DESC_DISEASE	Regeneration reduced by <PERCENT>%
$STATUS_DESC_EVER_BLEED	<RE>$STATUS_DESC_BLEED
$STATUS_DESC_EVER_POISON	<INTI> DMG/sec.
$STATUS_DESC_FB_BORED	Can't be bothered to move.
$STATUS_DESC_FB_EXISTENTIAL	-<PERCENT>% speed, +<PERCENT>% damage resist.
$STATUS_DESC_FB_HAPPY	<PLUS><PERCENT>% speed.
$STATUS_DESC_FB_LOL	<PLUS><PERCENT>% speed.
$STATUS_DESC_FB_OMG	<PLUS><PERCENT>% speed, -<PERCENT>% damage resist.
$STATUS_DESC_FB_SAD	-<PERCENT>% speed.
$STATUS_DESC_FIRE	<RE>$STATUS_DESC_BURN
$STATUS_DESC_FREEZE	Can't move.<N>Cancelled by fire.
$STATUS_DESC_FRENZY	Speed up by <PERCENT>%	COMMENT: Status descriptions have LOTS of variables. Ask Lars is you have any questions.
$STATUS_DESC_INSPIRE	<RE>$STATUS_DESC_INSPIRED
$STATUS_DESC_INSPIRED	Attacks deal +<M_MULT_PERCENT>% DMG.
$STATUS_DESC_INSPIRED_HIT	<RE>$STATUS_DESC_INSPIRED
$STATUS_DESC_LIGHT	Removes darkness.
$STATUS_DESC_POISON	<INTI> DMG/sec for <TIME> sec
$STATUS_DESC_SINGLE_STUN	Can't move. Can only be inflicted once.
$STATUS_DESC_SLOW	-<PERCENT>% speed.
$STATUS_DESC_STUN	Can't move.
$STATUS_DESC_TROLL	Dodges attacks <PERCENT> % of the time.
$STATUS_TIME_FOREVER	Lasts forever.
$STATUS_TIME_LEFT	<TIME_LEFT>/<TIME> seconds left.
$STRONG_DMG_MULT	<PERCENT>% DMG resist vs. <FLAVOR>
$STRONG_EVADE	<PERCENT>% evade <FLAVOR>
$TALK_ASH	ASH REFUGEE
$TALK_CULTIST	CULTIST PRIEST
$TALK_NOMAD	NOMAD REFUGEE
$TALK_QUAID	QUAID REFUGEE
$TARGET_BOSS_TEXT	If not pressed, ignore boss enemies.
$TARGET_BOSS_TITLE	Target BOSS
$TARGET_BOTH_TEXT	Use techniques according to boost level.
$TARGET_BOTH_TITLE	Normal priority
$TARGET_BULLDOG_TEXT	Never change targets until the enemy leaves range or dies.<N><N>Kinda tricky, recommended for advanced players only!
$TARGET_BULLDOG_TITLE	BULLDOG mode
$TARGET_CHANCE_TEXT	Target the enemy least likely to dodge or resist the attack.
$TARGET_CHANCE_TITLE	Best CHANCE
$TARGET_CHEAP_TEXT	Save higher-boost techniques for targets that can't be killed with a lesser one.
$TARGET_CHEAP_TITLE	CHEAPEST technique
$TARGET_EFFECT_TEXT	Use status effect attacks against the least affected enemy.
$TARGET_EFFECT_TITLE	Optimize EFFECTS
$TARGET_FAST_TEXT	Target the fastest moving enemy.
$TARGET_FAST_TITLE	Target FASTEST
$TARGET_FIGHT_TEXT	Attack whenever possible, even if a better heal technique is ready.
$TARGET_FIGHT_TITLE	Prioritize FIGHTING
$TARGET_FIRST_TEXT	Target the enemy closest to the end.
$TARGET_FIRST_TITLE	Target FIRST
$TARGET_HEAL_TEXT	Heal whenever possible, even if a better attack technique is ready.
$TARGET_HEAL_TITLE	Prioritize HEALING
$TARGET_LAST_TEXT	Target the enemy furthest from the end.
$TARGET_LAST_TITLE	Target LAST
$TARGET_SAVE_TEXT	Makes the current target settings the default for this character.
$TARGET_SAVE_TITLE	SAVE settings
$TARGET_SPECIFIC_TEXT	Manually select a specific enemy to attack, ignoring all others.
$TARGET_SPECIFIC_TITLE	Target SPECIFIC
$TARGET_STRONG_TEXT	Target the enemy with the most HP + Armor.
$TARGET_STRONG_TITLE	Target STRONGEST
$TARGET_WEAK_TEXT	Target the enemy with the least HP + Armor.
$TARGET_WEAK_TITLE	Target WEAKEST
$TIP_00_TEXT	<N><N>Sometimes it is helpful to go back and play an earlier battle to level up, get some gold, and buy better equipment. You can also try 'Casual' difficulty for a lighter challenge.
$TIP_00_TITLE	Get Stuck?
$TIP_10_TEXT	You can control the game with the keyboard!<N><N>- Select spells<N>- Select characters to summon<N>- Boost / recall defenders<N>- Pause / unpause the game<N>- Cycle through summoned defenders<N>- Change targeting/speed options<N>- Tab-navigate through any interface<N>- Move cursor/click with the keyboard<N><N>(Customize keys in the options menu)
$TIP_10_TITLE	Hotkeys
$TIP_100_TEXT	Recalling summoned defenders will let you regain a portion of the Psi you've invested in them.<N><N>The amount of recalled Psi gets lower when the defender is injured.
$TIP_100_TITLE	Recalling
$TIP_110_TEXT	If you have physical disabilities, check out the following in the options menu:<N><N>1) Video - play in fullscreen mode, scale up the visuals<N>2) Controls - remap all the controls<N>3) Accessibility - toggle effects, play speed, and experience multiplier
$TIP_110C_TEXT	If you have physical disabilities, check out the following in the options menu:<N><N>1) Controls - remap all the controls<N>2) Accessibility - toggle effects, play speed, and experience multiplier
$TIP_110_TITLE	Accessibility
$TIP_120_TEXT	This hint is simply included so nobody tries analyzing codes or deciphering enigmas.
$TIP_120_TITLE	Public Service Announcement
$TIP_130_TEXT	If you click on a defender, you can set their targeting options to favor enemies in the front, back, strong, weak, or fast - use these to optimize your attacks. For example, 'strong' can help you focus on bigger units or soften up a whole crowd.
$TIP_130C_TEXT	If you select a defender, you can set their targeting options to favor enemies in the front, back, strong, weak, or fast - use these to optimize your attacks. For example, 'strong' can help you focus on bigger units or soften up a whole crowd.
$TIP_130_TITLE	Targeting Options
$TIP_140_TEXT	In addition to basic targeting options, there are four optional settings:<N><N>1) Cheapest technique <N>2) Optimize Effects <N>3) Best Chance <N>4) Bulldog mode<N><N>These aren't necessary, but can help advanced players maximize their battle strategies. You can even save default target options for a given character!
$TIP_140_TITLE	Advanced Targeting
$TIP_150_TEXT	Fire and ice don't play well together.  Chill and freeze will cancel fire, fire will melt freeze, and will cancel chill.
$TIP_150_TITLE	Fire and Ice
$TIP_160_TEXT	The 'Advanced' and 'Extreme' difficulties will usually be too tough to try immediately.<N><N>Give them a try after you've beaten the next few battles on normal.
$TIP_160_TITLE	Higher Difficulties
$TIP_170_TEXT	When you buy new equipment for your hero characters, your old stuff makes great hand-me-downs for your other party members.
$TIP_170_TITLE	Equipment
$TIP_180_TEXT	Grouping defenders close together makes enemies spread out their attacks, making it easier for each of them to survive.<N><N>The drawback to this strategy is that you cover less area.
$TIP_180_TITLE	Strength in Numbers
$TIP_190_TEXT	If you want to adjust the game's level-up pace, you can change the global experience multiplier from the options menu.<N><N>The default setting is 100%.<N><N>You can also change the multiplier for scrap.
$TIP_190_TITLE	Reward Multiplier
$TIP_20_TEXT	Each defender gains 1 skill point whenever they level up.<N><N>Assign these points in the party menu to unlock new abilities for battle.<N><N>1) TECHNIQUES (round) - attacks used in battle<N>2) TRAITS (square) - passive, 'always-on' abilities.<N><N>More advanced techniques require boosting to use in battle.
$TIP_20_TITLE	Skills
$TIP_200_TEXT	Sometimes a particular technique may be throwing off your groove (perhaps your dragon fireballs are melting all your ice), or you just want to save a powerful attack for later. If so, you can click on the defender, then click on the technique in the menu on the lower-right to temporarily disable it.
$TIP_200C_TEXT	Sometimes a particular technique may be throwing off your groove (perhaps your dragon fireballs are melting all your ice), or you just want to save a powerful attack for later. If so, you can select the defender, then select the technique in the menu on the lower-right to temporarily disable it.
$TIP_200_TITLE	Disabling Techniques
$TIP_210_TEXT	On the save game menu, there's a button with a picture of a folder and floppy disk.<N><N>This will take you to where your saved games and configuration file are stored.
$TIP_210_TITLE	Where Are My Save Files?
$TIP_220_TEXT	After you finish the regular game, you can start a new adventure with your old party, with harder battles and crazy rewards!<N><N><RE>[$NEW_GAME_PLUS_NOTE]
$TIP_220_TITLE	New Game+
$TIP_230_TEXT	In NG+ mode, you'll be able to earn special artifacts that you can use to upgrade unique equipment from the regular game. These upgraded items have special powers!
$TIP_230_TITLE	Upgrades
$TIP_240_TEXT	Once you've earned enough stars, you'll start unlocking bonus battles. These special missions have extra challenges and extra rewards.
$TIP_240_TITLE	Bonus Missions
$TIP_250_TEXT	The Lightning spell has 'Psi burn', which burns off a proportion of the enemy's Psi reward each time.  If the spell does 40% damage to the enemy, 40% of their normal Psi reward will be removed.
$TIP_250_TITLE	Psi Burn?
$TIP_260_TEXT	Did you know you can make your own mods (modifications) of Defender's Quest?<N><N>Click on the wrench button in the save game menu.  You can change almost anything - stats, levels, classes, characters, cutscenes, graphics, items, etc.
$TIP_260_TITLE	Mod Support
$TIP_270_TEXT	<N><N>Call your mother, she misses you.
$TIP_270_TITLE	Remember Mom
$TIP_30_TEXT	<N><N>After a battle, everyone gets the same experience if they were alive and summoned at the end.<N><N>Everyone else gets half experience.  XP per character is the same regardless of number of characters.<N><N>You can change this penalty in the Accessibility menu.
$TIP_30_TITLE	Who Gets Experience?
$TIP_40_TEXT	You can click and drag to pan around the overworld, or navigate with the keyboard.<N><N>Scrolling is mapped to the arrow keys by default.
$TIP_40_TITLE	Overworld
$TIP_50_TEXT	Recalling defenders normally nets you only a portion of the invested Psi.<N><N>If you recall them before the first enemy wave spawns, however, you'll get 100% of your Psi back.
$TIP_50_TITLE	Recall for 100% Psi
$TIP_60_TEXT	If you have a question, join the Defender's Quest online community at www.defendersquest.com!<N><N>We have a forum where you can ask questions, a collaborative wiki, as well as a development blog.
$TIP_60_TITLE	Website and Forum
$TIP_70_TEXT	You can use the keyboard to place defenders in battle.<N><N>Default controls are mapped to the arrow keys.
$TIP_70_TITLE	Place Defenders
$TIP_80_TEXT	The colors of the bouncing numbers indicate damage type.  White is normal, grey is reduced by armor, red is bleeding, orange is fire, purple is poison, and big is critical. <N><N>You can turn them on and off in the options menu under 'Gameplay.'
$TIP_80_TITLE	Battle Effects
$TIP_90_TEXT	As you play levels on higher difficulties, you will occasionally find unique items.  These are powerful collectible items and cannot be sold in stores.
$TIP_90_TITLE	Unique Items
$TITLE_BONUS_GOODIES	Bonus Goodies
$TITLE_BONUS_GOODIES_2	Secrets?
$TITLE_CONNECTING_KONG	Connecting to KONG...
$TITLE_EULA_1	By playing this you agree to our
$TITLE_EULA_2	End User License Agreement
$TITLE_FULL_GAME	FULL GAME
$TITLE_OPTIONS	Options
$TITLE_PLEASE_WAIT	<RE>$MISC_PLEASE_WAIT
$TITLE_QUIT	Quit
$TITLE_RELOAD_MOD	Reload Mod
$TITLE_START	Start
$TITLE_START_DEMO	Start DEMO
$TITLE_START_GAME	Start GAME
$TITLE_UNLOAD_MOD	Unload Mod
$TOOLTIP_ADVANCED	Harder challenge, with greater rewards.<N><N>Come back when you're strong enough.
$TOOLTIP_CASUAL	In casual mode, enemies have reduced hitpoints and attack damage.
$TOOLTIP_CHANGE_PATH_1	NOTE:
$TOOLTIP_CHANGE_PATH_2	Your old files won't automatically transfer to the new location.<N><N>They will remain in the original directory.
$TOOLTIP_EXTREME	Hardest challenge, with the greatest rewards.<N><N>Be prepared!
$TOOLTIP_NORMAL	Normal challenge.<N><N>Most players should start here.
$TYPE_ARMOR	Armored
$TYPE_ATTACKER	Attacker
$TYPE_BOSS	Boss
$TYPE_CULTIST	Cultist
$TYPE_DARK	Dark
$TYPE_EXALTED	Exalted
$TYPE_FAST	Fast
$TYPE_NO_END_DAMAGE	NoEndDamage
$TYPE_NORMAL	Normal
$TYPE_NUKE_ON_KILL	NukeOnKill
$TYPE_REVENANT	Revenant
$TYPE_SHEEP	Sheep
$TYPE_SNAIL	Snail
$TYPE_SPITTER	Spitter
$TYPE_SPLITTER	Splitter
$TYPE_STATIONARY	Stationary
$TYPE_TELEPORTER	Teleporter
$TYPE_WATER	Water
$TYPE_WORM	Worm
$UI_ACCEPT_NUMS	font:18,off_y:1,off_x:-3
$UI_ACCESS_ABSENCE	ABSENCE
$UI_ACCESS_DEFAULT	*Default Settings
$UI_ACCESS_FAIL	FAILURE
$UI_ACCESS_FAILURE_PENALTY	Failure Penalty
$UI_ACCESS_FLASHING	Flashing Effects
$UI_ACCESS_NUMS	font:18,off_y:1,off_x:-2,show_boxes:1,absence_off_x:0,speed_off_x:0
$UI_ACCESS_PENALTIES	PENALTIES
$UI_ACCESS_REWARDS	REWARDS
$UI_ACCESS_SEE_ALSO	See Also:
$UI_ACCESS_SPEED	Game Speed
$UI_ACCESS_TITLE	Accessibility
$UI_ACHIEVE_CATEGORIES	Categories
$UI_ACHIEVE_COMPLETION	Completion
$UI_ACHIEVE_EASY	Easy
$UI_ACHIEVE_HARD	Hard
$UI_ACHIEVE_IMPOSSIBLE	Impossible
$UI_ACHIEVE_MEDIUM	Medium
$UI_ACHIEVE_POP_UP	Pop-up Notifier
$UI_ACHIEVE_TRAINER	Trainer
$UI_ACHIEVEMENTS_BUTTON_NUMBERS	font:18,offy:-2
$UI_ACHIEVEMENTS_NUMS	font:18,off_y:0,pop_up_off_y:0
$UI_ACHIEVEMENTS_TITLE	Achievements
$UI_AWARDS_TITLE	Awards
$UI_ALL_FILES	All Files
$UI_AUDIO_NUMS	font:18,off_y:1,off_x:-2
$UI_AUDIO_TITLE	Audio
$UI_BACK_NUMS	font:18,off_y:1,off_x:-3
$UI_BATTLE_CASH_OUT	Cash Out
$UI_BATTLE_CASH_OUT_TEXT	End the battle now and collect any rewards you've earned?
$UI_BATTLE_CASH_OUT?	Cash Out?
$UI_BATTLE_MORE	MORE
$UI_BATTLE_NEXT	NEXT
$UI_BATTLE_SEND_NEXT	Send<N>NEXT
$UI_BATTLE_WAVE	Wave
$UI_BATTLE_WAVES	Waves
$UI_BONUS_BLUE_STARS_LINE	<STAR_NUM> blue stars
$UI_BONUS_BONUS_LEVELS	Bonus Levels
$UI_BONUS_GOLD_STARS_LINE	<STAR_NUM> gold stars
$UI_BONUS_STARS_LINE	<STAR_NUM> <STAR_COLOR> stars
$UI_CLOUD_UNKNOWN	Cloud Saves
$UI_CLOUD_UNKNOWN_TEXT	<N>Enable Steam cloud saves?
$UI_CLOUD_UNKNOWN_TEXT_2	You can change this setting<N>at any time in:<N>Options:Miscellaneous
$UI_CONFLICT_BACKUP	Backup the file I don't pick to:<N><LOC>
$UI_CONFLICT_BETTER	We think this one seems better
$UI_CONFLICT_BUTTON	Use this
$UI_CONFLICT_CLOUD	CLOUD
$UI_CONFLICT_LOCAL	COMPUTER
$UI_CONFLICT_CONSOLE	CONSOLE
$UI_CONFLICT_MSG	We're not sure which of these should go in Slot <SLOT>.<N>Please pick the one you want to keep.
$UI_CONFLICT_CONFIRMATION_CLOUD	Overwrite cloud data with local data for Slot <SLOT>?
$UI_CONFLICT_CONFIRMATION_LOCAL	Overwrite local data with cloud data for Slot <SLOT>?
$UI_CONFLICT_NGP	New Game+
$UI_CONFLICT_TITLE	Cloud Conflict!
$UI_CONFLICT_CONFIRM	Confirm Overwrite
$UI_CONTROLS_ACCEL	Acceleration
$UI_CONTROLS_INERTIA	Inertia
$UI_CONTROLS_ACCEPT	Accept
$UI_CONTROLS_ACCEPT_SELECT	Accept/Select
$UI_CONTROLS_AUTO	Auto
$UI_CONTROLS_BACK	Back
$UI_CONTROLS_BACK_CANCEL	Back/Cancel
$UI_CONTROLS_BOOST	Boost
$UI_CONTROLS_CANCEL	Cancel
$UI_CONTROLS_CHARACTER	Character
$UI_CONTROLS_CLASS	Class
$UI_CONTROLS_CLICK	Click
$UI_CONTROLS_CURSOR	Cursor
$UI_CONTROLS_CYCLE	Cycle<N>Defenders
$UI_CONTROLS_CYCLE_NUMS	off_x:-5,off_y:0
$UI_CONTROLS_DEVICE	Device
$UI_CONTROLS_FAST	Fast
$UI_CONTROLS_GAMEPAD	Gamepad
$UI_CONTROLS_GAMEPAD_MODEL	Model
$UI_CONTROLS_GAMEPAD_ICONS	Icons
$UI_CONTROLS_GAMEPAD_ACTION_SET	Action Set
$UI_CONTROLS_KEYBOARD	Mouse & Keyboard
$UI_CONTROLS_STEAM_CONTROLLER	Steam Controller
$UI_CONTROLS_LOGITECH	Logitech
$UI_CONTROLS_MENU	Menu
$UI_CONTROLS_MENU_ALT	Menu 2
$UI_CONTROLS_MINUS_PLUS_SPEED	-/+<N>Speed
$UI_CONTROLS_MINUS_SPEED	- Speed
$UI_CONTROLS_MOVE_CURSOR	Move Cursor
$UI_CONTROLS_NAVIGATE_MENU	Navigate Menu
$UI_CONTROLS_NONE	None
$UI_CONTROLS_NORMAL	Normal
$UI_CONTROLS_NUMS	font:18,off_y:1,off_x:-2
$UI_CONTROLS_OUYA	Ouya
$UI_CONTROLS_PAUSE	Pause
$UI_CONTROLS_PLUS_SPEED	<PLUS> Speed
$UI_CONTROLS_POINTER	Pointer
$UI_CONTROLS_PRESET_AZERTY	Azerty
$UI_CONTROLS_PRESET_COLEMAK	Colemak
$UI_CONTROLS_PRESET_CUSTOM	Custom
$UI_CONTROLS_PRESET_DEFAULT	Default
$UI_CONTROLS_PRESET_DVORAK	Dvorak
$UI_CONTROLS_PRESET_LEFTY	Lefty
$UI_CONTROLS_PRESET_PS	PlayStation
$UI_CONTROLS_PRESET_PSJ	Japanese
$UI_CONTROLS_PRESET_QWERTY	Qwerty
$UI_CONTROLS_PRESET_QWERTZ	Qwertz
$UI_CONTROLS_PRESET_WIIU	WiiU Default
$UI_CONTROLS_PRESET_XBOX	XBox Default
$UI_CONTROLS_PRESETS	Presets
$UI_CONTROLS_PS3	Playstation 3
$UI_CONTROLS_PS4	Playstation 4
$UI_CONTROLS_PSVITA	Playstation Vita
$UI_CONTROLS_RECALL	Recall
$UI_CONTROLS_SCROLL	Scroll Map,<N>Place Defender
$UI_CONTROLS_SEE_ALSO	See Also:
$UI_CONTROLS_SELECT	Select
$UI_CONTROLS_SLOW	Slow
$UI_CONTROLS_SLOWEST	Slowest
$UI_CONTROLS_SPEED	Speed
$UI_CONTROLS_SPELL	Spell
$UI_CONTROLS_TAB_NAV	Tab<N>Navigation
$UI_CONTROLS_TARGET	Target
$UI_CONTROLS_TITLE	Controls
$UI_CONTROLS_VIRTUAL_MOUSE	Virtual Mouse
$UI_CONTROLS_XBOX1	Xbox One
$UI_CONTROLS_XBOX360	Xbox 360
$UI_CONTROLS_XINPUT	Xinput
$UI_CONTROLS_STEAM_CONTROLLER_CONFIG	Configure
$UI_CONTROLS_STEAM_CONTROLLER_CONFIG_FAIL_TITLE	Steam Error!
$UI_CONTROLS_STEAM_CONTROLLER_CONFIG_FAIL_TEXT	Couldn't open configuration screen: is Steam in Big Picture mode and is Steam overlay working?
$UI_DEFENDER_BOOST	BOOST: <PSI> Psi
$UI_DEFENDER_BOOST_MAX	MAXIMUM BOOST
$UI_DEFENDER_BOOST_NEED	BOOST: Need <PSI> Psi
$UI_DEFENDER_BOOST_NEED2	<RE>$UI_DEFENDER_BOOST_NEED
$UI_DEFENDER_BOOST_UNLOCK	Unlocks at BOOST LEVEL <LVL>
$UI_DEFENDER_CLICK_TO	(Click to enable/disable)
$UI_DEFENDER_CLICK_TO_CONSOLE	(Select to enable/disable)
$UI_DEFENDER_RECALL	Recall
$UI_DEFENDER_RECALL_LINE	RECALL:<N>+<PSI> Psi
$UI_DEFENDER_TECHNIQUE	Technique
$UI_DEFENDER_TECHNIQUES	TECHNIQUES
$UI_DEFENDER_TRAIT	Trait
$UI_DEFENDER_TRAITS	TRAITS
$UI_DEFQ_MODS	Mod
$UI_DEMO_IMPORT_OPTIONS	Import option settings from demo?
$UI_DEMO_IMPORT_SAVES	Import saves from demo?
$UI_DEMO_OPTIONS_DETECTED	Demo Options Detected!
$UI_DEMO_SAVES_DETECTED	Demo Saves Detected!
$UI_DOWNLOAD_BODY	Click a button to download the<N>desktop version of the game.<N><N>It will download in a new window/tab.<N>There might be a slight delay, so give it<N>a minute and try not to spam the buttons.
$UI_DOWNLOAD_LINUX	Linux
$UI_DOWNLOAD_MACINTOSH	Macintosh
$UI_DOWNLOAD_SOUNDTRACK	Soundtrack
$UI_DOWNLOAD_WARNING	DISABLE YOUR<N>POP-UP BLOCKER!
$UI_DOWNLOAD_WINDOWS	Windows
$UI_DQ_SAVE_FILES	DQ<X> Save Files
$UI_EQUIP_ALL_A_HEAVY	All heavy armor equipped!
$UI_EQUIP_ALL_A_HEAVY_EQUIPPED	All heavy armor equipped!
$UI_EQUIP_ALL_A_LIGHT	All light armor equipped!
$UI_EQUIP_ALL_A_LIGHT_EQUIPPED	All light armor equipped!
$UI_EQUIP_ALL_ACC_BOOK	All books equipped!
$UI_EQUIP_ALL_W_BOW	All bows equipped!
$UI_EQUIP_ALL_W_BOW_EQUIPPED	All bows equipped!
$UI_EQUIP_ALL_W_STAFF	All staffs equipped!
$UI_EQUIP_ALL_W_STAFF_EQUIPPED	All staffs equipped!
$UI_EQUIP_ALL_W_SWORD	All swords equipped!
$UI_EQUIP_ALL_W_SWORD_EQUIPPED	All swords equipped!
$UI_EQUIP_CANT_SELL_UNIQUE	Can't sell unique items!
$UI_EQUIP_CANT_UPGRADE_A_HEAVY	You have no heavy armor I could improve!
$UI_EQUIP_CANT_UPGRADE_A_LIGHT	You have no light armor I could improve!
$UI_EQUIP_CANT_UPGRADE_W_BOW	You have no bows I could improve!
$UI_EQUIP_CANT_UPGRADE_W_STAFF	You have no staffs I could improve!
$UI_EQUIP_CANT_UPGRADE_W_SWORD	You have no swords I could improve!
$UI_EQUIP_CLASS_CANT_A	This class can't equip armor!
$UI_EQUIP_CLASS_CANT_W	This class can't equip weapons!
$UI_EQUIP_COMPARE	compare
$UI_EQUIP_EQUIP_AFTER	Equip after purchase
$UI_EQUIP_EQUIP_WHO	Who will equip it?
$UI_EQUIP_EQUIPPED	Equipped
$UI_EQUIP_MAX_OWNED	MAXIMUM OWNED
$UI_EQUIP_NAME	Name
$UI_EQUIP_NO_A_HEAVY	No heavy armor owned!
$UI_EQUIP_NO_A_HEAVY	No heavy armor owned!
$UI_EQUIP_NO_A_LIGHT	No light armor owned!
$UI_EQUIP_NO_A_LIGHT	No light armor owned!
$UI_EQUIP_NO_ACC_BOOK	No books owned!
$UI_EQUIP_NO_W_BOW	No bows owned!
$UI_EQUIP_NO_W_BOW	No bows owned!
$UI_EQUIP_NO_W_STAFF	No staffs owned!
$UI_EQUIP_NO_W_STAFF	No staffs owned!
$UI_EQUIP_NO_W_SWORD	No swords owned!
$UI_EQUIP_NO_W_SWORD	No swords owned!
$UI_EQUIP_OWNED	owned
$UI_EQUIP_OWNER	Owner
$UI_EQUIP_PRICE	price
$UI_EQUIP_SELL_OLD_ARMOR_FOR	Sell old armor for <SELL_PRICE> Scrap?
$UI_EQUIP_SELL_OLD_WEAPON_FOR	Sell old weapon for <SELL_PRICE> Scrap?
$UI_EQUIP_SHOW_EQUIPPED	Show Equipped
$UI_EQUIP_SHOW_EQUIPPED	Show equipped
$UI_EQUIP_STAT	Stat
$UI_EQUIP_WHO_WILL	Who will equip:
$UI_EULA_TITLE	END USER LICENSE AGREEMENT
$UI_GAMEPLAY_ALWAYS	Always
$UI_GAMEPLAY_AUTO_UPDATE	Auto-Updater
$UI_GAMEPLAY_BATTLE_NUMBERS	Battle Numbers
$UI_GAMEPLAY_CLOUD_SAVE	Cloud Saves
$UI_GAMEPLAY_DEFAULT	New Battles Only
$UI_GAMEPLAY_DIALOGUE	Dialogue
$UI_GAMEPLAY_CUTSCENES	<RE>$UI_VIDEO_CUTSCENES
$UI_GAMEPLAY_DISABLE_UPDATER	Disable auto-updater
$UI_GAMEPLAY_ENABLE_UPDATER	Check for updates when game starts
$UI_GAMEPLAY_HIDE	Hide
$UI_GAMEPLAY_MISCELLANEOUS	Miscellaneous
$UI_GAMEPLAY_NEVER	Never
$UI_GAMEPLAY_OFF	Off
$UI_GAMEPLAY_ON	On
$UI_GAMEPLAY_SHOW	Show
$UI_GAMEPLAY_SLOW_FOOTNOTE	Might slow down the game
$UI_GAMEPLAY_TRACK_NO	Don't track me, bro!
$UI_GAMEPLAY_TRACK_YES	Let us track anonymous play stats
$UI_GAMEPLAY_TRACKING	Data Tracking
$UI_GAMEPLAY_TUTORIALS	Tutorials
$UI_GRAPHICS_HD	HD
$UI_GRAPHICS_ORIGINAL	Original
$UI_HIGH	High
$UI_HIGH()	High(<X>)
$UI_LEGACY_IMPORT_SAVES	Import saves from old version of Defender's Quest?
$UI_LEGACY_SAVES_DETECTED	Legacy Saves Detected!
$UI_LOGGING_ALWAYS	Always
$UI_LOGGING_ASK	Ask each time
$UI_LOGGING_CRASH	Record crash logs
$UI_LOGGING_CRASH_CONTENT	Include with crash log:
$UI_LOGGING_CRASH_OPTIONS	Game settings
$UI_LOGGING_CRASH_REPLAY	User input records
$UI_LOGGING_CRASH_SAVES	Save files
$UI_LOGGING_CRASH_SCREENSHOT	Screenshot
$UI_LOGGING_CRASH_SYSTEM	System specs
$UI_LOGGING_NEVER	Never
$UI_LOGGING_SEND	Send crash logs to developer
$UI_LOGGING_TITLE	Logging
$UI_LEGAL_TITLE	Legal
$UI_LOW	Low
$UI_LOW()	Low(<X>)
$UI_MISC_NUMS	font:18,off_y:1,off_x:-2
$UI_MISC_TITLE	Miscellaneous
$UI_MOD_ALL_FILES	All Files (*.*)
$UI_MOD_AUTHOR	Author
$UI_MOD_BKGS	<PLUS>42M of Bkg art
$UI_MOD_BROWSE_QUEUE	My Mods
$UI_MOD_BROWSE_WORKSHOP	Steam Workshop
$UI_MOD_CREATE_NEW	Create new Mod
$UI_MOD_DATA_ONLY	Data Only (1M)
$UI_MOD_DEFQ_SAVE	Defender's Quest Save Files (*.dfq)
$UI_MOD_DOWNLOAD	Downloading Mod
$UI_MOD_DOWNLOAD_TEXT	
$UI_MOD_EDIT	Edit
$UI_MOD_EXISTS	Mod exists.<N>Load it?
$UI_MOD_EXPORT_CANCEL	Export Cancelled!
$UI_MOD_EXPORT_CANCEL_TEXT	Files are located at:
$UI_MOD_EXPORT_CHURN	Task <TASK_PROGRESS><N><N><TASK><N><PROGRESS>
$UI_MOD_EXPORT_FAIL	Export Failed!
$UI_MOD_EXPORT_FAIL_TEXT	There was an error!
$UI_MOD_EXPORT_FINISH	Export Complete!
$UI_MOD_EXPORT_FINISH_TEXT	Your mod is located at:
$UI_MOD_EXPORTING	Exporting Data
$UI_MOD_INSTALL_ERROR	That mod folder name exists.<N>Try installing with a suffix?
$UI_MOD_INSTALL_ERROR2	Sorry, we couldn't install the Mod.
$UI_MOD_INSTALL_STANDALONE	Install from ZIP
$UI_MOD_LATER	Later
$UI_MOD_LOAD_EXISTING	Load existing Mod
$UI_MOD_LOAD_FAIL	Loading Failed!
$UI_MOD_LOAD_FAIL_TEXT	Error loading mod:
$UI_MOD_LOAD_FINISH	Loading Complete
$UI_MOD_LOAD_FINISH_TEXT	Mod loaded successfully.<N>Game will now Restart.
$UI_MOD_LOAD_MOD	Load Mod
$UI_MOD_LOAD_MOD_TEXT	Load mod <LQ><MOD><RQ>?<N>This will restart the game.
$UI_MOD_LOADING	Loading Mod...
$UI_MOD_MISSING	Couldn't find settings.xml.<N>Either there's no mod there,<N>or it's broken.
$UI_MOD_MISSING_SUBSCRIBE	Subscribed Files
$UI_MOD_MISSING_SUBSCRIBE_TEXT	Would you like to download:<N><NUM> subscribed workshop file(s)?
$UI_MOD_MOD_INCOMPAT_TEXT	<N>File is from a different mod,<N>it might be incompatible.<N><N>Try importing anyway?
$UI_MOD_MOVIES	<PLUS>13M of Movie art
$UI_MOD_NAME	Enter a Name for this Mod
$UI_MOD_NORM_INCOMPAT_TEXT	<N>A mod is active, but that<N>file is from the normal game,<N>it might be incompatibile.<N><N>Try importing anyway?
$UI_MOD_NOT_DIR	Whoa!<N>That's not even a directory!<N>Try Again.
$UI_MOD_PATH	Mod Files Path...
$UI_MOD_PLAY	Play
$UI_MOD_PLEASE_WAIT	Please Wait While<N>We Load Your Mod
$UI_MOD_PROGRESS	Task <TASK><N>File <FILE><N>
$UI_MOD_SELECT_DIR	Select Mod Directory
$UI_MOD_SHARE	Share
$UI_MOD_SHARE_TEXT_LOCAL	This will package your mod into a single file for easy distribution.
$UI_MOD_SHARE_TEXT_STEAM	This will package and upload your mod to Steam Workshop.
$UI_MOD_SHARE_TITLE	Share Mod
$UI_MOD_SHARED	Shared
$UI_MOD_SPRITES	<PLUS>4M of Sprites
$UI_MOD_STEAM_SEND	Sending to Steam
$UI_MOD_STEAM_UPLOAD	Uploading to Steam...
$UI_MOD_STEAM_WAIT	Waiting for response from Steam...<N>(Might be a short wait)
$UI_MOD_SUBSCRIBED	Subscribed
$UI_MOD_TEMPLATE_SETTINGS	Mod Template Settings
$UI_MOD_TITLE	Modifications
$UI_MOD_TITLE	Modifications
$UI_MOD_UPDATE	Update
$UI_MOD_UPDATE_STEAM_FINISH	Update Complete
$UI_MOD_UPDATE_STEAM_FINISH_TEXT	Mod successfully updated on<N>Steam Workshop
$UI_MOD_UPDATE_TEXT_STEAM	This will update your mod on Steam Workshop.
$UI_MOD_WEB_BROWSER	Web Browser
$UI_MOD_WORKSHOP	Workshop
$UI_MOD_ZIP_FAIL	Packaging Failed!
$UI_MOD_ZIP_FAIL_TEXT	There was an error while zipping the files.
$UI_MOD_ZIP_FILES	Zip Files (*.*)
$UI_MOD_ZIP_FINISH	Packaging Complete
$UI_MOD_ZIP_FINISH_TEXT	Mod zipped successfully.
$UI_MOD_ZIP_PROGRESS	Task <TASK><N>File <FILE><N>
$UI_MOD_ZIP_STEAM_FAIL	Upload Failed!
$UI_MOD_ZIP_STEAM_FAIL_TEXT	Could not upload the mod to<N>Steam Workshop.
$UI_MOD_ZIP_STEAM_FINISH	Upload Complete
$UI_MOD_ZIP_STEAM_FINISH_TEXT	Mod successfully uploaded to<N>Steam Workshop
$UI_MOD_ZIPPING	Packaging Mod Files
$UI_MOVIE_END	end
$UI_MOVIE_QUEST	quest
$UI_MOVIE_SCENE	scene
$UI_MOVIE_SELECT_A_MOVIE	Select a Movie
$UI_MUSIC	Music:
$UI_NORM_MOD_INCOMPAT_TEXT	<N>File is from a mod,<N>it might be incompatibile.<N><N>Try importing anyway?
$UI_OPTIONS_MENU	Options Menu
$UI_OPTIONS_NUMS	font:18,off_y:1,off_x:-2
$UI_OPTIONS_SPEED	Game Speed
$UI_OPTIONS_TITLE	Options
$UI_QUIT_NUMS	font:18,off_y:1,off_x:-2
$UI_RECRUIT_BERSERKER_NUMS	font:14,x_off:0,y_off:0
$UI_RECRUIT_CLASS_FULL	CLASS IS FULL
$UI_RECRUIT_DRAGON_NUMS	font:14,x_off:0,y_off:0
$UI_RECRUIT_HEALER_NUMS	font:14,x_off:0,y_off:0
$UI_RECRUIT_KNIGHT_NUMS	font:14,x_off:0,y_off:0
$UI_RECRUIT_MAGE_NUMS	font:14,x_off:0,y_off:0
$UI_RECRUIT_RANGER_NUMS	font:14,x_off:0,y_off:0
$UI_RESOLUTION_CHOICES	Available:
$UI_RESOLUTION_CURRENT	Current:
$UI_RESOLUTION_CURRENT_PARENTHESES	(Current)
$UI_RESOLUTION_TITLE	Monitor Resolution
$UI_RESTART_NUMS	font:18,off_y:1,off_x:-2
$UI_SAVE_CONFIRM_DELETE	Confirm Delete?
$UI_SAVE_CONFIRM_DELETE_TEXT	PERMANENTLY erase this<N>save slot?
$UI_SAVE_DEMO_ATTENTION	Attention!
$UI_SAVE_DEMO_IMPORT	Demo Import
$UI_SAVE_DEMO_IMPORT_TEXT	That file is from the DEMO. Some adjustments might be made.<N>Is that cool?
$UI_SAVE_DEMO_NEWER	File is from NEWER version of game,<N>it might be incompatibile.<N>Try importing anyway?
$UI_SAVE_DEMO_OLDER	File is from OLDER version of game<N>some adjustments might be made.<N>Is that cool?
$UI_SAVE_ERROR_INCOMPAT	Incompatible!
$UI_SAVE_ERROR_INCOMPAT_TEXT	Error! You're playing the DEMO<N>and that file is from the FULL version
$UI_SAVE_MENU_CHECK_GOG	Check GOG for free updates!
$UI_SAVE_MENU_DOWNLOAD	Get downloadable version
$UI_SAVE_MENU_FULL_VERSION	Full Version
$UI_SAVE_MENU_KONG_DEMO	<RE>$MISC_DEMO_VERSION
$UI_SAVE_MENU_KONG_DEMO_LOGIN_FULL	Demo - Log in to kongregate to access the full game!
$UI_SAVE_MENU_KONG_DEMO_LOGIN_XDEMO	Demo - Log in to kongregate to access extended content!
$UI_SAVE_MENU_KONG_XDEMO	Extended Demo Version
$UI_SAVE_MENU_KONG_XDEMO_LOGIN	Extended Demo - Log in to kongregate to access the full game!
$UI_SAVE_MENU_LOADED	Loading Complete!
$UI_SAVE_PATH	Save Files Path...
$UI_SAVE_SELECT_DIR	Select Save Directory
$UI_SELECT_A_FILE_TEXT	Please select a save file to import
$UI_SELECT_A_FILE_TITLE	Select a file please!
$UI_SFX	SFX:
$UI_SKILLS_CLICK_TO_UPGRADE	Click to Upgrade.
$UI_SKILLS_MAX	MAXIMUM
$UI_SKILLS_MOUSE_OVER	Mouse-over to inspect.
$UI_SKILLS_NO_LEARN_SPELL	You haven't learned<N>this spell yet.
$UI_SKILLS_NO_POINTS	No points.
$UI_SKILLS_REQ_1PT	REQUIRES: Char. LVL <LVL>,<N><PT> point in <SKILL>
$UI_SKILLS_REQ_XPT	REQUIRES: Char. LVL <LVL>,<N><PT> points in <SKILL>
$UI_TIPS_TITLE	Tips & Tricks
$UI_UPDATER_ASK_DOWNLOAD	Download the update?
$UI_UPDATER_CANCEL	<RE>$MISC_CANCEL
$UI_UPDATER_CHECKING	Checking for updates...
$UI_UPDATER_CHECKSUM	Calculating checksum...
$UI_UPDATER_CHECKSUM_MISMATCH	The file's checksum didn't match what we expected.<N><N>Possible causes are an incomplete download (likely), a security problem (unlikely), or cosmic rays (you never know!).<N><N>Either way, the update failed.
$UI_UPDATER_CLOSE_WINDOW	You must close this window before installing the update.
$UI_UPDATER_CONNECT_AGAIN	Connecting Again
$UI_UPDATER_CONNECTING	Connecting to server...
$UI_UPDATER_CURRENT_VERSION	Current Version:<T>
$UI_UPDATER_DEB	DEB package
$UI_UPDATER_DETAILS	Details:
$UI_UPDATER_DOWNLOADED	Update Downloaded!
$UI_UPDATER_DOWNLOADING_FILE	Downloading update file...
$UI_UPDATER_DOWNLOADING_SIG	Downloading update signature...
$UI_UPDATER_ERROR!	ERROR!
$UI_UPDATER_EXITING	Exiting Application...
$UI_UPDATER_FILE_IS_AT	Your update file is located at:
$UI_UPDATER_GIVE_UP	Give Up
$UI_UPDATER_IF_NO_WINDOW	If a navigation folder does not open, try going there manually.
$UI_UPDATER_INSTALLING	Installing Update...
$UI_UPDATER_NAVIGATE_NOW	Navigate to file now?
$UI_UPDATER_NAVIGATING	Navigating to file...
$UI_UPDATER_NEWEST_VERSION	Newest   Version:<T>
$UI_UPDATER_NO_BIG_DEAL	This isn't a big deal, you can still play the game, you just can't reach the update server right now.
$UI_UPDATER_NO_DOWNLOAD	Couldn't download update file.
$UI_UPDATER_NO_INFO	Couldn't find update info on server.
$UI_UPDATER_NO_UPDATES	No updates are available
$UI_UPDATER_NO_VERIFY	Couldn't verify update file.
$UI_UPDATER_NOTE	Note:
$UI_UPDATER_PLEASE_WAIT	<RE>$MISC_PLEASE_WAIT
$UI_UPDATER_RPM	RPM package
$UI_UPDATER_SECURED_WITH	This update mechanism is secured with HTTPS,<N>as well as public key fingerprint verification.
$UI_UPDATER_SECURITY	For security reasons, you must run the downloaded installer manually.<N><N>This program will navigate to your file's download location.
$UI_UPDATER_SERVER_TIMEOUT	Server Timeout!
$UI_UPDATER_TARGZ	TAR.GZ archive
$UI_UPDATER_TRY_AGAIN	Try Again
$UI_UPDATER_TRYING_30	Trying for 30 seconds
$UI_UPDATER_UPDATE_EXISTS	Updated version available!
$UI_VIDEO_AOE	Hilight area attacks
$UI_VIDEO_BIT_DEPTH	Depth
$UI_VIDEO_CAN_SLOW_GAME	(Can slow game)
$UI_VIDEO_CHANGE_RES	Change Resolution
$UI_VIDEO_CHANGE_RES_BUTTON	Change it!
$UI_VIDEO_CHANGE_RES_TO	Change Resolution to <X>
$UI_VIDEO_CUTSCENES	Cutscenes
$UI_VIDEO_FULLSCREEN	Fullscreen
$UI_VIDEO_GRAPHICS	Graphics
$UI_VIDEO_HD	Wide (16:9)
$UI_VIDEO_IF_DOESNT_WORK	If the new resolution doesn't work,<N>it will revert after a few seconds.
$UI_VIDEO_MATCH_MONITOR	Match Fullscreen
$UI_VIDEO_MODE	Mode
$UI_VIDEO_MOUSE	Mouse Cursor
$UI_VIDEO_MOUSE_DEFAULT	Default
$UI_VIDEO_MOUSE_FANCY	Fancy
$UI_VIDEO_NUMS	font:18,off_y:1,off_x:-2
$UI_VIDEO_PARTICLES	Particles
$UI_VIDEO_PIXELS	Pixels
$UI_VIDEO_RECOMMENDED	Recommended:
$UI_VIDEO_REFRESH	Refresh
$UI_VIDEO_RES_CHANGED	Resolution changed.<N>Do you like it?<N><N>Reverting in <TIME> seconds
$UI_VIDEO_RESOLUTION	Fullscreen Monitor Resolution
$UI_VIDEO_SCALE	Scale
$UI_VIDEO_SCREEN_POS	Screen Position
$UI_VIDEO_SCREEN_SIZE	Game Window Size
$UI_VIDEO_SD	Standard (4:3)
$UI_VIDEO_SELECT_NEW	Select New...
$UI_VIDEO_SETTINGS	Video Settings
$UI_VIDEO_SHOW_ALL_RES	Show All Resolutions
$UI_VIDEO_SPRITES	Sprites
$UI_VIDEO_STANDARD_RATIO	(Standard ratio)
$UI_VIDEO_SWIRL	Pre-Battle Animation
$UI_VIDEO_TITLE	Video
$UI_VIDEO_WARNING	Video options disabled in browser mode.
$UI_VIDEO_WARNING2	Your system configuration does not support in-game resolution switching, unfortunately :(
$UI_VIDEO_WARNING3	In COMPATIBILITY MODE, resolution switching is disabled.<N><N>Sorry about that!
$UI_VIDEO_WIDESCREEN	(Widescreen)
$UI_VIDEO_WINDOWED	Windowed
$WEAK_DMG_MULT	<PLUS><PERCENT>% extra DMG from <FLAVOR>
$YOU_GOT	You got
$YOU_GOT_JOIN	<NAME> the <CLASS><N>joined the party!
$YOU_GOT_MONEY	You got <MONEY> scrap!
$YOU_GOT_NEW_GAME_PLUS_TEXT	Congratulations! You can now start a new adventure with your old party!<N><N>Face mutant enemies with new abilities, infuse your equipment with amazing new powers, and stock your library with many new books. Engage in numerous new side-quests with additional cutscenes and story, unlock developer commentary, translate Eztli-Tenoch's speech, meet new characters, and so much more!<N><N><RE>[$NEW_GAME_PLUS_NOTE]<N><N>You can return to your <LQ>regular<RQ> game at any time.
$YOU_GOT_NEW_GAME_PLUS_TITLE	New Game+ Unlocked!
$YOU_GOT_NO_EQUIP	This item cannot be equipped.
$YOU_GOT_NO_EQUIP_YET	No one in your party can equip <THING> yet.<N>Don't worry, just keep playing and new characters will show up who can.
$YOU_GOT_X	<NUM>x <THING>!
$GAMEPAD_TEMP_SPACER	,,,,
$GAMEPAD_BUTTON_SPACER	
$ACTIONS_MENUCONTROLS	Menu
$ACTIONS_MENUCONTROLSWITHANALOG	Menu
$ACTIONS_CUTSCENECONTROLS	Cutscene
$ACTIONS_BATTLECONTROLS	Battle
$ACTIONS_MAPCONTROLS	Overworld Map
$ACTIONS_MENU_MENU	Menu
$ACTIONS_MENU_SELECT	Select
$ACTIONS_MENU_CANCEL	Cancel
$ACTIONS_MENU_THING_1	Choice 1
$ACTIONS_MENU_THING_2	Choice 2
$ACTIONS_MENU_THING_3	Choice 3
$ACTIONS_MENU_MOVE	Move Cursor
$GAMEPAD_A	A button
$GAMEPAD_B	B button
$GAMEPAD_X	X button
$GAMEPAD_Y	Y button
$GAMEPAD_BACK	Back button
$GAMEPAD_START	Start button
$GAMEPAD_LEFT_SHOULDER	Left shoulder button
$GAMEPAD_RIGHT_SHOULDER	Right shoulder button
$GAMEPAD_LEFT_TRIGGER	Left analog trigger
$GAMEPAD_RIGHT_TRIGGER	Right analog trigger
$GAMEPAD_DPAD	Directional pad
$GAMEPAD_DPAD_UP	Directional pad up
$GAMEPAD_DPAD_DOWN	Directional pad down
$GAMEPAD_DPAD_LEFT	Directional pad left
$GAMEPAD_DPAD_RIGHT	Directional pad right
$GAMEPAD_LEFT_ANALOG_STICK	Left-hand analog stick
$GAMEPAD_LEFT_ANALOG_STICK_X_MINUS	Left-hand analog stick, pointing LEFT
$GAMEPAD_LEFT_ANALOG_STICK_X_PLUS	Left-hand analog stick, pointing RIGHT
$GAMEPAD_LEFT_ANALOG_STICK_Y_MINUS	Left-hand analog stick, pointing UP
$GAMEPAD_LEFT_ANALOG_STICK_Y_PLUS	Left-hand analog stick, pointing DOWN
$GAMEPAD_RIGHT_ANALOG_STICK	Right-hand analog stick
$GAMEPAD_RIGHT_ANALOG_STICK_X_MINUS	Right-hand analog stick, pointing LEFT
$GAMEPAD_RIGHT_ANALOG_STICK_X_PLUS	Right-hand analog stick, pointing RIGHT
$GAMEPAD_RIGHT_ANALOG_STICK_Y_MINUS	Right-hand analog stick, pointing UP
$GAMEPAD_RIGHT_ANALOG_STICK_Y_PLUS	Right-hand analog stick, pointing DOWN
$GAMEPAD_LEFT_STICK_CLICK	Left-hand analog stick, CLICKED in
$GAMEPAD_RIGHT_STICK_CLICK	Right-hand analog stick, CLICKED in
$GAMEPAD_EMPTY	Nothing
$XBOX360_A	<RE>$GAMEPAD_A
$XBOX360_B	<RE>$GAMEPAD_B
$XBOX360_X	<RE>$GAMEPAD_X
$XBOX360_Y	<RE>$GAMEPAD_Y
$XBOX360_BACK	<RE>$GAMEPAD_BACK
$XBOX360_START	<RE>$GAMEPAD_START
$XBOX360_LEFT_SHOULDER	<RE>$GAMEPAD_LEFT_SHOULDER
$XBOX360_RIGHT_SHOULDER	<RE>$GAMEPAD_RIGHT_SHOULDER
$XBOX360_LEFT_TRIGGER	<RE>$GAMEPAD_LEFT_TRIGGER
$XBOX360_RIGHT_TRIGGER	<RE>$GAMEPAD_RIGHT_TRIGGER
$XBOX360_DPAD	<RE>$GAMEPAD_DPAD
$XBOX360_DPAD_UP	<RE>$GAMEPAD_DPAD_UP
$XBOX360_DPAD_DOWN	<RE>$GAMEPAD_DPAD_DOWN
$XBOX360_DPAD_LEFT	<RE>$GAMEPAD_DPAD_LEFT
$XBOX360_DPAD_RIGHT	<RE>$GAMEPAD_DPAD_RIGHT
$XBOX360_LEFT_ANALOG_STICK	<RE>$GAMEPAD_LEFT_ANALOG_STICK
$XBOX360_LEFT_ANALOG_STICK_X_MINUS	<RE>$GAMEPAD_LEFT_ANALOG_STICK_X_MINUS
$XBOX360_LEFT_ANALOG_STICK_X_PLUS	<RE>$GAMEPAD_LEFT_ANALOG_STICK_X_PLUS
$XBOX360_LEFT_ANALOG_STICK_Y_MINUS	<RE>$GAMEPAD_LEFT_ANALOG_STICK_Y_MINUS
$XBOX360_LEFT_ANALOG_STICK_Y_PLUS	<RE>$GAMEPAD_LEFT_ANALOG_STICK_Y_PLUS
$XBOX360_RIGHT_ANALOG_STICK	<RE>$GAMEPAD_RIGHT_ANALOG_STICK
$XBOX360_RIGHT_ANALOG_STICK_X_MINUS	<RE>$GAMEPAD_RIGHT_ANALOG_STICK_X_MINUS
$XBOX360_RIGHT_ANALOG_STICK_X_PLUS	<RE>$GAMEPAD_RIGHT_ANALOG_STICK_X_PLUS
$XBOX360_RIGHT_ANALOG_STICK_Y_MINUS	<RE>$GAMEPAD_RIGHT_ANALOG_STICK_Y_MINUS
$XBOX360_RIGHT_ANALOG_STICK_Y_PLUS	<RE>$GAMEPAD_RIGHT_ANALOG_STICK_Y_PLUS
$XBOX360_LEFT_STICK_CLICK	<RE>$GAMEPAD_LEFT_STICK_CLICK
$XBOX360_RIGHT_STICK_CLICK	<RE>$GAMEPAD_RIGHT_STICK_CLICK
$XBOX360_EMPTY	<RE>$GAMEPAD_EMPTY
$XBOXONE_A	A button
$XBOXONE_B	B button
$XBOXONE_X	X button
$XBOXONE_Y	Y button
$XBOXONE_BACK	View button
$XBOXONE_START	Menu button
$XBOXONE_LEFT_SHOULDER	Left bumper
$XBOXONE_RIGHT_SHOULDER	Right bumper
$XBOXONE_LEFT_TRIGGER	Left trigger
$XBOXONE_RIGHT_TRIGGER	Right trigger
$XBOXONE_DPAD	D-pad
$XBOXONE_DPAD_UP	D-pad up
$XBOXONE_DPAD_DOWN	D-pad down
$XBOXONE_DPAD_LEFT	D-pad left
$XBOXONE_DPAD_RIGHT	D-pad right
$XBOXONE_LEFT_ANALOG_STICK	Left stick
$XBOXONE_LEFT_ANALOG_STICK_X_MINUS	Left stick, pointing LEFT
$XBOXONE_LEFT_ANALOG_STICK_X_PLUS	Left stick, pointing RIGHT
$XBOXONE_LEFT_ANALOG_STICK_Y_MINUS	Left stick, pointing UP
$XBOXONE_LEFT_ANALOG_STICK_Y_PLUS	Left stick, pointing DOWN
$XBOXONE_RIGHT_ANALOG_STICK	Right stick
$XBOXONE_RIGHT_ANALOG_STICK_X_MINUS	Right stick, pointing LEFT
$XBOXONE_RIGHT_ANALOG_STICK_X_PLUS	Right stick, pointing RIGHT
$XBOXONE_RIGHT_ANALOG_STICK_Y_MINUS	Right stick, pointing UP
$XBOXONE_RIGHT_ANALOG_STICK_Y_PLUS	Right stick, pointing DOWN
$XBOXONE_LEFT_STICK_CLICK	Left stick, CLICKED in
$XBOXONE_RIGHT_STICK_CLICK	Right stick, CLICKED in
$XBOXONE_EMPTY	<RE>$GAMEPAD_EMPTY
$PS4_A	Cross button
$PS4_B	Circle button
$PS4_X	Square button
$PS4_Y	Triangle button
$PS4_BACK	SHARE button
$PS4_BACK_PS4	Touch pad button
$PS4_START	OPTIONS button
$PS4_LEFT_SHOULDER	L1 button
$PS4_RIGHT_SHOULDER	R1 button
$PS4_LEFT_TRIGGER	L2 button
$PS4_RIGHT_TRIGGER	R2 button
$PS4_DPAD	Directional buttons
$PS4_DPAD_UP	Up button
$PS4_DPAD_DOWN	Down button
$PS4_DPAD_LEFT	Left button
$PS4_DPAD_RIGHT	Right button
$PS4_LEFT_ANALOG_STICK	Left stick
$PS4_LEFT_ANALOG_STICK_X_MINUS	Left stick, pointing LEFT
$PS4_LEFT_ANALOG_STICK_X_PLUS	Left stick, pointing RIGHT
$PS4_LEFT_ANALOG_STICK_Y_MINUS	Left stick, pointing UP
$PS4_LEFT_ANALOG_STICK_Y_PLUS	Left stick, pointing DOWN
$PS4_LEFT_STICK_CLICK	L3 Button
$PS4_RIGHT_ANALOG_STICK	Right stick
$PS4_RIGHT_ANALOG_STICK_X_MINUS	Right stick, pointing LEFT
$PS4_RIGHT_ANALOG_STICK_X_PLUS	Right stick, pointing RIGHT
$PS4_RIGHT_ANALOG_STICK_Y_MINUS	Right stick, pointing UP
$PS4_RIGHT_ANALOG_STICK_Y_PLUS	Right stick, pointing DOWN
$PS4_RIGHT_STICK_CLICK	R3 Button
$PS4_EMPTY	<RE>$GAMEPAD_EMPTY
$PS3_A	<RE>$PS4_A
$PS3_B	<RE>$PS4_B
$PS3_X	<RE>$PS4_X
$PS3_Y	<RE>$PS4_Y
$PS3_BACK	Select button
$PS3_START	<RE>$GAMEPAD_START
$PS3_LEFT_SHOULDER	<RE>$PS4_LEFT_SHOULDER
$PS3_RIGHT_SHOULDER	<RE>$PS4_RIGHT_SHOULDER
$PS3_LEFT_TRIGGER	<RE>$PS4_LEFT_TRIGGER
$PS3_RIGHT_TRIGGER	<RE>$PS4_RIGHT_TRIGGER
$PS3_DPAD	<RE>$PS4_DPAD
$PS3_DPAD_UP	<RE>$PS4_DPAD_UP
$PS3_DPAD_DOWN	<RE>$PS4_DPAD_DOWN
$PS3_DPAD_LEFT	<RE>$PS4_DPAD_LEFT
$PS3_DPAD_RIGHT	<RE>$PS4_DPAD_RIGHT
$PS3_LEFT_ANALOG_STICK	<RE>$PS4_LEFT_ANALOG_STICK
$PS3_LEFT_ANALOG_STICK_X_MINUS	<RE>$PS4_LEFT_ANALOG_STICK_X_MINUS
$PS3_LEFT_ANALOG_STICK_X_PLUS	<RE>$PS4_LEFT_ANALOG_STICK_X_PLUS
$PS3_LEFT_ANALOG_STICK_Y_MINUS	<RE>$PS4_LEFT_ANALOG_STICK_Y_MINUS
$PS3_LEFT_ANALOG_STICK_Y_PLUS	<RE>$PS4_LEFT_ANALOG_STICK_Y_PLUS
$PS3_RIGHT_ANALOG_STICK	<RE>$PS4_RIGHT_ANALOG_STICK
$PS3_RIGHT_ANALOG_STICK_X_MINUS	<RE>$PS4_RIGHT_ANALOG_STICK_X_MINUS
$PS3_RIGHT_ANALOG_STICK_X_PLUS	<RE>$PS4_RIGHT_ANALOG_STICK_X_PLUS
$PS3_RIGHT_ANALOG_STICK_Y_MINUS	<RE>$PS4_RIGHT_ANALOG_STICK_Y_MINUS
$PS3_RIGHT_ANALOG_STICK_Y_PLUS	<RE>$PS4_RIGHT_ANALOG_STICK_Y_PLUS
$PS3_LEFT_STICK_CLICK	<RE>$GAMEPAD_LEFT_STICK_CLICK
$PS3_RIGHT_STICK_CLICK	<RE>$GAMEPAD_RIGHT_STICK_CLICK
$PS3_EMPTY	<RE>$PS4_EMPTY
$PSVITA_A	<RE>$PS4_A
$PSVITA_B	<RE>$PS4_B
$PSVITA_X	<RE>$PS4_X
$PSVITA_Y	<RE>$PS4_Y
$PSVITA_BACK	Select button
$PSVITA_START	<RE>$GAMEPAD_START
$PSVITA_LEFT_SHOULDER	L button
$PSVITA_RIGHT_SHOULDER	R button
$PSVITA_LEFT_TRIGGER	<RE>$PS4_LEFT_TRIGGER
$PSVITA_RIGHT_TRIGGER	<RE>$PS4_RIGHT_TRIGGER
$PSVITA_DPAD	<RE>$PS4_DPAD
$PSVITA_DPAD_UP	<RE>$PS4_DPAD_UP
$PSVITA_DPAD_DOWN	<RE>$PS4_DPAD_DOWN
$PSVITA_DPAD_LEFT	<RE>$PS4_DPAD_LEFT
$PSVITA_DPAD_RIGHT	<RE>$PS4_DPAD_RIGHT
$PSVITA_LEFT_ANALOG_STICK	<RE>$PS4_LEFT_ANALOG_STICK
$PSVITA_LEFT_ANALOG_STICK_X_MINUS	<RE>$PS4_LEFT_ANALOG_STICK_X_MINUS
$PSVITA_LEFT_ANALOG_STICK_X_PLUS	<RE>$PS4_LEFT_ANALOG_STICK_X_PLUS
$PSVITA_LEFT_ANALOG_STICK_Y_MINUS	<RE>$PS4_LEFT_ANALOG_STICK_Y_MINUS
$PSVITA_LEFT_ANALOG_STICK_Y_PLUS	<RE>$PS4_LEFT_ANALOG_STICK_Y_PLUS
$PSVITA_RIGHT_ANALOG_STICK	<RE>$PS4_RIGHT_ANALOG_STICK
$PSVITA_RIGHT_ANALOG_STICK_X_MINUS	<RE>$PS4_RIGHT_ANALOG_STICK_X_MINUS
$PSVITA_RIGHT_ANALOG_STICK_X_PLUS	<RE>$PS4_RIGHT_ANALOG_STICK_X_PLUS
$PSVITA_RIGHT_ANALOG_STICK_Y_MINUS	<RE>$PS4_RIGHT_ANALOG_STICK_Y_MINUS
$PSVITA_RIGHT_ANALOG_STICK_Y_PLUS	<RE>$PS4_RIGHT_ANALOG_STICK_Y_PLUS
$PSVITA_LEFT_STICK_CLICK	<RE>$GAMEPAD_LEFT_STICK_CLICK
$PSVITA_RIGHT_STICK_CLICK	<RE>$GAMEPAD_RIGHT_STICK_CLICK
$PSVITA_EMPTY	<RE>$PS4_EMPTY
$LOGITECH_A	2 (face) button
$LOGITECH_B	3 (face) button
$LOGITECH_X	1 (face) button
$LOGITECH_Y	4 (face) button
$LOGITECH_BACK	9 (back) button
$LOGITECH_START	10 (start) button
$LOGITECH_LEFT_SHOULDER	5 (left shoulder) button
$LOGITECH_RIGHT_SHOULDER	6 (right shoulder) button
$LOGITECH_LEFT_TRIGGER	7 (left analog) trigger
$LOGITECH_RIGHT_TRIGGER	8 (right analog) trigger
$LOGITECH_DPAD	<RE>$GAMEPAD_DPAD
$LOGITECH_DPAD_UP	<RE>$GAMEPAD_DPAD_UP
$LOGITECH_DPAD_DOWN	<RE>$GAMEPAD_DPAD_DOWN
$LOGITECH_DPAD_LEFT	<RE>$GAMEPAD_DPAD_LEFT
$LOGITECH_DPAD_RIGHT	<RE>$GAMEPAD_DPAD_RIGHT
$LOGITECH_LEFT_ANALOG_STICK	<RE>$GAMEPAD_LEFT_ANALOG_STICK
$LOGITECH_LEFT_ANALOG_STICK_X_MINUS	<RE>$GAMEPAD_LEFT_ANALOG_STICK_X_MINUS
$LOGITECH_LEFT_ANALOG_STICK_X_PLUS	<RE>$GAMEPAD_LEFT_ANALOG_STICK_X_PLUS
$LOGITECH_LEFT_ANALOG_STICK_Y_MINUS	<RE>$GAMEPAD_LEFT_ANALOG_STICK_Y_MINUS
$LOGITECH_LEFT_ANALOG_STICK_Y_PLUS	<RE>$GAMEPAD_LEFT_ANALOG_STICK_Y_PLUS
$LOGITECH_RIGHT_ANALOG_STICK	<RE>$GAMEPAD_RIGHT_ANALOG_STICK
$LOGITECH_RIGHT_ANALOG_STICK_X_MINUS	<RE>$GAMEPAD_RIGHT_ANALOG_STICK_X_MINUS
$LOGITECH_RIGHT_ANALOG_STICK_X_PLUS	<RE>$GAMEPAD_RIGHT_ANALOG_STICK_X_PLUS
$LOGITECH_RIGHT_ANALOG_STICK_Y_MINUS	<RE>$GAMEPAD_RIGHT_ANALOG_STICK_Y_MINUS
$LOGITECH_RIGHT_ANALOG_STICK_Y_PLUS	<RE>$GAMEPAD_RIGHT_ANALOG_STICK_Y_PLUS
$LOGITECH_LEFT_STICK_CLICK	<RE>$GAMEPAD_LEFT_STICK_CLICK
$LOGITECH_RIGHT_STICK_CLICK	<RE>$GAMEPAD_RIGHT_STICK_CLICK
$LOGITECH_EMPTY	<RE>$GAMEPAD_EMPTY
$WIIU_A	B button
$WIIU_B	A button
$WIIU_X	Y button
$WIIU_Y	X button
$WIIU_BACK	- (select) button
$WIIU_START	<PLUS> (start) button
$WIIU_LEFT_SHOULDER	L shoulder button
$WIIU_RIGHT_SHOULDER	R shoulder button
$WIIU_LEFT_TRIGGER	ZL analog trigger
$WIIU_RIGHT_TRIGGER	ZR analog trigger
$WIIU_DPAD	<RE>$GAMEPAD_DPAD
$WIIU_DPAD_UP	<RE>$GAMEPAD_DPAD_UP
$WIIU_DPAD_DOWN	<RE>$GAMEPAD_DPAD_DOWN
$WIIU_DPAD_LEFT	<RE>$GAMEPAD_DPAD_LEFT
$WIIU_DPAD_RIGHT	<RE>$GAMEPAD_DPAD_RIGHT
$WIIU_LEFT_ANALOG_STICK	<RE>$GAMEPAD_LEFT_ANALOG_STICK
$WIIU_LEFT_ANALOG_STICK_X_MINUS	<RE>$GAMEPAD_LEFT_ANALOG_STICK_X_MINUS
$WIIU_LEFT_ANALOG_STICK_X_PLUS	<RE>$GAMEPAD_LEFT_ANALOG_STICK_X_PLUS
$WIIU_LEFT_ANALOG_STICK_Y_MINUS	<RE>$GAMEPAD_LEFT_ANALOG_STICK_Y_MINUS
$WIIU_LEFT_ANALOG_STICK_Y_PLUS	<RE>$GAMEPAD_LEFT_ANALOG_STICK_Y_PLUS
$WIIU_RIGHT_ANALOG_STICK	<RE>$GAMEPAD_RIGHT_ANALOG_STICK
$WIIU_RIGHT_ANALOG_STICK_X_MINUS	<RE>$GAMEPAD_RIGHT_ANALOG_STICK_X_MINUS
$WIIU_RIGHT_ANALOG_STICK_X_PLUS	<RE>$GAMEPAD_RIGHT_ANALOG_STICK_X_PLUS
$WIIU_RIGHT_ANALOG_STICK_Y_MINUS	<RE>$GAMEPAD_RIGHT_ANALOG_STICK_Y_MINUS
$WIIU_RIGHT_ANALOG_STICK_Y_PLUS	<RE>$GAMEPAD_RIGHT_ANALOG_STICK_Y_PLUS
$WIIU_LEFT_STICK_CLICK	<RE>$GAMEPAD_LEFT_STICK_CLICK
$WIIU_RIGHT_STICK_CLICK	<RE>$GAMEPAD_RIGHT_STICK_CLICK
$WIIU_EMPTY	<RE>$GAMEPAD_EMPTY
$OUYA_A	O button
$OUYA_B	A button
$OUYA_X	U button
$OUYA_Y	Y button
$OUYA_BACK	<RE>$GAMEPAD_BACK
$OUYA_START	<RE>$GAMEPAD_START
$OUYA_LEFT_SHOULDER	<RE>$PS4_LEFT_SHOULDER
$OUYA_RIGHT_SHOULDER	<RE>$PS4_RIGHT_SHOULDER
$OUYA_LEFT_TRIGGER	<RE>$PS4_LEFT_TRIGGER
$OUYA_RIGHT_TRIGGER	<RE>$PS4_RIGHT_TRIGGER
$OUYA_DPAD	<RE>$GAMEPAD_DPAD
$OUYA_DPAD_UP	<RE>$GAMEPAD_DPAD_UP
$OUYA_DPAD_DOWN	<RE>$GAMEPAD_DPAD_DOWN
$OUYA_DPAD_LEFT	<RE>$GAMEPAD_DPAD_LEFT
$OUYA_DPAD_RIGHT	<RE>$GAMEPAD_DPAD_RIGHT
$OUYA_LEFT_ANALOG_STICK	<RE>$GAMEPAD_LEFT_ANALOG_STICK
$OUYA_LEFT_ANALOG_STICK_X_MINUS	<RE>$GAMEPAD_LEFT_ANALOG_STICK_X_MINUS
$OUYA_LEFT_ANALOG_STICK_X_PLUS	<RE>$GAMEPAD_LEFT_ANALOG_STICK_X_PLUS
$OUYA_LEFT_ANALOG_STICK_Y_MINUS	<RE>$GAMEPAD_LEFT_ANALOG_STICK_Y_MINUS
$OUYA_LEFT_ANALOG_STICK_Y_PLUS	<RE>$GAMEPAD_LEFT_ANALOG_STICK_Y_PLUS
$OUYA_RIGHT_ANALOG_STICK	<RE>$GAMEPAD_RIGHT_ANALOG_STICK
$OUYA_RIGHT_ANALOG_STICK_X_MINUS	<RE>$GAMEPAD_RIGHT_ANALOG_STICK_X_MINUS
$OUYA_RIGHT_ANALOG_STICK_X_PLUS	<RE>$GAMEPAD_RIGHT_ANALOG_STICK_X_PLUS
$OUYA_RIGHT_ANALOG_STICK_Y_MINUS	<RE>$GAMEPAD_RIGHT_ANALOG_STICK_Y_MINUS
$OUYA_RIGHT_ANALOG_STICK_Y_PLUS	<RE>$GAMEPAD_RIGHT_ANALOG_STICK_Y_PLUS
$OUYA_LEFT_STICK_CLICK	<RE>$GAMEPAD_LEFT_STICK_CLICK
$OUYA_RIGHT_STICK_CLICK	<RE>$GAMEPAD_RIGHT_STICK_CLICK
$OUYA_EMPTY	<RE>$GAMEPAD_EMPTY
$MISC_INPUT_0	Input:
$MISC_INPUT_1	Input 1:
$MISC_INPUT_2	Input 2:
$MISC_INPUT_3	Input 3:
$GAMEPAD_NOTE	Select to customize
$MISC_DEVICE_DISCONNECTED_TITLE	Device Disconnected!
$MISC_DEVICE_DISCONNECTED_TEXT	"<NAME>" in slot <SLOT> was disconnected!
$MISC_PLEASE_RECONNECT_CONTROLLER	Please reconnect controller
$MISC_EDIT	Edit
$SOFT_KEYBOARD_SPACE	Space
$SOFT_KEYBOARD_BACKSPACE	Backspace
$SOFT_KEYBOARD_CLEAR	Clear
$CONTROL_SWITCH_WARNING	You cannot switch fundamental input methods in the middle of a battle. Sorry about that!
$MISC_TITLE_SAFE_TEXT	Move sticks until all boxes are visible.
$MISC_UNIVERSAL	Universal
$MISC_LOAD_ORDER	Load Order
$MISC_SELECTED	Selected
$MISC_OVERWRITE	Confirm overwrite
$MISC_OVERWRITE_TEXT	Some subscribed mods conflict with local versions. Proceed with overwrites one by one?
$MISC_OVERWRITE2	Overwrite "<MODNAME>"?
$MISC_OVERWRITE_TEXT2	<SOURCE><N><N>--><N><N><DEST>
$PRESS_A	Press <A> to continue.
$MISC_REQUIRES_RESTART	(requires restart)
$MISC_PICTURE_SIZE	Picture size
$MISC_SIGNED_OUT	<USER> has signed out.
$MISC_SIGNED_IN	Signed in as <USER>.
$MISC_SWITCH_USER	Switch user
$MISC_RESTART_XBOX	Restart your Xbox?
$MISC_NO_SIGN_IN_WARNING	Your progress will not be saved unless you sign in.
$MISC_NEW_USER	New user
$MISC_CROSS_SAVE	Cross-Save
$CROSS_SAVE_RESULT_EQUAL	Slot <X>: Identical, skipped.
$CROSS_SAVE_RESULT_CONFIRM	Slot <X>: Conflicting data.
$CROSS_SAVE_RESULT_STOMP_DOWN	Slot <X>: Downloaded.
$CROSS_SAVE_RESULT_STOMP_UP	Slot <X>: Uploaded.
$CROSS_SAVE_RESULT_EMPTY	Slot <X>: Empty, skipped.
$CROSS_SAVE_RESULT_PLEASE_CONFIRM	Please review conflicts.
$CROSS_SAVE_RESULT_NO_CHANGES	No changes.
$CROSS_SAVE_RESULT_CHANGES	Success!
$MISC_NETWORK_ERROR	There was a problem connecting to the network.