flag	content	comment
$TITLE_START_DEMO	体験版開始
$TITLE_FULL_GAME	本ゲーム
$TITLE_START_GAME	ゲームをスタートする
$TITLE_START	スタート
$TITLE_QUIT	終了
$TITLE_EULA_1	これをプレイすると
$TITLE_EULA_2	最終ユーザーライセンス契約に合意したことになります
$TITLE_PLEASE_WAIT	<RE>$MISC_PLEASE_WAIT	COMMENT: this is a redirect, the text for $MISC_PLEASE_WAIT will be duplicated here. The <RE> invocation at the beginning of the string signals a redirect, and will not show up in the final text
$TITLE_BONUS_GOODIES	ボーナス
$TITLE_BONUS_GOODIES_2	おたから？
$TITLE_CONNECTING_KONG	コングにつなぐ
$TITLE_UNLOAD_MOD	MODをアンロードする
$TITLE_RELOAD_MOD	MODをリロードする
$DEMO_OVER_PLEASE_WAIT	<RE>$MISC_PLEASE_WAIT
$DEMO_OVER_DONT_FORGET	保存したファイルを忘れないでください！
$DEMO_OVER_EXPORT_HOW	このボタンで、保存したファイルをエクスポートします。
$DEMO_OVER_USE_IT	前回やめたところから始めるには、これを使ってくださいね！
$DEMO_OVER_PLAY	プレイを続けましょう！
$DEMO_OVER_THANKS	プレイしてくれてありがとう！
$DEMO_OVER_ENORMOUS	クエストを続けるためには、大きなボタンをクリック！
$DEMO_OVER_ENORMOUS_2	クエストを続けるためには、大きなボタンをクリック！
$DEMO_OVER_FULL_GAME	製品版をゲットしましょう！
$DEMO_OVER_FULL_GAME_SHORT	フル<N>ゲーム！
$DEMO_OVER_ACTS	Acts<N>III & IV	COMMENT: <N> means a line break. <N> works too, but not <N> or <n>
$ERROR_TITLE	エラーが発生しました！
$ERROR_NUMBER	エラー #
$ERROR_CONTEXT	コンテキスト
$ERROR_MESSAGE	メッセージ
$ERROR_STACK	スタックトレース
$PARTY_FROM_BATTLE	バトルから
$PARTY_GO_TO_MAP	マップへ戻る
$PARTY_RETURN_TOWN	町へ戻る
$PARTY_CANT_WEAPON	武器<N>装備不可
$PARTY_CANT_ARMOR	鎧<N>装備不可
$PARTY_RESET_POINTS	振り直し
$PARTY_X_PTS	<X> pts
$PARTY_REDESIGN	もう一度デザインする
$PARTY_CONFIRM_CHANGES	変化を確認する
$PARTY_FAILED	ステージ失敗！
$PARTY_FAILED_DESC	<MCG>は殺された。	COMMENT: <MCG> is a variable. In this exact string, the game expects this exact variable, and will replace <MCG> with Azra's name. Any other variable is ignored and will appear as-is.
$PARTY_NO_NEW_ACHIEVE	何も達成できませんでした。
$PARTY_WELL_DONE	よくできました！
$PARTY_ACHIEVE_SINGULAR	達成
$PARTY_ACHIEVE_PLURAL	達成
$PARTY_1_NEW_ACHIEVE	1つ達成しました！
$PARTY_X_NEW_ACHIEVE	<NUM>つ達成しました！
$PARTY_PERFECT_WORD	パーフェクト
$PARTY_PASSED_WORD	クリア
$PARTY_FAIL_PENALTY	ペナルティ
$PARTY_TOTAL	トータル
$PARTY_PERFECT	パーフェクト！
$PARTY_PERFECT+	パーフェクト！+
$PARTY_PERFECT++	パーフェクト！++
$PARTY_PERFECT_DESC	<MCG>は怪我一つしなかった！
$PARTY_PERFECT++_DESC	<MCG>と<ALLY>は<N>怪我一つしなかった！
$PARTY_PERFECT+_DESC	<MCG>は怪我一つしなかった！<N><ALLY>は怪我を負った！
$PARTY_PERFECT_ALLY_DEAD_DESC	<MCG>は怪我一つしなかったが、<ALLY>は死んだ。	COMMENT: The game will put Zelemir, Tletl-Meztli, or any other alternate mcguffin's name where <ALLY> appears.
$PARTY_PASSED	ステージクリア！
$PARTY_PASSED+	ステージクリア！+
$PARTY_PASSED++	ステージクリア！++
$PARTY_PASSED_DESC	<MCG>は生き残ったが、<N>怪我を負った。
$PARTY_PASSED_ALLY_DEAD_DESC	<ALLY>が死に、<N><MCG>は怪我を負った。
$PARTY_PASSED+_DESC	<MCG>は怪我を負い、<N><ALLY>は生き延びた！
$PARTY_PASSED++_DESC	<MCG>は怪我を負い、<N><ALLY>は怪我一つ負わず生き延びた！
$PARTY_DEFEATED_WAVE_X	Defeated wave <X>
$PARTY_REACHED_WAVE_X	Reached wave <X>
$PARTY_NO_POINTS	スキルの割り当てをやり直せるスキルポイントはありません！
$PARTY_NO_AFFORD	スクラップが不足しています！<N>コスト:<COST><N>スクラップ:<SCRAP>
$PARTY_RE_ASSIGN	<NAME>のスキルをもう一度割り当てますか？<N>コスト:<COST><N>スクラップ:<SCRAP>
$PARTY_CHANGE_NAME	リネーム
$PARTY_CONFIRM_POINTS_1_1	キャラクターへのスキルポイントの<N>割り当てを確定しますか？	COMMENT: There are 4 variants here to handle the various pluralizations
$PARTY_CONFIRM_POINTS_1_X	<CHARS>キャラクターへのスキルポイントの<N>割り当てを確定しますか？
$PARTY_CONFIRM_POINTS_X_1	キャラクターへの<POINTS>スキルポイントの<N>割り当てを確定しますか？
$PARTY_CONFIRM_POINTS_X_X	<CHARS>キャラクターへの<CHARS>スキルポイントの<N>割り当てを確定しますか？
$PARTY_POINT	ポイント
$PARTY_POINTS	ポイント
$PARTY_CHARACTER	キャラクター
$PARTY_CHARACTERS	キャラクター
$PARTY_CONFIRM_POINTS_TITLE	スキルポイントの確認
$PARTY_RENAME	リネーム
$PARTY_REDESIGN	リデザイン
$UI_EQUIP_NAME	名称
$UI_EQUIP_STAT	成績
$UI_EQUIP_OWNER	持ち主
$UI_EQUIP_SHOW_EQUIPPED	持っている武器を見せる
$UI_EQUIP_CLASS_CANT_W	このクラスは武器を装備できません！
$UI_EQUIP_CLASS_CANT_A	このクラスは鎧を装備できません！
$UI_EQUIP_ALL_W_SWORD	すべての剣を装備しています。
$UI_EQUIP_ALL_W_BOW	すべての弓を装備しています。
$UI_EQUIP_ALL_W_STAFF	すべての杖を装備しています。
$UI_EQUIP_ALL_A_LIGHT	すべての軽鎧を装備しています。
$UI_EQUIP_ALL_A_HEAVY	すべての重鎧を装備しています。
$UI_EQUIP_NO_W_SWORD	一つも剣を持っていません！
$UI_EQUIP_NO_W_BOW	一つも弓を持っていません！
$UI_EQUIP_NO_W_STAFF	一つも杖を持っていません！
$UI_EQUIP_NO_A_LIGHT	一つも軽い鎧を持っていません！
$UI_EQUIP_NO_A_HEAVY	一つも重い鎧を持っていません！
$UI_ACCEPT_NUMS	font:18,off_y:1,off_x:-3	COMMENT: Font size and x/y offsets for options menu button labels
$UI_BACK_NUMS	font:18,off_y:1,off_x:-3
$UI_AUDIO_NUMS	font:18,off_y:1,off_x:-2
$UI_VIDEO_NUMS	font:18,off_y:1,off_x:-2
$UI_MISC_NUMS	font:18,off_y:1,off_x:-2
$UI_ACCESS_NUMS	font:18,off_y:1,off_x:-2,show_boxes:1,absence_off_x:0,speed_off_x:0	COMMENT: hide/show accessibility box graphic, offset for 'absence' text, offset for 'speed' text
$UI_ACHIEVEMENTS_NUMS	font:18,off_y:0,pop_up_off_y:0
$UI_RESTART_NUMS	font:18,off_y:1,off_x:-2
$UI_QUIT_NUMS	font:18,off_y:1,off_x:-2
$UI_CONTROLS_NUMS	font:18,off_y:1,off_x:-2
$UI_OPTIONS_NUMS	font:18,off_y:1,off_x:-2
$UI_CONTROLS_TITLE	操作設定
$UI_VIDEO_TITLE	グラフィック
$UI_AUDIO_TITLE	ミュージック
$UI_ACCESS_TITLE	ユーザー補助
$UI_MISC_TITLE	その他
$UI_OPTIONS_TITLE	オプション
$UI_OPTIONS_MENU	オプション
$UI_OPTIONS_SPEED	ゲームスピード
$UI_ACHIEVEMENTS_TITLE	実績
$UI_ACHIEVEMENTS_BUTTON_NUMBERS	font:18,off_y:1,off_x:-2
$UI_SFX	SFX:
$UI_MUSIC	Music:
$UI_ACCESS_REWARDS	報酬
$UI_ACCESS_PENALTIES	ペナルティ
$UI_ACCESS_DEFAULT	*デフォルトの設定
$UI_ACCESS_FAIL	失敗
$UI_ACCESS_ABSENCE	不足
$UI_ACCESS_FLASHING	フラッシュ効果
$UI_ACCESS_SPEED	ゲームスピード
$UI_BONUS_NUMS	select_font:16,locked_font:13,leading:-8,locked_y_off:-6
$UI_BONUS_BONUS_LEVELS	ボーナスレベル
$UI_BONUS_STARS_LINE	<STAR_NUM><STAR_COLOR>スター
$UI_BONUS_GOLD_STARS_LINE	<STAR_NUM>ゴールドスター
$UI_BONUS_BLUE_STARS_LINE	<STAR_NUM>ブルースター
$UI_MOVIE_SELECT_A_MOVIE	シーン選択
$UI_MOVIE_SCENE	シーン
$UI_MOVIE_END	エンディング
$UI_MOVIE_QUEST	クエスト
$UI_TIPS_TITLE	コツ＆トリック
$UI_UPDATER_CANCEL	<RE>$MISC_CANCEL
$UI_UPDATER_SECURED_WITH	このアップデートのシステムは、公開鍵指紋の照合と同じように、HTTPSで守られています。
$UI_UPDATER_ASK_DOWNLOAD	アップデートをダウンロードしますか？
$UI_UPDATER_SERVER_TIMEOUT	サーバーがタイムアウトしました！
$UI_UPDATER_NO_INFO	サーバー上にアップデートの情報を見つけられませんでした。
$UI_UPDATER_NO_BIG_DEAL	アップデートサーバーへのログインに失敗しました。<N><N>ゲームはプレイ可能ですが、アップデートをしたい場合はもう一度リトライを押してください。
$UI_UPDATER_DEB	DEBパッケージ
$UI_UPDATER_RPM	RPMパッケージ
$UI_UPDATER_TARGZ	TAR.GZアーカイブ
$UI_UPDATER_CHECKING	アップデートをチェックしています・・・
$UI_UPDATER_UPDATE_EXISTS	アップデートバージョンが手に入ります！
$UI_UPDATER_CURRENT_VERSION	現在のバージョン：<T>
$UI_UPDATER_NEWEST_VERSION	最新のバージョン：<T>
$UI_UPDATER_NO_UPDATES	手に入るアップデートはありません
$UI_UPDATER_PLEASE_WAIT	<RE>$MISC_PLEASE_WAIT
$UI_UPDATER_TRYING_30	30秒間、試してみます
$UI_UPDATER_CONNECT_AGAIN	もう一度接続しています
$UI_UPDATER_ERROR!	エラーです！
$UI_UPDATER_DETAILS	詳細：
$UI_UPDATER_NO_VERIFY	アップデートファイルを照合できませんでした。
$UI_UPDATER_NO_DOWNLOAD	アップデートファイルをダウンロードできませんでした。
$UI_UPDATER_CHECKSUM_MISMATCH	このファイルのチェックサムは、私たちの予想と合致しませんでした。<N><N>考えられる原因は、不完全なダウンロードかもしれないし、セキュリティーの問題じゃないかもしれないし、宇宙線だったら確かめようもないですが<N><N>いずれにせよ、アップデートは失敗しました。
$UI_UPDATER_GIVE_UP	諦める
$UI_UPDATER_TRY_AGAIN	りトライ
$UI_UPDATER_CONNECTING	サーバーに接続しています・・・
$UI_UPDATER_DOWNLOADING_FILE	アップデートファイルをダウンロードしています・・・
$UI_UPDATER_DOWNLOADING_SIG	アップデートの署名をダウンロードしています・・・
$UI_UPDATER_CHECKSUM	チェックサムを計算しています・・・
$UI_UPDATER_NAVIGATING	ファイルまで案内します・・・
$UI_UPDATER_CLOSE_WINDOW	このウィンドウを閉じて、アップデートをインストールしてください。
$UI_UPDATER_FILE_IS_AT	あなたのアップデートファイルは、ここにあります：
$UI_UPDATER_IF_NO_WINDOW	もしナビゲーションフォルダーが開かなければ、手動で試してください。
$UI_UPDATER_DOWNLOADED	アップデートをダウンロードしました！
$UI_UPDATER_NAVIGATE_NOW	現在のファイルまで案内しますか？
$UI_UPDATER_NOTE	注意：
$UI_UPDATER_SECURITY	セキュリティー上の理由から、ダウンロードしたインストーラーを手動で操作しなければいけません。<N><N>このプログラムは、あなたのファイルがダウンロードされた場所まで案内します。
$UI_UPDATER_INSTALLING	アップデートをインストールしています・・・
$UI_UPDATER_EXITING	アプリを終了します・・・
$UI_DEFENDER_RECALL_LINE	帰還：<N>+<PSI>Psi
$UI_DEFENDER_BOOST	ブースト：<PSI>Psi
$UI_DEFENDER_BOOST_NEED	ブースト：<PSI>Psi必要
$UI_DEFENDER_BOOST_MAX	ブーストMAX
$UI_DEFENDER_BOOST_UNLOCK	ブースト<LVL>でアンロック
$UI_DEFENDER_CLICK_TO	（有効 / 無効）
$UI_DEFENDER_TECHNIQUES	テクニック
$UI_DEFENDER_TECHNIQUE	テクニック
$UI_DEFENDER_TRAITS	特徴
$UI_DEFENDER_TRAIT	特徴
$UI_DEFENDER_RECALL	帰還
$UI_SKILLS_CLICK_TO_UPGRADE	強化する！
$UI_SKILLS_MAX	MAX
$MISC_MAX	MAX
$UI_SKILLS_NO_POINTS	ポイントがありません。
$UI_SKILLS_REQ_1PT	条件：レベル<LVL><N><SKILL><PT>ポイント
$UI_SKILLS_REQ_XPT	条件：レベル<LVL><N><SKILL><PT>ポイント
$UI_SKILLS_NO_LEARN_SPELL	まだこの呪文を習得していません。
$UI_SKILLS_MOUSE_OVER	詳細はマウスオーバーで確認できます。
$UI_EQUIP_OWNED	所有数
$UI_EQUIP_COMPARE	比較
$UI_EQUIP_PRICE	価格
$UI_EQUIP_SHOW_EQUIPPED	持っている武器を見せる
$UI_EQUIP_EQUIP_AFTER	購入後、装備する
$UI_EQUIP_EQUIP_WHO	誰が装備しますか？
$UI_EQUIP_EQUIPPED	装備者
$UI_EQUIP_MAX_OWNED	最善の装備をしています
$UI_EQUIP_ALL_W_SWORD_EQUIPPED	すべての剣を装備しています！
$UI_EQUIP_ALL_W_STAFF_EQUIPPED	すべての杖を装備しています！
$UI_EQUIP_ALL_W_BOW_EQUIPPED	すべての弓を装備しています！
$UI_EQUIP_ALL_A_LIGHT_EQUIPPED	すべての軽鎧を装備しています！
$UI_EQUIP_ALL_A_HEAVY_EQUIPPED	すべての重鎧を装備しています！
$UI_EQUIP_CANT_UPGRADE_W_SWORD	剣の強化はできません。
$UI_EQUIP_CANT_UPGRADE_W_BOW	弓の強化はできません。
$UI_EQUIP_CANT_UPGRADE_W_STAFF	杖の強化はできません。
$UI_EQUIP_CANT_UPGRADE_A_LIGHT	軽鎧の強化はできません。
$UI_EQUIP_CANT_UPGRADE_A_HEAVY	重鎧の強化はできません。
$UI_EQUIP_NO_W_SWORD	剣を持っていません。
$UI_EQUIP_NO_W_STAFF	杖を持っていません。
$UI_EQUIP_NO_W_BOW	弓を持っていません。
$UI_EQUIP_NO_A_LIGHT	軽鎧を持っていません。
$UI_EQUIP_NO_A_HEAVY	重鎧を持っていません。
$UI_EULA_TITLE	最終ユーザーライセンス契約
$UI_ACHIEVE_COMPLETION	獲得
$UI_ACHIEVE_CATEGORIES	ランク
$UI_ACHIEVE_POP_UP	ポップアップ通知
$UI_ACHIEVE_TRAINER	肩ならし
$UI_ACHIEVE_EASY	イージー
$UI_ACHIEVE_MEDIUM	ノーマル
$UI_ACHIEVE_HARD	ハード
$UI_ACHIEVE_IMPOSSIBLE	インポッシブル
$UI_CONTROLS_SPELL	呪文
$UI_CONTROLS_CLASS	クラス
$UI_CONTROLS_CHARACTER	キャラクター
$UI_CONTROLS_TARGET	ターゲット
$UI_CONTROLS_PAUSE	ポーズ
$UI_CONTROLS_MINUS_SPEED	スピード-
$UI_CONTROLS_PLUS_SPEED	スピード＋
$UI_CONTROLS_BOOST	ブースト
$UI_CONTROLS_RECALL	帰還
$UI_CONTROLS_RECALL_NUMS	btn_off_x:-8
$UI_CONTROLS_BACK_NUMS	btn_off_x:-8
$UI_CONTROLS_BACK	戻る
$UI_CONTROLS_PRESETS	初期設定
$UI_CONTROLS_TAB_NAV	タブキー<N>操作
$UI_CONTROLS_CYCLE	サイクル<N>ディフェンダー
$UI_CONTROLS_CYCLE_NUMS	off_x:-5,off_y:0	COMMENT: moves the 'cycle defenders' text and associated buttons
$UI_CONTROLS_SCROLL	マップスクロール<N>ディフェンダーの配置
$UI_CONTROLS_SCROLL_NUMS	off_x:-10
$UI_CONTROLS_MOVE_CURSOR	カーソル移動
$UI_CONTROLS_VIRTUAL_MOUSE	仮想マウス
$UI_CONTROLS_CLICK	クリック
$UI_CONTROLS_SPEED	スピード
$UI_CONTROLS_ACCEL	アクセル
$UI_CONTROLS_SLOWEST	最も遅い
$UI_CONTROLS_SLOW	遅い
$UI_CONTROLS_NORMAL	普通
$UI_CONTROLS_FAST	早い
$UI_CONTROLS_NONE	無し
$UI_CONTROLS_PRESET_QWERTY	標準キーボード
$UI_CONTROLS_PRESET_LEFTY	左利き
$UI_CONTROLS_PRESET_AZERTY	アザーティ
$UI_CONTROLS_PRESET_QWERTZ	クワーツ
$UI_CONTROLS_PRESET_DVORAK	ドボラック
$UI_CONTROLS_PRESET_CUSTOM	カスタム
$UI_DOWNLOAD_WARNING	ポップアップのブロックを無効にしてください！
$UI_DOWNLOAD_BODY	デスクトップバージョンのゲームをダウンロードするためには、ボタンをクリックしてください。<N><N>新しいウィンドウまたはタブでダウンロードします。少々遅れが生じるかもしれませんので、<N>辛抱強く待ってください。くれぐれもスパムメールを送らないように。
$UI_DOWNLOAD_LINUX	Linux
$UI_DOWNLOAD_WINDOWS	Windows
$UI_DOWNLOAD_MACINTOSH	Macintosh
$UI_DOWNLOAD_SOUNDTRACK	サウンドトラック
$UI_CONFLICT_TITLE	クラウドの衝突！
$UI_CONFLICT_MSG	どちらのスロットに行くべきか、不明です<SLOT>。<N>好きな方を選んでください。
$UI_CONFLICT_CLOUD	クラウド
$UI_CONFLICT_LOCAL	コンピューター
$UI_CONFLICT_CONSOLE	ゲーム機
$UI_CONFLICT_BETTER	こちらの方がいいと思います
$UI_CONFLICT_BUTTON	これを使う
$UI_CONFLICT_NGP	ニューゲーム+
$UI_CONFLICT_BACKUP	選んでいないファイルのバックアップを取る：<N><LOC>
$UI_GAMEPLAY_MISCELLANEOUS	その他
$UI_GAMEPLAY_CLOUD_SAVE	クラウドに保存する
$UI_GAMEPLAY_OFF	オフ
$UI_GAMEPLAY_ON	オン
$UI_GAMEPLAY_TUTORIALS	チュートリアル
$UI_GAMEPLAY_DIALOGUE	会話文の表示
$UI_GAMEPLAY_NEVER	なし
$UI_GAMEPLAY_ALWAYS	いつも
$UI_GAMEPLAY_DEFAULT	新しいバトルのみ
$UI_GAMEPLAY_BATTLE_NUMBERS	バトルの数字
$UI_GAMEPLAY_HIDE	表示する
$UI_GAMEPLAY_SHOW	表示しない
$UI_GAMEPLAY_TRACKING	データトラックする
$UI_GAMEPLAY_TRACK_YES	名前が無いプレイスタッツを追跡します
$UI_GAMEPLAY_TRACK_NO	私をトラックしないでよ！
$UI_GAMEPLAY_AUTO_UPDATE	自動アップデート
$UI_GAMEPLAY_ENABLE_UPDATER	ゲーム開始時にアップデートをチェック
$UI_GAMEPLAY_DISABLE_UPDATER	自動アップデートを無効にする
$UI_GAMEPLAY_SLOW_FOOTNOTE	ゲームスピードが落ちるかもしれません
$UI_SAVE_PATH	セーブファイルパス
$UI_MOD_PATH	MODファイルパス
$TOOLTIP_CHANGE_PATH_1	メモ：
$TOOLTIP_CHANGE_PATH_2	古いファイルは自動的に新しい場所には転送されません。元のディレクトリに存在したままです。
$UI_VIDEO_IF_DOESNT_WORK	もし新しい解像度が上手く機能しなければ、<N>数秒後に前の設定に戻ります。
$UI_VIDEO_RES_CHANGED	解像度を変更しました。<N>これでよろしいですか？<N><N><TIME>秒後に前の設定に戻ります。
$UI_VIDEO_SETTINGS	ビデオモード
$UI_VIDEO_WARNING	ブラウザモードでは、ビデオオプションは無効です。
$UI_VIDEO_WARNING2	あなたのシステム設定では、ゲーム内の解像度の切り替えをサポートしていません。ごめんなさい：（
$UI_VIDEO_WARNING3	互換モードでは、解像度の切り替えは無効です。<N><N>ごめんね！
$UI_VIDEO_MOUSE	マウスカーソル
$UI_VIDEO_MOUSE_DEFAULT	デフォルト
$UI_VIDEO_MOUSE_FANCY	ファンシー
$UI_VIDEO_PARTICLES	パーティクル
$UI_VIDEO_SWIRL	戦闘前アニメーション
$UI_VIDEO_AOE	攻撃エリアをハイライト
$UI_VIDEO_CHANGE_RES	解像度を変える
$UI_VIDEO_SCREEN_POS	スクリーンポジション
$UI_VIDEO_CHANGE_RES_BUTTON	変更する
$UI_VIDEO_SHOW_ALL_RES	すべての解像度
$UI_VIDEO_RECOMMENDED	おすすめ：
$UI_VIDEO_STANDARD_RATIO	（標準比率）
$UI_VIDEO_WIDESCREEN	（ワイドスクリーン）
$UI_VIDEO_PIXELS	ピクセル
$UI_VIDEO_BIT_DEPTH	深度
$UI_VIDEO_REFRESH	リフレッシュ
$UI_VIDEO_SCALE	スケール
$UI_VIDEO_CAN_SLOW_GAME	（ゲームを遅くできます）
$UI_VIDEO_WINDOWED	ウィンドウ
$UI_VIDEO_FULLSCREEN	フルスクリーン
$UI_SAVE_ERROR_INCOMPAT	互換性がありません！
$UI_SAVE_ERROR_INCOMPAT_TEXT	エラーです！あなたがプレイしているデモ<N>は、フルバージョンです
$UI_SAVE_DEMO_IMPORT	デモのインポート
$UI_SAVE_DEMO_IMPORT_TEXT	そのファイルはデモにあります。引き継ぐことができるかもしれません。<N>スゴくない？
$UI_SAVE_DEMO_NEWER	ファイルは、新しいバージョンのゲームにあります。<N>互換性がない可能性があります。<N>インポートしますか？
$UI_SAVE_DEMO_OLDER	ファイルは、古いバージョンのゲームにあります。<N>何らかの調整が行われた可能性があります。<N>かっこよくない？
$UI_NORM_MOD_INCOMPAT_TEXT	<N>MODからのファイルは、<N>互換性のない場合があります。<N><N>インポートしてみますか？
$UI_MOD_NORM_INCOMPAT_TEXT	<N>MODはアクティビティですが、<N>ファイルは普通のゲームからです。互換性のない場合があります。<N><N>インポートしてみますか？
$UI_MOD_MOD_INCOMPAT_TEXT	<N>ファイルは違うMODからです。<N>互換性のない場合があります。<N><N>インポートしてみますか？
$UI_SAVE_DEMO_ATTENTION	注意！
$UI_SAVE_MENU_LOADED	読み込みが完了しました！
$UI_SAVE_MENU_CHECK_GOG	GOGで無料アップデートをチェックしてください！
$UI_SAVE_MENU_DOWNLOAD	ダウンロードできるバージョンをゲットする
$UI_SAVE_MENU_FULL_VERSION	フルバージョン
$UI_SAVE_MENU_KONG_XDEMO_LOGIN	拡張デモ―フルゲームにアクセスするためには、kongregateにログインしてください！
$UI_SAVE_MENU_KONG_XDEMO	拡張デモバージョン
$UI_SAVE_MENU_KONG_DEMO_LOGIN_FULL	デモ - kongregateにログインして、フルゲームにアクセスしてください！
$UI_SAVE_MENU_KONG_DEMO_LOGIN_XDEMO	デモ - kongregateにログインして、拡張したコンテンツにアクセスしてください！
$UI_SAVE_MENU_KONG_DEMO	<RE>$MISC_DEMO_VERSION
$UI_SAVE_CONFIRM_DELETE	消去の確認
$UI_SAVE_CONFIRM_DELETE_TEXT	このセーブスロットを、<N>完全に消去しますか？
$SAVE_SLOT_PLAY	プレイ
$SAVE_SLOT_PLAY_PLUS	プレイ+
$SAVE_SLOT_NEW_GAME	ニューゲーム
$SAVE_SLOT_NEW_GAME_PLUS	ニューゲーム+
$SAVE_SLOT_EXPORT	エクスポート
$SAVE_SLOT_IMPORT	インポート
$SAVE_SLOT_DELETE	消去
$UI_DEMO_SAVES_DETECTED	デモのセーブデータを検知しました！
$UI_DEMO_IMPORT_SAVES	デモのセーブデータをインポートしますか？
$UI_CLOUD_UNKNOWN	クラウドに保存する
$UI_CLOUD_UNKNOWN_TEXT	STEAMクラウドの保存を無効にしますか？
$UI_CLOUD_UNKNOWN_TEXT_2	こちらで、いつでも設定を変えられます：<N><N>オプション：その他
$UI_MOD_TITLE	MOD
$UI_MOD_LOAD_EXISTING	既存のMODをロードする
$UI_MOD_CREATE_NEW	新しいMODをロードする
$UI_MOD_BROWSE_QUEUE	ローカルキューをブラウズする
$UI_MOD_BROWSE_WORKSHOP	スチームのワークショップをブラウズする
$UI_MOD_WEB_BROWSER	Webブラウザ
$UI_MOD_INSTALL_STANDALONE	ZIPからインストール
$UI_MOD_INSTALL_ERROR	同じ名前のMODフォルダがあります。<N>名前を変えてインストールしますか？
$UI_MOD_INSTALL_ERROR2	すみませんが、MODをインストールできません。
$UI_DEFQ_MODS	MOD
$UI_MOD_TITLE	MOD
$UI_MOD_DATA_ONLY	データのみ（1M）
$UI_MOD_SPRITES	スプライトを+4M
$UI_MOD_MOVIES	ムービーアートを+13M
$UI_MOD_BKGS	背景アートを+42M
$UI_MOD_TEMPLATE_SETTINGS	MODテンプレートの設定
$UI_MOD_SELECT_DIR	MODディレクトリーの選択
$UI_SAVE_SELECT_DIR	MODをロードする
$UI_MOD_LOAD_MOD	MODが存在します。<N>ロードしますか？
$UI_MOD_EXISTS	設定を見つけられませんでした。<N>MODは存在しないか、<N>壊れている可能性があります。
$UI_MOD_MISSING	うわっ！<N>ディレクトリーすらありません！<N>再試行してください。
$UI_MOD_NOT_DIR	うわっ！<N>ディレクトリーすらありません！<N>再試行してください。
$UI_MOD_LOADING	MODをロードしています・・・
$UI_MOD_PLEASE_WAIT	少々お待ちください<N>あなたのMODをロードしています
$UI_MOD_PROGRESS	タスク<TASK><N>ファイル<FILE><N>
$UI_MOD_LOAD_FINISH	ロードが完了しました
$UI_MOD_LOAD_FINISH_TEXT	MODのロードに成功しました。<N>ゲームを再起動します。
$UI_MOD_LOAD_FAIL	ロードに失敗しました！
$UI_MOD_LOAD_FAIL_TEXT	MODのロードに失敗しました：
$UI_MOD_NAME	このMODに名前をつけてください
$UI_MOD_EXPORTING	データのエクスポート
$UI_MOD_EXPORT_FINISH	エクスポートが完了しました！
$UI_MOD_EXPORT_FINISH_TEXT	あなたのMODはここにあります：
$UI_MOD_EXPORT_CANCEL	エクスポートはキャンセルされました！
$UI_MOD_EXPORT_CANCEL_TEXT	ファイルはここにあります：
$UI_MOD_EXPORT_FAIL	エクスポートは失敗しました！
$UI_MOD_EXPORT_FAIL_TEXT	エラーが発生しました！
$UI_MOD_EXPORT_CHURN	Task <TASK_PROGRESS><N><N><TASK><N><PROGRESS>
$UI_MOD_DEFQ_SAVE	Defender's Quest Save Files (*.dfq)
$UI_MOD_ALL_FILES	All Files (*.*)
$UI_MOD_AUTHOR	作者
$UI_MOD_PLAY	プレイ
$UI_MOD_SHARE	シェア
$UI_MOD_UPDATE	アップデート
$UI_MOD_EDIT	エディット
$UI_MOD_WORKSHOP	Workshop
$UI_MOD_SHARE_TITLE	MODシェア
$UI_MOD_SHARE_TEXT_LOCAL	カンタンに配布するために、MODを単一ファイルにパッケージします。
$UI_MOD_SHARE_TEXT_STEAM	パッケージにしてSteam WorkshopにMODをアップロードします。
$UI_MOD_UPDATE_TEXT_STEAM	Steam WorkshopにMODが更新されます。
$UI_MOD_ZIP_PROGRESS	Task <TASK><N>File <FILE><N>
$UI_MOD_ZIP_FINISH	パッケージ完成
$UI_MOD_ZIP_FINISH_TEXT	Mod Zip完成
$UI_MOD_ZIP_FAIL	パッケージできません！
$UI_MOD_ZIP_FAIL_TEXT	ファイル圧縮中にエラーが発生しました。
$UI_MOD_STEAM_UPLOAD	Steamにアップロード
$UI_MOD_STEAM_WAIT	Steamから応答待ちです・・・<N>(短時間の可能性があります。)
$UI_MOD_STEAM_SEND	Steamに送っています・・・
$UI_MOD_SHARED	シェア
$UI_MOD_SUBSCRIBED	発行
$UI_MOD_ZIP_STEAM_FAIL	アップロード失敗！
$UI_MOD_ZIP_STEAM_FAIL_TEXT	Steam Workshopに<N>アップロードできません。
$UI_MOD_ZIP_STEAM_FINISH	アップロード完成
$UI_MOD_ZIP_STEAM_FINISH_TEXT	Steam Workshop<N>Modアップロード成功
$UI_MOD_UPDATE_STEAM_FINISH	アップデート完成
$UI_MOD_UPDATE_STEAM_FINISH_TEXT	Steam Workshopに<N>Modアップデータ成功
$UI_MOD_ZIPPING	Mod Filesパッケージ
$UI_MOD_MISSING_SUBSCRIBE	発行ファイル
$UI_MOD_MISSING_SUBSCRIBE_TEXT	ダウンロードしますか？:<N><NUM> 発行workshop file(s)?
$UI_MOD_DOWNLOAD	Modダウンロード中
$UI_MOD_DOWNLOAD_TEXT	
$UI_MOD_LATER	後で
$UI_EQUIP_WHO_WILL	装備するキャラクター：
$UI_EQUIP_CANT_SELL_UNIQUE	特殊なアイテムは売ることができません！
$UI_EQUIP_SELL_OLD_WEAPON_FOR	<SELL_PRICE>で古い武器を売却
$UI_EQUIP_SELL_OLD_ARMOR_FOR	<SELL_PRICE>で古い鎧を売却
$UI_RECRUIT_CLASS_FULL	満員です！
$UI_RECRUIT_ERROR_NUMS	off_y:5
$UI_RECRUIT_BERSERKER_NUMS	font:14,x_off:0,y_off:0
$UI_RECRUIT_RANGER_NUMS	font:14,x_off:0,y_off:0
$UI_RECRUIT_KNIGHT_NUMS	font:14,x_off:0,y_off:0
$UI_RECRUIT_MAGE_NUMS	font:14,x_off:0,y_off:0
$UI_RECRUIT_HEALER_NUMS	font:14,x_off:0,y_off:0
$UI_RECRUIT_DRAGON_NUMS	font:14,x_off:0,y_off:0
$UI_BATTLE_MORE	MORE
$UI_BATTLE_SEND_NEXT	送る<N>次
$UI_BATTLE_NEXT	次
$UI_BATTLE_WAVES	WAVE
$UI_BATTLE_WAVE	WAVES
$UI_BATTLE_CASH_OUT	清算
$UI_BATTLE_CASH_OUT?	清算しますか？
$UI_BATTLE_CASH_OUT_TEXT	戦闘を終了し、獲得した報酬を清算しますか？
$FB_LIKE_US_TEXT	私たちのFacebookのページにいいね！<N>してください。 このプライズを無料で差し上げます！
$FB_LIKE_US_YES	OK！
$FB_LIKE_US_NO	ははは、やだ。
$FB_THANKS_TEXT	私たちのFacebookのページにいいね！してくれてありがとう！<N>プライズをお送りします！
$FB_THANKS_OK	OK
$FB_THANKS_SUCKS	Facebookキライ
$FB_REBEL_TEXT	だよね！あんなもん、ほっとこうぜ！<N>代わりにこれを持って行って！
$FB_SECOND_PITCH	私たちのFacebookのページにいいね！していただくと、<N>これが手に入ります！
$FB_SECOND_PITCH_YES	OK
$FB_SECOND_PITCH_NO	ヤダ！
$FB_HARD_SELL_TEXT	マジで？<N>こんなにキラキラしてるのに？
$FB_HARD_SELL_YES	うん・・・じゃあOK。
$FB_HARD_SELL_NO	絶対ヤダ！
$FB_PERSISTENT_TEXT	OK、お前の勝ちだ！<N>どうせ最初からあげるつもりだったけど。
$FB_PERSISTENT_OK	やったね！
$FB_THIS_ITEM_WILL_NOW	このアイテムは、どのプレイヤーのリストにも常に表示されます。
$BOOK_PSI_TAX	PSI Tax:
$BOOK_COST_MULT	呪文コスト x
$BOOK_COOL_MULT	呪文再詠唱時間 x
$STATUS_DESC_FB_HAPPY	スピード+<PERCENT>%。
$STATUS_DESC_FB_SAD	スピード-<PERCENT>%。
$STATUS_DESC_FB_BORED	面倒くさくて動きたくなーい。
$STATUS_DESC_FB_LOL	スピード+<PERCENT>%。
$STATUS_DESC_FB_OMG	スピード+<PERCENT>%、ダメージ軽減-<PERCENT>%。
$STATUS_DESC_TROLL	攻撃を受けている時、<PERCENT>%攻撃回避。
$STATUS_DESC_ANONYMOUS	攻撃回避率+<PERCENT>%。
$STATUS_DESC_DARK	非エリア攻撃時、<PERCENT>%攻撃回避。
$STATUS_DESC_LIGHT	闇を取り除く。
$STATUS_DESC_FRENZY	<PERCENT>%スピードアップ。
$STATUS_DESC_BLINDED	<PERCENT>%攻撃を外す。	COMMENT: Status descriptions have LOTS of variables. Ask Lars is you have any questions.
$STATUS_DESC_BLEED	ダメージに+<PERCENT>%を付与。
$STATUS_DESC_EVER_POISON	<INTI>ダメージ/秒。
$STATUS_DESC_DISEASE	回復力が<PERCENT>%減少。
$STATUS_DESC_POISON	<TIME>秒間、<INTI>ダメージ/秒。
$STATUS_DESC_SINGLE_STUN	動けなくなる。<N>効果は一度だけ。
$STATUS_DESC_STUN	動けなくなる。
$STATUS_DESC_BURN	<AMT_1DIG>ダメージ/秒。<N>氷で相殺可能。
$STATUS_DESC_INSPIRED	ダメージに+<M_MULT_PERCENT>%を付与。
$STATUS_DESC_FREEZE	動けなくなる。<N>火で相殺可能。
$STATUS_DESC_CHILL	スピードが-<PERCENT>%。<N>火で相殺可能。
$STATUS_DESC_SLOW	スピードが-<PERCENT>%。
$STATUS_TIME_LEFT	残り<TIME_LEFT>/<TIME>秒。
$STATUS_TIME_FOREVER	無制限。
$FLAV_DESC_LIGHT	闇の敵に+<AMT_2DIG>×<EXTRA>のダメージを与え、さらに<TIME><EXTRA_TIME>秒間、攻撃しやすくなる。
$FLAV_DESC_LIGHT_SHORT	闇の敵に、数秒間強くなる。
$FLAV_DESC_BLINDED	敵の攻撃が<TIME><EXTRA_TIME>秒間、正確さを<PERCENT>%<EXTRA>失う。
$FLAV_DESC_BLINDED_SHORT	敵の攻撃が数秒間、正確さを失う。
$FLAV_DESC_CONFUSED	<TIME><EXTRA_TIME>秒間だけ敵が後ろに歩く。
$FLAV_DESC_CONFUSED_SHORT	数秒間だけ敵が後ろに歩く。
$FLAV_DESC_BLEED	敵は<TIME><EXTRA_TIME>秒間、<PERCENT>%<EXTRA>大きなダメージを受ける。
$FLAV_DESC_BLEED_SHORT	敵は攻撃されると一時的に大ダメージを受ける。
$FLAV_DESC_KNOCK_BACK	<AMT_1DIG><EXTRA>タイルだけ敵を後ろに押し戻す。
$FLAV_DESC_KNOCK_BACK_SHORT	数タイルだけ敵を後ろに押し戻す。
$FLAV_DESC_DISEASE	敵の回復力が<PERCENT>%<EXTRA>減少。
$FLAV_DESC_DISEASE_SHORT	敵の回復力が減少。
$FLAV_DESC_POISON	<TIME><EXTRA_TIME>秒間、攻撃ダメージの<PERCENT>%<EXTRA>/秒のダメージを敵に与える。
$FLAV_DESC_POISON_DIRECT	<TIME><EXTRA_TIME>秒間、<AMTDMG><EXTRA>/秒のダメージを敵に与える。
$FLAV_DESC_POISON_SHORT	短期間に渡り、敵にダメージを与える。
$FLAV_DESC_SINGLE_STUN	敵を<TIME><EXTRA_TIME>間動けなくする。この攻撃は、1回しか使えない。
$FLAV_DESC_SINGLE_STUN_SHORT	敵を数秒間動けなくする。この攻撃は、1回しか使えない。
$FLAV_DESC_STUN	敵を<TIME><EXTRA_TIME>秒間動けなくする。
$FLAV_DESC_STUN_SHORT	敵を一時的に敵を動けなくする。
$FLAV_DESC_AUTO_KILL	HP<EXTRA>以下の敵を<PERCENT>%で自動的に倒す。
$FLAV_DESC_AUTO_KILL_SHORT	一定の強さを持たない敵を自動的に倒す。
$FLAV_DESC_BURN	敵に<TIME><EXTRA_TIME>秒間、<AMTDMG><EXTRA>ダメージ/秒を与える。氷で相殺可能。
$FLAV_DESC_BURN_SHORT	敵に数秒間、ダメージを与える。氷で相殺可能。
$FLAV_DESC_INSPIRE	<TIME><EXTRA_TIME>秒間だけ、<M_MULT_PERCENT><EXTRA>%多くダメージを与えられる。
$FLAV_DESC_INSPIRE_SHORT	一時的に大ダメージを与られえる。
$FLAV_DESC_FREEZE	<TIME><EXTRA_TIME>秒間、敵を動けなくする。<N>火で相殺可能。
$FLAV_DESC_FREEZE_SHORT	一時的に敵を動けなくする。<N>火で相殺可能。
$FLAV_DESC_ARMOR_PIERCE_DIRECT	攻撃が<AMTDMG><EXTRA>ポイントのアーマーを無効化。
$FLAV_DESC_ARMOR_PIERCE_AMT_LESS_1	<INV_AMOUNT><EXTRA>ダメージ毎にアーマーを1無効化。
$FLAV_DESC_ARMOR_PIERCE_AMT_GRTR_1	1ダメージ毎にアーマーを<AMT_1DIG><EXTRA>無効化。
$FLAV_DESC_ARMOR_PIERCE_SHORT	攻撃が、数ポイントのアーマーを無効化。
$FLAV_DESC_ARMOR_BREAK_DIRECT	<AMTDMG><EXTRA>のアーマーを攻撃で破壊。
$FLAV_DESC_ARMOR_BREAK_AMT_LESS_1	<INV_AMOUNT><EXTRA>毎に1アーマーを破壊。
$FLAV_DESC_ARMOR_BREAK_AMT_GRTR_1	1ダメージ毎に<AMT_2DIG><EXTRA>のアーマーを破壊。
$FLAV_DESC_ARMOR_BREAK_SHORT	攻撃が、数ポイントのアーマーを破壊。
$FLAV_DESC_CHILL	敵の動きが<TIME><EXTRA_TIME>秒間、<PERCENT>%<EXTRA>鈍る。
$FLAV_DESC_CHILL_SHORT	敵の動きが数秒間鈍る。火で相殺可能。
$FLAV_DESC_SLOW	敵の動きが、<TIME><EXTRA_TIME>秒間、<PERCENT>%<EXTRA>で鈍る。
$FLAV_DESC_SLOW_SHORT	敵が、一時的に動けなくなる。
$FLAV_DESC_STRIKE_THROUGH	敵を<INTI><EXTRA>人まで攻撃可能。
$FLAV_DESC_STRIKE_THROUGH_SHORT	複数の敵を攻撃可能。
$FLAV_DESC_CRITICAL	ダメージ＝通常攻撃の<AMT_1DIG>×<EXTRA>
$FLAV_DESC_CRITICAL_SHORT	通常攻撃より大ダメージ。
$STAT_DESC_HP	ヒットポイント<N>0になるとバトルから退場。
$STAT_DESC_SPEED	スピード<N>攻撃のクールダウン速度：<SPEED_SHOW_MULT>毎にクールダウン速度が倍に。
$STAT_DESC_SPEED_ENEMY	スピード<N>敵の動き及び攻撃の速さ。１ポイント＝１タイル/秒。
$STAT_DESC_ATTACK	攻撃<N>テクニックのダメージをより大きくする。
$STAT_DESC_ATTACK_ENEMY	攻撃<N>敵の最強の攻撃によるダメージ
$STAT_DESC_DEFENSE	防御<N>吸収されるダメージ量
$STAT_DESC_DEFENSE_ENEMY	アーマー<N>吸収されるダメージ量
$STAT_DESC_STRONGS	耐性
$STAT_DESC_WEAKS	弱点
$STAT_DESC_REGEN	回復<N>HPの回復速度で、単位はHP/秒
$STAT_DESC_REGEN_ENEMY	回復<N>HPの回復速度で、単位はHP/秒
$STAT_DESC_EVADE	回避<N>攻撃を避ける確率
$STAT_DESC_EVADE_ENEMY	回避<N>攻撃を避ける確率
$STAT_DESC_RANGE	射程<N>攻撃範囲の半径
$STAT_DESC_RANGE_ENEMY	射程<N>攻撃範囲の半径
$STAT_DESC_SPELLS	呪文
$STAT_DESC_PHASING	透明<N>定期的に姿を消したり現したりする。消えている間は、狙われず攻撃を受けない。<N>見た目はタイルになります。
$STAT_DESC_BARRIER	バリア<N>ダメージから身を守るバリア。非常に強力な魔法でしかバリアを弱められない。
$STAT_DESC_FINAL_HIT	ファイナルヒット<N>敵が最後に<FINAL_HIT_TARGET>に与えるダメージ
$STRONG_DMG_MULT	<FLAVOR>からのダメージを<PERCENT>%減。
$STRONG_EVADE	<PERCENT>%<FLAVOR>を回避。
$SKILL_DESC_PSI_COST	Psiコスト
$SKILL_DESC_COOLDOWN	再使用まで
$SKILL_DESC_EFFECT	効果
$SKILL_DESC_TARGET	ターゲット
$SKILL_DESC_HITS	ヒット
$SKILL_DESC_HITS_NUM	ヒット回数
$SKILL_DESC_SPECIAL	
$SKILL_DESC_SPLASH	範囲攻撃
$SKILL_DESC_DMG	ダメージ
$SKILL_DESC_ADDS_CHANCE_TO_ALL	すべての攻撃に、<N><PERCENT>%<EXTRA>で<FLAV>を付与。
$SKILL_DESC_ADDS_CHANCE_TO_ONE	<LQ><ATTACK><RQ>に、<N><PERCENT>%<EXTRA>で<FLAV>を付与。
$SKILL_DESC_ADDS_TO_ALL	すべての攻撃に、<N><FLAV>を付与。
$SKILL_DESC_ADDS_TO_ONE	<LQ><ATTACK><RQ>に、<N><FLAV>を加える。
$SKILL_DESC_TOTAL_BONUS	<STAT>に+<AMOUNT><EXTRA>の<N>トータルボーナス。
$MISC_FOE_SINGULAR	敵
$MISC_FOE_PLURAL	敵
$MISC_FRIEND_SINGULAR	味方
$MISC_FRIEND_PLURAL	味方
$MISC_1_FOE	敵1体
$MISC_X_FOES	敵<NUM>体
$MISC_1_FRIEND	味方1人
$MISC_X_FRIENDS	味方<NUM>人
$MISC_ALL_FOES	射程内にいるすべての敵
$MISC_ALL_FOES_IN	<TILES>タイル内にいるすべての敵
$MISC_ALL_FRIENDS	射程内にいるすべての味方
$MISC_ALL_FRIENDS_IN	<TILES>タイル内にいるすべての味方
$MISC_ALL_TARGETS	射程内だけ狙う
$MISC_ALL_TARGETS_IN	<TILES>タイル内だけ狙う
$MISC_X_HITS_FOE	敵１体につき<NUM>回
$MISC_X_HITS_FRIEND	味方１人につき<NUM>回
$MISC_X_HITS_TARGET	１ターゲットにつき<NUM>回
$MISC_X_HITS_TOTAL	トータルで<NUM>回
$MISC_UP_TO_X_FRIENDS	<FRIEND><NUM>人まで
$MISC_UP_TO_X_FOES	<FOE><NUM>体まで
$MISC_SPLASH_DAMAGE	範囲攻撃
$MISC_SPLASH_LINE	<AMT>DMG、<TILES>タイル
$MISC_SPLASH_TILES	タイル
$MISC_SAVED!	救助！
$MISC_MISS	MISS
$MISC_PROBLEM?	問題か
$MISC_COUNTER	カウンター
$MISC_NOM!	モグモグ！
$MISC_ACHIEVEMENT!	実績獲得！
$BASE_ATTACK	基本アタック
$BONUS_DEFENSE	ボーナスディフェンス
$DECIMATE_BY	<PERCENT>%によって全滅
$EN_SPELL_FRENZY_DESC	<SEC> 秒間スピード+<PERCENT>
$EN_SPELL_HEAL_DESC	回復：<PERCENT> HP
$EN_SPELL_DRAGON_FIRE_1_DESC	<DMG>ダメージ
$EN_SPELL_DRAGON_FIRE_2_DESC	<LOW>-<HIGH>ダメージ
$SPECIAL_IMPROVES	<FLAVOR>アップ
$SPECIAL_PLUS_FLAV	<FLAVOR>追加
$SPECIAL_SAVE_VS	HP<PERCENT>%以上なら<FLAVOR>防御
$TARGET_FIRST_TITLE	最初の敵を狙う
$TARGET_FIRST_TEXT	最も近い敵を狙う
$TARGET_LAST_TITLE	最後の敵を狙う
$TARGET_LAST_TEXT	最も離れた敵を狙う
$TARGET_STRONG_TITLE	最も強い敵を狙う
$TARGET_STRONG_TEXT	HPが最も高い敵を狙う
$TARGET_WEAK_TITLE	最も弱い敵を狙う
$TARGET_WEAK_TEXT	HPが最も低い敵を狙う
$TARGET_FAST_TITLE	最も速い敵を狙う
$TARGET_FAST_TEXT	最も速く動く敵を狙う
$TARGET_HEAL_TITLE	いのち大切に
$TARGET_HEAL_TEXT	治療できる時ならいつでも治療する。よりよい攻撃テクニックが準備できても、お構いなし。
$TARGET_FIGHT_TITLE	ガンガンいくぜ
$TARGET_FIGHT_TEXT	戦える時ならいつでも戦う。よりよい治療テクニックが準備できても、お構いなし。
$TARGET_BOTH_TITLE	ブースト通り
$TARGET_BOTH_TEXT	ブーストレベルに応じてテクニックを使う。
$TARGET_CHEAP_TITLE	テクニック節約
$TARGET_CHEAP_TEXT	高いブーストテクニックは使わずに取っておく。
$TARGET_EFFECT_TITLE	ガンガン状態異常
$TARGET_EFFECT_TEXT	攻撃の影響を受けにくい敵に、エフェクトアタックを使う。
$TARGET_BULLDOG_TITLE	ブルドッグ
$TARGET_BULLDOG_TEXT	敵が射程から出るか殺すまで狙い続ける。使いどころは難しいが上級プレイヤーにお勧め！
$TARGET_CHANCE_TITLE	チャンスをモノに
$TARGET_CHANCE_TEXT	攻撃を避けたり抵抗したりしない敵を狙う。
$TARGET_BOSS_TITLE	ボスを狙え
$TARGET_BOSS_TEXT	これを使わないと、ボスの敵を無視する。
$TARGET_SAVE_TITLE	設定保存
$TARGET_SAVE_TEXT	現在のターゲット設定を、このキャラのデフォルトとして保存できます。
$CONFIRM_RES_CHANGE	解像度が変わりました。<N>ちょうどいいですか？<N><N><SECONDS>秒で元に戻ります。
$CONFIRM_RESTART_TITLE	バトルをリスタートしますか？
$CONFIRM_RESTART_TEXT	今までに入手した経験値とスクラップは没収となります。
$CONFIRM_QUIT_TITLE	バトルを中止しますか？
$CONFIRM_QUIT_TEXT	<RE>$CONFIRM_RESTART_TEXT
$MISC_LEADER	リーダー
$MISC_LEVEL	レベル
$MISC_LVLUP	レベルアップ
$MISC_LEVEL_UPX	レベルアップx
$MISC_LEVEL_UP!	レベルアップ！
$MISC_ANONYMOUS	名無し
$MISC_LEVEL_SHORT	レベル
$MISC_LEVEL_PARTY_GEM	レベル	Appears on character blocks in the party screen
$MISC_LEVEL_WAVE_BLOCK	レベル	Appears on enemy wave blocks in battle
$PARTY_HP	HP
$PARTY_PSI	Psi
$PARTY_XP	経験値
$PARTY_ATTACK	攻撃：<T>
$PARTY_RANGE	射程：<T>
$PARTY_SPEED	スピード：<T>
$PARTY_DEFEND	防御：<T>
$PARTY_EVADE	回避：<T>
$PARTY_REGEN	回復：<T>
$MISC_HP	ヒットポイント
$MISC_HP_SHORT	HP
$MISC_PSI	Psi
$MISC_SPEED	スピード
$MISC_SPEED_SHORT	SPD
$MISC_ATTACK	攻撃
$MISC_ATTACK_SHORT	ATK
$MISC_ARMOR	アーマー
$MISC_ARMOR_SHORT	ARMR
$MISC_EVADE	回避
$MISC_EVADE_SHORT	EVA
$MISC_EVASION	回避
$MISC_DEFEND	防御
$MISC_DEFENSE	防御
$MISC_DEFENSE_SHORT	DEF
$MISC_RANGE	射程
$MISC_RANGE_SHORT	RNG
$MISC_REGEN_LONG	回復
$MISC_REGEN	回復
$MISC_REGEN_SHORT	REG
$MISC_OF_DAMAGE	ダメージの
$MISC_DAMAGE	ダメージ
$MISC_DAMAGE_SHORT	DMG
$MISC_DAMAGE_RESIST	レジスト
$MISC_RESIST	レジスト<SOMETHING>
$MISC_VS	vs
$MISC_TO	to
$MISC_VERSUS	対
$MISC_DEF_SHORT	DEF
$MISC_PHASES	透明
$MISC_SWIMS	泳ぐ
$MISC_WALKS_ON	歩く
$MISC_HEAL	治療
$MISC_DEATH_SPLASH	デススプラッシュ
$MISC_PORCUPINE	とげ
$MISC_DARK	闇
$MISC_DARK_DESC	（75%で攻撃回避）
$MISC_SPAWNS	卵
$MISC_STRENGTHS	耐性
$MISC_WEAKNESSES	弱点
$MISC_IMMUNE_TO	<SOMETHING>への耐性
$MISC_AMOUNT	量
$MISC_AMOUNT_SHORT	amt
$MISC_SECOND	秒
$MISC_SECONDS	秒
$MISC_SECOND_SHORT	秒
$MISC_SECONDS_SHORT	秒
$MISC_CHANCE	確率
$MISC_THRESHOLD	入り口
$MISC_BASE_ATTACK	ベース攻撃
$MISC_BONUS_DEFENSE	ベース防衛
$MISC_SAVED	保存しました
$MISC_UNSAVED	保存していません
$MISC_EXIT	出口
$MISC_QUIT	終了
$MISC_CLOSE	閉じる
$MISC_TRY_AGAIN	やり直してください！
$MISC_RANDOM	ランダム
$MISC_HIRE	雇う！
$MISC_CANT_AFFORD	足りません
$MISC_CONFIRM_RECRUIT	雇用の確認
$MISC_CONFIRM_CHANGE	変更の確認
$MISC_MAKE_CHANGE	変更を行いますか？
$MISC_HIRE_Q	<N><SCRAP>スクラップで、<CLASS>の<NAME>を雇いますか？
$MISC_MODS	MOD
$MISC_CONFIG_DIR	コンフィグフォルダ
$MISC_LANGUAGES	言語
$MISC_PLEASE_ENTER_A_NAME!	名前を入力してください！
$MISC_ARE_YOU_SURE	これでいいですか？
$MISC_NEXT	次へ
$MISC_PREVIOUS	戻る
$MISC_PREV	戻る
$MISC_CANCEL	キャンセル
$MISC_IGNORE	無視
$MISC_SIGN_IN	サインイン
$MISC_CHANGE_USER	ユーザーを変更
$MISC_WRONG_USER	サインインしているユーザーに問題があります。
$MISC_UNDO_ALL	すべてやり直す
$MISC_UNDO	やり直す
$MISC_UNDO_NUMS	y_off:0,leading:-4
$MISC_DOWNLOAD	ダウンロード
$MISC_BEGIN	始める
$MISC_LEAVE	出る
$MISC_WEAPONS	武器
$MISC_ARMOR	鎧
$MISC_RECRUIT	雇用
$MISC_TALK	話しかける
$MISC_QUIT	止める
$MISC_ENTER	入る
$MISC_YES	はい
$MISC_NO	いいえ
$MISC_OK	OK
$MISC_ACCEPT	適用
$MISC_BACK	戻る
$MISC_REFUSE	拒否する
$MISC_RESTART	リスタートする
$MISC_RESTART?	再起動？
$MISC_OKAY	OK
$MISC_QUIT_BATTLE	バトルを止める
$MISC_NONE	なし
$MISC_SLOW	遅い
$MISC_FAST	速い
$MISC_XP	経験値
$MISC_EXPERIENCE	経験値
$MISC_SCRAP	スクラップ
$MISC_COST	コスト
$MISC_GAIN	売値
$MISC_CASUAL	カジュアル
$MISC_CASUAL_SHORT	カジュアル
$MISC_EASY	イージー
$MISC_EASY_SHORT	イージー
$MISC_NORMAL	ノーマル
$MISC_NORMAL_SHORT	ノーマル
$MISC_ADVANCED	ハード
$MISC_ADVANCED_SHORT	ハード
$MISC_EXTREME	ヘル
$MISC_EXTREME_SHORT	ヘル
$MISC_SELECT_CHALLENGE	チャレンジ選択
$MISC_REWARD	報酬：
$MISC_PERFECT_BONUS	完全勝利：
$MISC_WAVES	WAVE
$MISC_ENEMY_LEVELS	敵のレベル
$MISC_TYPES	タイプ
$MISC_PASS	クリア
$MISC_PERFECT	パーフェクト
$MISC_PERFECT!	パーフェクト！
$MISC_COMPLETE	コンプリート
$MISC_COMPLETE!	コンプリート！
$MISC_STRANGER	見知らぬ人
$MISC_DESCRIPTION	説明
$MISC_DEFENDER	ディフェンダー
$MISC_DEFENDERS	ディフェンダー
$MISC_STATS	状態
$MISC_STATUS	状態
$MISC_NO_AFFORD	買えない
$MISC_BUY	買う
$MISC_UPGRADE	強化
$MISC_SELL	売る
$MISC_NOTHING	何もありません
$MISC_NOTHING!	何もありません！
$MISC_SPECIAL	特別
$MISC_UNKNOWN	？？？
$MISC_MORE	さらに
$MISC_X_MORE	さらに<X>
$MISC_EQUIP	装備
$MISC_CANT_EQUIP!	装備できない！
$MISC_CANT_EQUIP_NUMS	font:12,x_off:0,y_off:-10
$MISC_UNEQUIP	装備を外す
$MISC_SKILLS	スキル
$MISC_SKILL	スキル
$MISC_SKILLTREE_SKILL_NUMS	font:13,x_off:-2,y_off:0
$MISC_BOOST	ブースト
$MISC_SPELL	呪文
$MISC_LOCKED	ロックされています
$MISC_SKIP	スキップ
$MISC_NOTHING_TO_EQUIP	装備するものは何もありません！
$MISC_ENABLED	有効
$MISC_DISABLED	無効
$MISC_CONFIRM	確認
$MISC_YOU_SURE	これでいいですか？
$MISC_LOADING	Loading・・・
$MISC_ENTER_TEXT	テキストを入力する：
$MISC_LOADING_PERCENT	Loading・・・<PERCENT>%
$MISC_BATTLE	バトル
$MISC_TOWN	町
$MISC_JOURNAL	日記
$MISC_MOVIES	ギャラリー
$MISC_OPTIONS	オプション
$MISC_CREDITS	クレジット
$MISC_PARTY	パーティー
$MISC_ERROR	エラーが発生しました
$MISC_ERROR!	エラーが発生しました！
$MISC_BONUS	ボーナス
$MISC_TIPS	ヒント
$MISC_CONTINUE	続ける
$MISC_PLEASE_WAIT	少々お待ちください・・・
$MISC_CLICK_HERE	ここをクリックしてください
$MISC_ASSIGN_POINTS	ポイント<N>割り当て
$MISC_ASSIGN_POINTS_NUMS	font:13,x_off:0,y_off:3,leading:-5
$MISC_NOBODY	なし
$MISC_EMPTY	なし
$MISC_CHANGE	チェンジ
$MISC_RESET	リセット
$MISC_DEFAULT	デフォルト
$MISC_SELECT	セレクト
$DATA_DUMP_LOCALES	ローカル書き出し中・・・
$DATA_DUMP_DATA	データファイル書き出し中・・・
$DATA_DUMP_CUTSCENE	カットシーンの画像書き出し中・・・
$DATA_DUMP_BKG	背景画像書き出し中・・・
$DATA_DUMP_EMBED	内蔵グラフィック書き出し中・・・
$DATA_DUMP_IMAGES	画像データ書き出し中・・・
$DATA_DUMP_TABLES	表データ書き出し中・・・
$DATA_DUMP_MOD_INFO	MOD情報書き出し中・・・
$DATA_DUMP_MAP_FILES	マップ書き出し中・・・
$DATA_DUMP_MAP_IMAGES	マップ画像書き出し中・・・
$DATA_DUMP_AUDIO	音声書き出し中・・・
$REWARD_NEXT_LEVEL	次のステージをアンロック
$REWARD_FINISH	ゲームクリア
$REWARD_QUEST	クエスト完了
$REWARD_NO_XP	なし！
$REWARD_NO_GOLD	なし！
$REWARD_XP	<PLUS> <XP> 経験値
$REWARD_GOLD	<PLUS> <GOLD> スクラップ
$HERO_BLURB_SLAK	勇敢だがちょっとバカなヘンな男・・・。
$HERO_BLURB_KETTA	遊牧民の女ハンター。ひねくれものでニヒリスト・・・。
$HERO_BLURB_BAKAL	穏やかな修道僧。罪が許される日を待っている・・・。
$HERO_BLURB_WRENNA	滅ぼされたクウェイド王国の王女。復讐を夢見ている・・・。
$HERO_BLURB_MARKOS	終わりなき戦いを経てボロボロになった騎士・・・。
$HERO_BLURB_NIRU	荒々しき神秘の存在。どんな秘密も明かそうとしない・・・。
$TALK_ASH	アッシュ難民
$TALK_QUAID	クウェイド難民
$TALK_NOMAD	遊牧難民
$TALK_CULTIST	カルト信者の難民
$MAP_TEXT_LAIR	隠れ家
$MAP_TEXT_SHRINE	祭壇
$MAP_TEXT_HERMIT	隠居
$MAP_TEXT_PRISON	牢屋
$MAP_TEXT_UNKNOWN	???
$MAP_TEXT_TREASURE	洞窟
$MCGUFFIN_LEARN_SPELL	<MCG>は新しい呪文を覚えた！
$YOU_GOT_JOIN	<CLASS>の<NAME>が<N>パーティーに加わった！
$YOU_GOT	入手！
$YOU_GOT_X	<NUM>x <THING>!
$YOU_GOT_NO_EQUIP_YET	今は、<THING>を使える人はいない<N>心配しなくても、パーティーに加わるかも。
$YOU_GOT_NO_EQUIP	このアイテムは装備できない。
$TOOLTIP_CASUAL	カジュアルモードでは、敵のヒットポイント、攻撃ダメージが少なくなっています。
$TOOLTIP_NORMAL	普通のチャレンジ。ここからスタートするのが望ましいでしょう。
$TOOLTIP_ADVANCED	少し難しいチャレンジ。でも、より良い報酬がもらえます。強くなったら挑戦しましょう。
$TOOLTIP_EXTREME	最も難しいチャレンジ。でも、最も大きい報酬がもらえます。心の準備を！
$TIP_00_TITLE	行き詰ったら
$TIP_00_TEXT	時には、前のバトルに戻るのもいいでしょう。レベル上げやお金の獲得、よりよい装備を手に入れましょう。カジュアルをプレイして、軽いチャレンジをするのもいいでしょう。
$TIP_10_TITLE	ホットキー
$TIP_10_TEXT	キーボードでゲームを操作できます！<N><N>―呪文の選択<N>―召喚キャラの選択<N>―ブースト/ディフェンダーの帰還<N>―ゲームの一時停止/再開<N>―召喚したディフェンダーを見る<N>―ターゲット/スピードの変更<N>―タブキー-インターフェースの操作<N>―キーボードでカーソル移動/クリック<N><N>(オプションメニューでキーをカスタマイズできます）
$TIP_20_TITLE	スキル
$TIP_20_TEXT	すべてのディフェンダーは、レベルアップするとスキルポイントが1上がります。<N><N>パーティーメニューでポイントを割り当て、新たな能力を解放しましょう。<N><N>１）テクニック（○）―バトルで使う攻撃<N>2)特徴（□）―パッシブスキル<N><N>上級のテクニックを使うには、ブーストが必要です。
$TIP_30_TITLE	経験値は誰のもの？
$TIP_30_TEXT	バトルの後、召喚された者が全員が生きていたなら、全員が同じ経験値を得ます。<N><N>召喚されていない者はその数に関わらず、それぞれトータルの半分の経験値を等しく得られます。<N><N>このペナルティは、ユーザー補助メニューで変更できます。
$TIP_40_TITLE	マップの確認
$TIP_40_TEXT	クリックとドラッグで、世界を見渡すことができます。キーボードでも操作できます。<N>デフォルトで、矢印キーでスクロールできるようになっています。
$TIP_50_TITLE	100%Psiで帰還
$TIP_50_TEXT	ディフェンダーを帰還させると、使ったPsiの一部が戻って来ます。<N><N>なお、最初のWAVEが出現するまでに帰還させると、全Psiを取り戻せます。
$TIP_60_TITLE	ウェブサイトとフォーラム
$TIP_60_TEXT	もし質問があれば、www.defendersquest.comのディフェンダーズ・クエスト・オンライン・コミュニティーを見てください！<N><N>コラボレーティブ・ウィキや開発ブログのフォーラムがあります。
$TIP_70_TITLE	ディフェンダーの配置
$TIP_70_TEXT	キーボードを使って、バトルにおけるディフェンダーの位置を決められます。<N><N>初期設定では、矢印キーでコントロールできます。
$TIP_80_TITLE	戦闘中の状態
$TIP_80_TEXT	ダメージの数字の色にはいくつか種類があります。白は通常、灰色はアーマーへの攻撃、赤は出血、オレンジは火、紫は毒、大きい数字はクリティカルヒットです。<N><N>オプションメニューのその他でオフにすることもできます。
$TIP_90_TITLE	特別アイテム
$TIP_90_TEXT	難しい難易度でプレイすると、特別なアイテムを見つけることができます。強力なアイテムで、店で売ることはできません。
$TIP_100_TITLE	100%のPsiで帰還
$TIP_100_TEXT	ディフェンダーを帰還させると、通常は使ったPsiの一部しか戻って来ません。<N><N>でも、WAVEが来る前に帰還させれば、PSIを100％取り戻せます。
$TIP_110_TITLE	ユーザー補助
$TIP_110_TEXT	ユーザーはオプションメニューで下記の設定を確認してください。<N><N>1)ビデオ―全画面表示、画像拡大<N>2)コントロール設定<N>3)ユーザー補助―特殊効果ON/OFF、ゲームスピード、経験値率の設定
$TIP_120_TITLE	公共サービス情報
$TIP_120_TEXT	ヒントは、コード解析・ソース解読を防止するために公表しております。
$TIP_130_TITLE	ターゲットの設定
$TIP_130_TEXT	ディフェンダーをクリックすると、ターゲットを設定できます。最初の敵、最後の敵、強い敵、弱い敵、速い敵。どれかを選択すると、その敵を攻撃するようになります。例えば［強い敵]を選ぶと、そのディフェンダーは強い敵を最初に攻撃するようになります。
$TIP_140_TITLE	詳細なターゲット設定
$TIP_140_TEXT	普通の設定だけでなく、さらに4つの設定があります。<N><N>1)テクニック節約<N>2)ガンガン状態異常<N>3)チャンスをモノに<N>4)ブルドッグモード<N><N>必ずしも使わなくても良いですが、使いこなすと戦略をより細かく設定できるでしょう。ターゲット設定の保存も可能です！
$TIP_150_TITLE	炎と氷
$TIP_150_TEXT	炎と氷は同時に使わない方がいいでしょう。炎は氷の異常を無効にし、氷は炎の異常を無効にします。
$TIP_160_TITLE	高難易度
$TIP_160_TEXT	最初から難しい難易度をプレイするのは大変です。<N><N>まずはノーマルモードから始めましょう。
$TIP_170_TITLE	装備
$TIP_170_TEXT	スターキャラに新たな装備を買えば、古い装備は他の仲間たちにとって最高のお下がりになるでしょう。
$TIP_180_TITLE	数で押し切れ
$TIP_180_TEXT	ディフェンダーを一箇所にまとめると、敵の攻撃が拡散するので、生き残るのが簡単になります。<N><N>この作戦のマイナス点は、カバーできるエリアが狭くなることです。
$TIP_190_TITLE	報酬を倍に
$TIP_190_TEXT	レベルアップのペースを調整したいなら、オプションメニューから経験値の倍率を変更してください。<N><N>初期設定では、100％になっています。<N><N>倍率を下げることもできます。
$TIP_200_TITLE	テクニックを無効に
$TIP_200_TEXT	ファイアボールで氷が溶けてしまったり、強力な攻撃を後のバトルのために取っておきたいなど、テクニックを使用したくない場合があるかもしれません。その場合は、ディフェンダーをクリックして、右下のメニューに出てくるテクニックをクリックしてください。一時的に無効にできます。
$TIP_210_TITLE	セーブファイルが見つからない時
$TIP_210_TEXT	ゲームデータのメニューに、フォルダにスパナが付いているボタンがあります。<N><N>このボタンを押せば、ゲームデータが保存されているコンフィグファイルを閲覧できます。
$TIP_220_TITLE	ニューゲーム+
$TIP_220_TEXT	ゲームクリア後は、お馴染みの仲間たちと新しくゲームを始めることができます。しかも、より厳しいバトルとクレイジーな報酬付きです！<N><N>ゲームデータのメニューから、クリア後のセーブスロットのニューゲーム+を選んでください。
$TIP_230_TITLE	強化
$TIP_230_TEXT	ニューゲーム+モードでは、特別なアイテムを稼ぎ、普通のゲームで得た装備を強化することができます。これらの強化されたアイテムには、特別な力があります！
$TIP_240_TITLE	ボーナスミッション
$TIP_240_TEXT	十分なスターを稼いだら、ボーナスバトルを始めましょう。この特別なミッションには、さらなるチャレンジとさらなる報酬があります。
$TIP_250_TITLE	燃えるPsi？
$TIP_250_TEXT	ライトニングの呪文は、Psiを燃焼します。敵の報酬Psiの一部を燃やしてしまうのです。もし、ライトニングで敵に40％のダメージを与えたなら、Psiの報酬から40％が引かれます。
$TIP_260_TITLE	MODのサポート
$TIP_260_TEXT	Defender's QuestではMODを作成できます。<N><N>ゲームデータのメニューから、大きな'M'のボタンをクリックしてください。レベル、キャラ、ステージ、キャラクター、カットシーン、画像、アイテムなどなど、何でも変えられるようになります。
$TIP_270_TITLE	お母さんを大事に
$TIP_270_TEXT	<N><N>お母さんに声をかけてあげよう。<N>寂しがってるよ。
$TYPE_DARK	闇
$TYPE_SHEEP	シープ
$TYPE_SPLITTER	スプリッター
$TYPE_WORM	ワーム
$TYPE_BOSS	ボス
$TYPE_NORMAL	ノーマル
$TYPE_CULTIST	カルト信者
$TYPE_WATER	泳げる
$TYPE_FAST	ファスト
$TYPE_SNAIL	ノロマ
$TYPE_REVENANT	レブナント
$TYPE_ATTACKER	アタッカー
$TYPE_SPITTER	スプリッター
$TYPE_NUKE_ON_KILL	全滅
$TYPE_ARMOR	アーマー
$TYPE_STATIONARY	動かない
$TYPE_TELEPORTER	転送装置
$TYPE_EXALTED	高貴
$TYPE_NO_END_DAMAGE	終わらないダメージ
$GETSCRAP1	廃品、ボロ布、壊れた道具、さびた金属片の山。<N><N>こんなもの誰が欲しがる？
$GETSCRAP2	奈落の底では、通貨として使われているようです。
$END	終わり
$BATTLE_STARTING_FORMATION_TEXT	前回と同様の陣形にしますか？
$DATA_DUMP_BACKGROUNDS	<RE>$DATA_DUMP_BKG
$DATA_DUMP_CUTSCENES	<RE>$DATA_DUMP_CUTSCENE
$DATA_DUMP_MUSIC	Musicを書き出し中・・・
$DATA_DUMP_SFX	SFXを書き出し中・・・
$DATA_DUMP_SPRITES	スプライトを書き出し中・・・
$LQ	“
$MISC_ABSORB_X	<X>を吸収
$MISC_ABSORB_X_RESIST_Y	<X>を吸収, <Y>%軽減
$MISC_ACCEPT_AND_CLOSE	適用後閉じる
$MISC_BOOST_X	<X>をブースト
$MISC_COST:	コスト:
$MISC_DEFEAT	討伐
$MISC_DEFENSE_ABS	防御
$MISC_DEMO_VERSION	デモバージョン
$MISC_DEMO_VERSION_DESC	この作品はDefender's Quest: Valley of the Forgotten, HD Special Editionのデモ版になります。<N><N>グラフィックや機能は開発中であり、製品版とは変更になる場合があります。<N><N>また不具合などが起こることもございますので、予めご了承ください。
$MISC_DQ_NEWS	ニュースをゲット！
$MISC_DQ_SITE	DefendersQuest.com
$MISC_EASIER	もっと簡単
$MISC_ERROR_INVALID_MOD_NAME	無効なMOD名です!
$MISC_ERROR_MOD_BAD	このMODは現バージョンには対応していません。
$MISC_ERROR_MOD_EXISTS	この名前のMODは既に存在しています。
$MISC_ERROR_UNKNOWN	原因不明のエラーが発生しました。
$MISC_ERROR_UNZIP	zipが解凍できません。オプションメニューでMODのパスを変更するか、ハードドライブの空き容量を確認してください。
$MISC_GAME_DATA	ゲームデータ
$MISC_GOLD	スクラップ
$MISC_GOLD:	スクラップ:
$MISC_HARD	<RE>$MISC_EXTREME
$MISC_HARDER	もっと難しい
$MISC_HARD_SHORT	<RE>$MISC_EXTREME_SHORT
$MISC_INFO	情報
$MISC_LEVEL_SHORT_X	レベル<X>
$MISC_LEVEL_SUPER_SHORT	Lv
$MISC_LEVEL_X	レベル<X>
$MISC_MEDIUM	<RE>$MISC_ADVANCED
$MISC_MEDIUM_SHORT	<RE>$MISC_ADVANCED_SHORT
$MISC_MENU	メニュー
$MISC_NEED_PSI	PSI<N>が必要
$MISC_NONE_DEFAULT	なし *
$MISC_NO_CHANGE	変更なし
$MISC_OTHER	他
$MISC_PLUS_X%_TO_ARMOR_MULT	アーマー<PLUS_OR_MINUS><X>
$MISC_PLUS_X%_TO_DEFENSE_MULT	防御<PLUS_OR_MINUS><X>%
$MISC_PLUS_X%_TO_DODGE	回避<PLUS_OR_MINUS><X>
$MISC_PLUS_X%_TO_EVADE	<RE>$MISC_PLUS_X%_TO_DODGE
$MISC_PLUS_X%_TO_REGEN_MULT	回復<PLUS_OR_MINUS><X>%
$MISC_PLUS_X_STAT	<PLUS><X> <STAT>
$MISC_PLUS_X_TO_ARMOR_ABS	アーマー<PLUS_OR_MINUS><X>
$MISC_PLUS_X_TO_ATTACK	攻撃<PLUS_OR_MINUS><X>
$MISC_PLUS_X_TO_ATTACK_SPEED	スピード<PLUS_OR_MINUS><X>
$MISC_PLUS_X_TO_DEFENSE_ABS	防御<PLUS_OR_MINUS><X>
$MISC_PLUS_X_TO_HP	ヒットポイント<PLUS_OR_MINUS><X>
$MISC_PLUS_X_TO_RANGE	射程<PLUS_OR_MINUS><X>
$MISC_PLUS_X_TO_REGEN_ABS	回復<PLUS_OR_MINUS><X>
$MISC_PSI_SHORT	psi
$MISC_RESIST_X	レジスト<X>%
$MISC_SAVE_DATA	セーブデータ
$MISC_SEND_NEXT	次へ送る
$MISC_THORNS	とげ
$MISC_UNIQUE	特別
$MISC_VICTORY	勝利
$MISC_WAIT	待機
$MISC_WEAPON	<RE>$MISC_WEAPONS
$MISC_X_PSI	<X> PSI
$RQ	”
$SKILL_DESC_HEAL	治療
$STATE_CRASH_DETAILS	詳細:
$STATE_CRASH_PROMPT	どうしますか？
$STATE_CRASH_SEND	開発者へ<N>報告する
$STATE_CRASH_SHOW_DUMP	ダンプファイルを<N>表示する
$STATE_CRASH_TITLE	重大なエラー！
$STATUS_DESC_DARK_FRENZY	<RE>$STATUS_DESC_FRENZY
$STATUS_DESC_EVER_BLEED	<RE>$STATUS_DESC_BLEED
$STATUS_DESC_FB_EXISTENTIAL	スピードが-<PERCENT>%減少、レジストが+<PERCENT>%付与。
$STATUS_DESC_FIRE	<RE>$STATUS_DESC_BURN
$STATUS_DESC_INSPIRE	<RE>$STATUS_DESC_INSPIRED
$STATUS_DESC_INSPIRED_HIT	<RE>$STATUS_DESC_INSPIRED
$STAT_DESC_ARMOR	アーマー<N>吸収されるダメージ量
$STAT_DESC_ARMOR_ENEMY	アーマー<N>吸収されるダメージ量
$STAT_DESC_SPAWN	卵:<N>
$STAT_DESC_THORNS	とげ<N>近接攻撃で攻撃してくる人にダメージを与える。
$STAT_DESC_XP	経験値<N>
$TARGET_SPECIFIC_TEXT	手動で敵を選択し攻撃します。他の敵には手を加えません。
$TARGET_SPECIFIC_TITLE	特定攻撃
$TITLE_OPTIONS	オプション
$UI_ACCESS_SEE_ALSO	参考:
$UI_ALL_FILES	すべてのファイル
$UI_CONTROLS_ACCEPT	適用
$UI_CONTROLS_ACCEPT_SELECT	適用/選択
$UI_CONTROLS_AUTO	自動検出
$UI_CONTROLS_BACK_CANCEL	戻る/キャンセル
$UI_CONTROLS_CANCEL	キャンセル
$UI_CONTROLS_CURSOR	カーソル
$UI_CONTROLS_DEVICE	デバイス
$UI_CONTROLS_GAMEPAD	ゲームパッド
$UI_CONTROLS_GAMEPAD_MODEL	モデル
$UI_CONTROLS_KEYBOARD	マウス&キーボード
$UI_CONTROLS_LOGITECH	Logitech
$UI_CONTROLS_MENU	メニュー
$UI_CONTROLS_MENU_ALT	メニュー２
$UI_CONTROLS_MINUS_PLUS_SPEED	-/+<N>スピード
$UI_CONTROLS_NAVIGATE_MENU	ナビゲートメニュー
$UI_CONTROLS_OUYA	Ouya
$UI_CONTROLS_POINTER	ポインター
$UI_CONTROLS_PRESET_COLEMAK	Colemak
$UI_CONTROLS_PRESET_DEFAULT	デフォルト
$UI_CONTROLS_PRESET_PS	PlayStation
$UI_CONTROLS_PRESET_PSJ	日本語
$UI_CONTROLS_PRESET_WIIU	WiiU デフォルト
$UI_CONTROLS_PRESET_XBOX	XBox デフォルト
$UI_CONTROLS_PS3	Playstation 3
$UI_CONTROLS_PS4	Playstation 4
$UI_CONTROLS_SEE_ALSO	参照:
$UI_CONTROLS_SELECT	選択
$UI_CONTROLS_XBOX1	Xbox One
$UI_CONTROLS_XBOX360	Xbox 360
$UI_CONTROLS_XINPUT	Xinput
$UI_DQ_SAVE_FILES	DQ<X>セーブファイル
$UI_EQUIP_ALL_ACC_BOOK	すべての本を装備しています。
$UI_EQUIP_NO_ACC_BOOK	一つも本を持っていません！
$UI_GRAPHICS_HD	HD
$UI_GRAPHICS_ORIGINAL	オリジナル
$UI_HIGH	高
$UI_HIGH()	高(<X>)
$UI_LOGGING_ALWAYS	常に
$UI_LOGGING_ASK	都度確認する
$UI_LOGGING_CRASH	クラッシュログを記録
$UI_LOGGING_CRASH_CONTENT	クラッシュログを含む:
$UI_LOGGING_CRASH_OPTIONS	ゲーム設定
$UI_LOGGING_CRASH_REPLAY	ユーザー入力の記録
$UI_LOGGING_CRASH_SAVES	ファイルの保存
$UI_LOGGING_CRASH_SCREENSHOT	スクリーンショット
$UI_LOGGING_CRASH_SYSTEM	スペック
$UI_LOGGING_NEVER	なし
$UI_LOGGING_SEND	クラッシュログを開発者へ送る
$UI_LOGGING_TITLE	ロギング
$UI_LOW	低
$UI_LOW()	低(<X>)
$UI_MOD_LOAD_MOD_TEXT	MODのロード<LQ><MOD><RQ>?<N>ゲームをリスタートします。
$UI_MOD_ZIP_FILES	Zipファイル (*.*)
$UI_RESOLUTION_CHOICES	利用可:
$UI_RESOLUTION_CURRENT	現在:
$UI_RESOLUTION_CURRENT_PARENTHESES	(現在)
$UI_RESOLUTION_TITLE	画面解像度
$UI_SELECT_A_FILE_TEXT	インポートするセーブファイルを選んでください。
$UI_SELECT_A_FILE_TITLE	ファイルを選択してください。
$UI_VIDEO_CHANGE_RES_TO	解像度を<X>に変更
$UI_VIDEO_CUTSCENES	カットシーン
$UI_VIDEO_GRAPHICS	グラフィック
$UI_VIDEO_HD	ワイド画面(16:9)
$UI_VIDEO_MATCH_MONITOR	フルスクリーンに合わせる
$UI_VIDEO_MODE	モード
$UI_VIDEO_RESOLUTION	フルスクリーンの画面解像度
$UI_VIDEO_SCREEN_SIZE	画面サイズ
$UI_VIDEO_SD	スタンダード画面 (4:3)
$UI_VIDEO_SELECT_NEW	新規を選択・・・
$UI_VIDEO_SPRITES	スプライト
$WEAK_DMG_MULT	<FLAVOR>からの+<PERCENT>%分追加ダメージ
$YOU_GOT_MONEY	<MONEY>スクラップ獲得！
$MISC_ADJUST_REWARDS	デフォルト値は100％です。アップまたはダウンで報酬を調整してください。
$MISC_BREAK_HERO_MODE_TEXT	<LQ>ヒーローモード<RQ>プレイ中は、味方ユニットを雇用できません。<N>ヒーローモードを終了して、味方ユニットを雇用しますか？
$MISC_BREAK_HERO_MODE_TITLE	ヒーローモードを終了しますか？
$MISC_CURRENT_SAVE	現在のセーブファイル：
$MISC_CUSTOM_SETTINGS	カスタマイズ…
$MISC_DEFAULT_SETTINGS	デフォルト（初心者におすすめ）
$MISC_DELETE_ACHIEVEMENT	実績を削除しますか?
$MISC_DELETE_BOTH_GOG_ACHIEVEMENT	コンピューター内とGOGの実績を削除する
$MISC_DELETE_BOTH_STEAM_ACHIEVEMENT	コンピューター内とSteamの実績を削除する
$MISC_DELETE_LOCAL_ACHIEVEMENT	コンピューター内の実績のみ削除する
$MISC_ERROR!	エラー！
$MISC_FAIL_TT_TEXT	バトルに敗北したたときに差し引かれる経験値とスクラップを調整します。<N>デフォルトは－50％です。アップまたはダウンでペナルティを調整してください。
$MISC_FAIL_TT_TITLE	<RE>$UI_ACCESS_FAILURE_PENALTY
$MISC_GOLD_TT_TEXT	バトル後に獲得するスクラップ（お金）<N><RE>[$MISC_ADJUST_REWARDS]
$MISC_GOLD_TT_TITLE	スクラップ
$MISC_HERO_MODE	ヒーローモード
$MISC_HERO_MODE_TEXT	味方ユニットは雇用できません。<N>はじめてゲームをプレイする方にはおすすめできません！<N><N>注意：<N>ヒーローモード内で味方ユニットを雇用しようとするときに出る警告を無視することで、ヒーローモードを終了して味方を雇用できるようになります。<N><N>ヒーローモードでは、経験値とスクラップの獲得率を300％に設定することを強くおすすめします。<N><N>この設定は、実績「ヒーローモード」には影響しません。この実績は、味方ユニットを雇用しないことだけが条件です。
$MISC_HERO_MODE_TITLE	<RE>$MISC_HERO_MODE
$MISC_NEW_GAME_SETTINGS	ニューゲーム設定
$MISC_NO_HARDWARE	お使いのシステムはハードウェアアクセラレーションに対応していません。ゲームを実行することはできますが、グラフィック設定を下げないとゲーム速度が低下する可能性があります。
$MISC_RESTORE_DEFAULTS	デフォルトに戻す
$MISC_SAVE_ERROR_TEXT	オートセーブに失敗しました。設定を確認してください。<N>その後、再試行します。
$MISC_SAVE_ERROR_TITLE	オートセーブエラー！
$MISC_SAVE_FIXED_TEXT	オートセーブに成功しました。正常に設定されたようですね。<N>終了します。
$MISC_SAVE_FIXED_TITLE	オートセーブが作動しています！
$MISC_WARNING	警告！
$MISC_WAVE_X	WAVE <X>
$SAVE_SLOT_DELETE_TEXT	このセーブファイルを完全に削除します。本当によろしいですか？
$SAVE_SLOT_DELETE_TITLE	セーブファイルを削除する
$SAVE_SLOT_EXPORT_TEXT	セーブファイルをテキストファイルにバックアップする。
$SAVE_SLOT_EXPORT_TITLE	セーブファイルをエクスポートする
$SAVE_SLOT_IMPORT_TEXT	コンピューター内のDefender's Questセーブファイルを検索する。
$SAVE_SLOT_IMPORT_TITLE	セーブファイルをインポートする
$SAVE_SLOT_NEW_GAME_PLUS_TEXT	獲得した経験値、スキル、装備を引き継いで、より難易度の高いニューゲームをスタートします。ニューゲーム+では、新しいタイプの敵、新しいクエスト、より強力な装備、そしてより多くの日記が登場します。 <N><N>注意：パーティーの成長はオリジナルゲームのデータと同期されます。オリジナルゲームとニューゲーム+間では、完全に自由にパーティーを行き来させることができます。
$SAVE_SLOT_NEW_GAME_PLUS_TITLE	ニューゲーム+をスタートする
$SAVE_SLOT_PLAY_PLUS_TEXT	パーティーの成長はオリジナルゲームのデータと同期されます。オリジナルゲームとニューゲーム+間では、完全に自由にパーティーを行き来させることができます。
$SAVE_SLOT_PLAY_PLUS_TITLE	ニューゲーム+を再開する
$UI_ACCESS_FAILURE_PENALTY	敗北ペナルティ
$UI_DEMO_IMPORT_OPTIONS	デモ版からオプション設定をインポートしますか？
$UI_DEMO_OPTIONS_DETECTED	デモ版のオプション設定があります！
$UI_LEGACY_IMPORT_SAVES	旧バージョンのDefender's Questからセーブファイルをインポートしますか？
$UI_LEGACY_SAVES_DETECTED	旧バージョンのセーブファイルがあります！
$YOU_GOT_NEW_GAME_PLUS_TEXT	おめでとうございます！パーティーはそのままで、新しい冒険を始めることができます。<N><N>変異して新たな能力を持った敵と対峙し、新たなすばらしいパワーを備えた武器を装備し、図書館に新たな本を加えましょう。追加のカットシーンとストーリーを楽しめるたくさんの新たなサイドクエストをプレイし、開発者の解説をアンロックし、エズティル・テノクのことばを解読し、新たなキャラクターを使用するなど、たくさんのことができます！<N><N><RE>[$NEW_GAME_PLUS_NOTE]<N><N><LQ>オリジナル<RQ>ゲームにはいつでも戻ることができます。
$YOU_GOT_NEW_GAME_PLUS_TITLE	ニューゲーム+が解除されました！
$MISC_PLEASE_RECONNECT_CONTROLLER	コントローラーを\n接続しなおしてください
$PRESS_A	<A> ボタンを押すと開始します。
$MISC_REQUIRES_RESTART	(再起動が必要)
$MISC_PICTURE_SIZE	画像サイズ
$MISC_SIGNED_OUT	<USER> はサインアウトしました
$MISC_SIGNED_IN	<USER> としてサインイン済み
$MISC_SWITCH_USER	ユーザーをきりかえ
$MISC_RESTART_XBOX	Xbox を再起動しますか?