flag	content
$SCENE_OPENING_TITLE	オープニング
$NARR_OPENING_00_TEXT	*私の名は$MCG
$NARR_OPENING_10_TEXT	私は、死を待つ身
$NARR_OPENING_20_TEXT	彼らは待ってくれない
$NARR_OPENING_30_TEXT	死体の火葬すらしてくれない
$NARR_OPENING_40_TEXT	死体を町から運び出し・・・
$NARR_OPENING_50_TEXT	・・・そして、奈落の底へと突き落とす
$SCENE_WHERE_AM_I_TITLE	生と死のはざま
$NARR_WHERE_AM_I_00_TEXT	ACT I
$NARR_WHERE_AM_I_00_SUB_TEXT	*生と死、ふたつの世界に片足を踏み入れながらも、<N>魂ははざまを彷徨う。<N>死に瀕した人の目に、すべてが映る。
$NARR_WHERE_AM_I_00_SUB_SUB_TEXT	*$N$N$N$N$N$N-遊牧民のことわざ
$LINE_WHERE_AM_I_00_CHAR	感染者
$LINE_WHERE_AM_I_00_TEXT	あの人の気配を、感じますか？
$LINE_WHERE_AM_I_10_CHAR	$MCG
$LINE_WHERE_AM_I_10_TEXT	えっ、何？ここはどこ？
$LINE_WHERE_AM_I_20_CHAR	感染者
$LINE_WHERE_AM_I_20_TEXT	あの方が私たちを呼んでいます・・・。
$LINE_WHERE_AM_I_30_CHAR	感染者
$LINE_WHERE_AM_I_30_TEXT	さあ、あの方の元へと行きましょう・・・。
$LINE_WHERE_AM_I_40_CHAR	感染者
$LINE_WHERE_AM_I_40_TEXT	さあ、もうちょっと、あと少しで・・・。
$LINE_WHERE_AM_I_50_CHAR	$MCG
$LINE_WHERE_AM_I_50_TEXT	何してるの？気が狂ったの？
$LINE_WHERE_AM_I_60_CHAR	感染者
$LINE_WHERE_AM_I_60_TEXT	あの御声に耳を澄まして・・・。
$LINE_WHERE_AM_I_70_CHAR	感染者
$LINE_WHERE_AM_I_70_TEXT	あの方は、多くのものをくださる・・・。<N>偉大なる存在の一部にしてもらえるの・・・。
$LINE_WHERE_AM_I_80_CHAR	感染者
$LINE_WHERE_AM_I_80_TEXT	抵抗するのは、愚か者だ！
$LINE_WHERE_AM_I_90_CHAR	$MCG
$LINE_WHERE_AM_I_90_TEXT	近寄らないで！
$LINE_WHERE_AM_I_100_CHAR	声
$LINE_WHERE_AM_I_100_TEXT	すべての者がここに集う。ここは、始まりの場所。
$LINE_WHERE_AM_I_110_CHAR	$MCG
$LINE_WHERE_AM_I_110_TEXT	ここから出して！
$LINE_WHERE_AM_I_120_CHAR	声
$LINE_WHERE_AM_I_120_TEXT	やれ。
$LINE_WHERE_AM_I_130_CHAR	$MCG
$LINE_WHERE_AM_I_130_TEXT	動け・・・ない・・・。
$LINE_WHERE_AM_I_140_CHAR	$MCG
$LINE_WHERE_AM_I_140_TEXT	助けて・・・誰か・・・。
$LINE_WHERE_AM_I_150_CHAR	$BER
$LINE_WHERE_AM_I_150_TEXT	どうしたどうした？どこで何が・・・？
$SCENE_MEET_BERSERKER_TITLE	ヘンな友との出会い
$LINE_MEET_BERSERKER_00_CHAR	$MCG
$LINE_MEET_BERSERKER_00_TEXT	うっわあ。
$LINE_MEET_BERSERKER_10_CHAR	$MCG
$LINE_MEET_BERSERKER_10_TEXT	何が起こったの？
$LINE_MEET_BERSERKER_20_CHAR	$BER
$LINE_MEET_BERSERKER_20_TEXT	知らねーな。つい5分前まで、お前はただの死体で、俺は新しい靴を狙う泥棒だったんだ。
$LINE_MEET_BERSERKER_30_CHAR	$BER
$LINE_MEET_BERSERKER_30_TEXT	いいニュースだ！お前は生きている。もう感染症にかかってはいないようだ。
$LINE_MEET_BERSERKER_40_CHAR	$MCG
$LINE_MEET_BERSERKER_40_TEXT	ここは、どこ？
$LINE_MEET_BERSERKER_50_CHAR	$BER
$LINE_MEET_BERSERKER_50_TEXT	悪いニュースだ！俺はもう新しい靴が手に入らない。
$LINE_MEET_BERSERKER_60_CHAR	$BER
$LINE_MEET_BERSERKER_60_TEXT	それにお前は、俺たちとともに感染者の集落に閉じ込められてる。
$LINE_MEET_BERSERKER_70_CHAR	$MCG
$LINE_MEET_BERSERKER_70_TEXT	奈落の谷ね・・・。
$LINE_MEET_BERSERKER_80_CHAR	$BER
$LINE_MEET_BERSERKER_80_TEXT	そう落ち込むな！お前は生き抜いたんだから、免疫があるはずだ。
$LINE_MEET_BERSERKER_90_CHAR	$MCG
$LINE_MEET_BERSERKER_90_TEXT	それじゃ、見張りが私たちを外に出してくれるのね？
$LINE_MEET_BERSERKER_100_CHAR	$BER
$LINE_MEET_BERSERKER_100_TEXT	ヤツらを説得しようとしてもいいが、耳を貸してくれないだろうぜ。
$LINE_MEET_BERSERKER_110_CHAR	$BER
$LINE_MEET_BERSERKER_110_TEXT	返答代わりに、雨のように矢を降らせてくれるだろうな。ご丁重に。
$LINE_MEET_BERSERKER_120_CHAR	$BER
$LINE_MEET_BERSERKER_120_TEXT	まったく、最近のアッシュ王国はどんな礼儀作法を教えてるんだか。
$LINE_MEET_BERSERKER_130_CHAR	$MCG
$LINE_MEET_BERSERKER_130_TEXT	・・・。
$LINE_MEET_BERSERKER_140_CHAR	$MCG
$LINE_MEET_BERSERKER_140_TEXT	私、まだわからないの。何が起こったのか・・・向こう側で・・・。
$LINE_MEET_BERSERKER_150_CHAR	$BER
$LINE_MEET_BERSERKER_150_TEXT	心配すんな。俺も、初めて『死病』にかかった時は、同じ幻覚を見たんだ。
$LINE_MEET_BERSERKER_160_CHAR	$MCG
$LINE_MEET_BERSERKER_160_TEXT	待って――あの時、私と一緒にいたでしょ！？幻覚ではないわ。
$LINE_MEET_BERSERKER_170_CHAR	$BER
$LINE_MEET_BERSERKER_170_TEXT	わっ、ありゃ何だ？キャラバンか！
$LINE_MEET_BERSERKER_180_CHAR	$MCG
$LINE_MEET_BERSERKER_180_TEXT	待って！
$LINE_MEET_BERSERKER_190_CHAR	$MCG
$LINE_MEET_BERSERKER_190_TEXT	せめて、名前を教えて！
$SCENE_SECOND_BATTLE_TITLE	死人のキャラバン
$LINE_SECOND_BATTLE_00_CHAR	$BER
$LINE_SECOND_BATTLE_00_TEXT	よう、キャラバンども！誰か、新品の靴を持ってないか？
$LINE_SECOND_BATTLE_10_CHAR	感染したキャラバンの見張り
$LINE_SECOND_BATTLE_10_TEXT	どうか、ご勘弁を・・・。<N>オジマル様への・・・貢物なんです・・・。
$LINE_SECOND_BATTLE_20_CHAR	$BER
$LINE_SECOND_BATTLE_20_TEXT	おおっと。
$LINE_SECOND_BATTLE_30_CHAR	$MCG
$LINE_SECOND_BATTLE_30_TEXT	この人たち、誰？
$LINE_SECOND_BATTLE_40_CHAR	$BER
$LINE_SECOND_BATTLE_40_TEXT	別のところへ行こう。今すぐにだ。
$LINE_SECOND_BATTLE_50_CHAR	$MCG
$LINE_SECOND_BATTLE_50_TEXT	でも、助けを求めているわ！
$LINE_SECOND_BATTLE_60_CHAR	$BER
$LINE_SECOND_BATTLE_60_TEXT	はは、まさか。
$LINE_SECOND_BATTLE_70_CHAR	$MCG
$LINE_SECOND_BATTLE_70_TEXT	放っておけない！
$LINE_SECOND_BATTLE_80_CHAR	$BER
$LINE_SECOND_BATTLE_80_TEXT	けど、死病にかかってんだぜ。
$LINE_SECOND_BATTLE_90_CHAR	$MCG
$LINE_SECOND_BATTLE_90_TEXT	でも、私たちには免疫があるんでしょ？
$LINE_SECOND_BATTLE_100_CHAR	$BER
$LINE_SECOND_BATTLE_100_TEXT	あいつらが憑変したら、どうする？<N>顔をかじられることに、免疫はないぜ。
$LINE_SECOND_BATTLE_110_CHAR	$MCG
$LINE_SECOND_BATTLE_110_TEXT	憑変？
$LINE_SECOND_BATTLE_120_CHAR	感染したキャラバンの見張り
$LINE_SECOND_BATTLE_120_TEXT	うっ、うううっ。びぎゃああァぁアアぁぁァぁアあーーッ！
$LINE_SECOND_BATTLE_130_CHAR	$BER
$LINE_SECOND_BATTLE_130_TEXT	ああいう風にさ。
$LINE_SECOND_BATTLE_140_CHAR	$BER
$LINE_SECOND_BATTLE_140_TEXT	へへ、お前と知り合えてよかったよ。
$LINE_SECOND_BATTLE_150_CHAR	$MCG
$LINE_SECOND_BATTLE_150_TEXT	待って！
$LINE_SECOND_BATTLE_160_CHAR	$BER
$LINE_SECOND_BATTLE_160_TEXT	・・・。
$LINE_SECOND_BATTLE_170_CHAR	$BER
$LINE_SECOND_BATTLE_170_TEXT	大丈夫？
$SCENE_TALK_BERSERKER_TITLE	貢物襲撃
$LINE_TALK_BERSERKER_00_CHAR	$MCG
$LINE_TALK_BERSERKER_00_TEXT	あの人たち・・・モンスターに変身したわ！
$LINE_TALK_BERSERKER_10_CHAR	$BER
$LINE_TALK_BERSERKER_10_TEXT	お前、この土地のもんじゃねーな。
$LINE_TALK_BERSERKER_20_CHAR	$BER
$LINE_TALK_BERSERKER_20_TEXT	死病で死んだ人間には、ああいうことが起こるんだ。
$LINE_TALK_BERSERKER_30_CHAR	$MCG
$LINE_TALK_BERSERKER_30_TEXT	私たち、さっきと同じ場所にいた・・・<N>あの、生と死のはざまに・・・。
$LINE_TALK_BERSERKER_40_CHAR	$MCG
$LINE_TALK_BERSERKER_40_TEXT	ここは最悪だわ。出ましょう！
$LINE_TALK_BERSERKER_50_CHAR	$BER
$LINE_TALK_BERSERKER_50_TEXT	おいおい、しっかりしろよ。<N>皆、10年以上もここを出ようとしてるんだぜ。
$LINE_TALK_BERSERKER_60_CHAR	$MCG
$LINE_TALK_BERSERKER_60_TEXT	こんなことが、10年以上も続いているの？！
$LINE_TALK_BERSERKER_70_CHAR	$BER
$LINE_TALK_BERSERKER_70_TEXT	お前さあ、都会の出身だろ。
$LINE_TALK_BERSERKER_80_CHAR	$MCG
$LINE_TALK_BERSERKER_80_TEXT	私は、王室で司書を務めているの。
$LINE_TALK_BERSERKER_90_CHAR	$BER
$LINE_TALK_BERSERKER_90_TEXT	なるほどな。王様の摂政は、お口が固くていらっしゃる。
$LINE_TALK_BERSERKER_100_CHAR	$BER
$LINE_TALK_BERSERKER_100_TEXT	お前、戦争が終わったことさえ知らねーだろ。
$LINE_TALK_BERSERKER_110_CHAR	$MCG
$LINE_TALK_BERSERKER_110_TEXT	戦争が終わった！？<N>じゃあ、あの兵士たち・・・軍はどこに派遣されてるの？
$LINE_TALK_BERSERKER_120_CHAR	$BER
$LINE_TALK_BERSERKER_120_TEXT	考えてみろよ。人をモンスターに変える病気だぜ？<N>かなり大掛かりな封じ込めが必要ってことさ！
$LINE_TALK_BERSERKER_130_CHAR	$MCG
$LINE_TALK_BERSERKER_130_TEXT	ひどい！
$LINE_TALK_BERSERKER_140_CHAR	$BER
$LINE_TALK_BERSERKER_140_TEXT	まあ、前向きに考えようぜーー<N>少なくとも、レブナントはいなくなった。
$LINE_TALK_BERSERKER_150_CHAR	$BER
$LINE_TALK_BERSERKER_150_TEXT	いやいや、単にいなくなったんじゃないぜ。完全に死んだんだ！
$LINE_TALK_BERSERKER_160_CHAR	$BER
$LINE_TALK_BERSERKER_160_TEXT	今まで、これができた人間はいねえ。
$LINE_TALK_BERSERKER_170_CHAR	$MCG
$LINE_TALK_BERSERKER_170_TEXT	ホント？
$LINE_TALK_BERSERKER_180_CHAR	$BER
$LINE_TALK_BERSERKER_180_TEXT	レブナントは無敵だ・・・少なくとも、今まではな！
$LINE_TALK_BERSERKER_190_CHAR	$BER
$LINE_TALK_BERSERKER_190_TEXT	よかったな。今日は、すげえついてる！
$LINE_TALK_BERSERKER_200_CHAR	$BER
$LINE_TALK_BERSERKER_200_TEXT	謎の魔力を持つ親友ができたぜ・・・。
$LINE_TALK_BERSERKER_210_CHAR	$BER
$LINE_TALK_BERSERKER_210_TEXT	しかも、宝を満載したキャラバンには見張りがいねえ！<N>俺たちは金持ちだ！マジで金持ちだぜ！
$LINE_TALK_BERSERKER_220_CHAR	$BER
$LINE_TALK_BERSERKER_220_TEXT	お。これ、靴か？
$SCENE_CAUGHT_BY_OZIMAL_TITLE	囚われの身
$LINE_CAUGHT_BY_OZIMAL_00_CHAR	$MCG
$LINE_CAUGHT_BY_OZIMAL_00_TEXT	*$BER。
$LINE_CAUGHT_BY_OZIMAL_10_CHAR	大男
$LINE_CAUGHT_BY_OZIMAL_10_TEXT	盗賊か。まったく、仕方ないな。
$LINE_CAUGHT_BY_OZIMAL_20_CHAR	$MCG
$LINE_CAUGHT_BY_OZIMAL_20_TEXT	あなたは？
$LINE_CAUGHT_BY_OZIMAL_30_CHAR	オジマル
$LINE_CAUGHT_BY_OZIMAL_30_TEXT	私は奈落の谷の王、オジマル・カズ。この宝は、私のものだ。
$LINE_CAUGHT_BY_OZIMAL_40_CHAR	$MCG
$LINE_CAUGHT_BY_OZIMAL_40_TEXT	待って、私はここに来たばかりなの。<N>知らなかっただけ――
$LINE_CAUGHT_BY_OZIMAL_50_CHAR	オジマル
$LINE_CAUGHT_BY_OZIMAL_50_TEXT	おい、この死に損ないの盗賊をコロシアムにぶちこめ！
$LINE_CAUGHT_BY_OZIMAL_60_CHAR	オジマル
$LINE_CAUGHT_BY_OZIMAL_60_TEXT	オジマル・カズから物を盗めば、どうなるか思い知らせてやれ。
$SCENE_COLISEUM_INTRO_TITLE	コロシアム
$LINE_COLISEUM_INTRO_00_CHAR	$MCG
$LINE_COLISEUM_INTRO_00_TEXT	嫌な感じ・・・。
$LINE_COLISEUM_INTRO_10_CHAR	囚人
$LINE_COLISEUM_INTRO_10_TEXT	君、処刑は初めてみたいね。
$LINE_COLISEUM_INTRO_20_CHAR	$MCG
$LINE_COLISEUM_INTRO_20_TEXT	処刑？
$LINE_COLISEUM_INTRO_30_CHAR	囚人
$LINE_COLISEUM_INTRO_30_TEXT	そう。もうすぐ門が開いて、<N>なだれ込んで来るモンスターに食われる。
$LINE_COLISEUM_INTRO_40_CHAR	$MCG
$LINE_COLISEUM_INTRO_40_TEXT	それじゃ・・・私たちは死ぬの？
$LINE_COLISEUM_INTRO_50_CHAR	囚人
$LINE_COLISEUM_INTRO_50_TEXT	そうさ。これが、奈落の谷という場所。
$LINE_COLISEUM_INTRO_60_CHAR	囚人
$LINE_COLISEUM_INTRO_60_TEXT	君のようなお嬢さんが<N>どうするつもりか知らないけれど、私は戦うよ。
$LINE_COLISEUM_INTRO_70_CHAR	$MCG
$LINE_COLISEUM_INTRO_70_TEXT	*待って！どうせ死ぬんだったら、<N>せめて自己紹介くらいしましょうよ。私は、$MCG。
$LINE_COLISEUM_INTRO_80_CHAR	囚人
$LINE_COLISEUM_INTRO_80_TEXT	お会いできて光栄。私は・・・
$SCENE_COLISEUM_OUTRO_TITLE	逆境にも負けず
$LINE_COLISEUM_OUTRO_00_CHAR	衛兵
$LINE_COLISEUM_OUTRO_00_TEXT	レブナントが全滅しました！
$LINE_COLISEUM_OUTRO_10_CHAR	オジマル
$LINE_COLISEUM_OUTRO_10_TEXT	ありえん！レブナントは誰にも殺せないはずだ！
$LINE_COLISEUM_OUTRO_20_CHAR	衛兵
$LINE_COLISEUM_OUTRO_20_TEXT	あの新入りの娘ですよ・・・。何をしたのかは<N>わかりませんが、囚人は皆無事で、レブナントは全滅です。
$LINE_COLISEUM_OUTRO_30_CHAR	オジマル
$LINE_COLISEUM_OUTRO_30_TEXT	面白い・・・。
$LINE_COLISEUM_OUTRO_40_CHAR	オジマル
$LINE_COLISEUM_OUTRO_40_TEXT	ヤツらを牢屋にぶち込め！
$LINE_COLISEUM_OUTRO_50_CHAR	衛兵
$LINE_COLISEUM_OUTRO_50_TEXT	はっ！
$LINE_COLISEUM_OUTRO_60_CHAR	オジマル
$LINE_COLISEUM_OUTRO_60_TEXT	それから、我が盟友の『コレクター』に手紙を送っておけ。
$LINE_COLISEUM_OUTRO_70_CHAR	オジマル
$LINE_COLISEUM_OUTRO_70_TEXT	面白い品物を仕入れたとな。
$SCENE_OZIMAL_PRISON_TITLE	牢屋の中
$LINE_OZIMAL_PRISON_00_CHAR	$RAN
$LINE_OZIMAL_PRISON_00_TEXT	で、さっきは一体何をしたの？
$LINE_OZIMAL_PRISON_10_CHAR	$RAN
$LINE_OZIMAL_PRISON_10_TEXT	何て言うか・・・心が一度に二つの方向に<N>引っ張られたみたいな・・・。
$LINE_OZIMAL_PRISON_20_CHAR	$MCG
$LINE_OZIMAL_PRISON_20_TEXT	ごめんなさい、よくわからないの。<N>わかるのは、それが役に立つってことだけ。
$LINE_OZIMAL_PRISON_30_CHAR	$MCG
$LINE_OZIMAL_PRISON_30_TEXT	何にせよ、こうして生きてる！それって良いことじゃない？
$LINE_OZIMAL_PRISON_40_CHAR	$RAN
$LINE_OZIMAL_PRISON_40_TEXT	生きているけど、気がヘンになりそう。<N>ああ、一杯やりたい。
$LINE_OZIMAL_PRISON_50_CHAR	$MCG
$LINE_OZIMAL_PRISON_50_TEXT	私も。
$LINE_OZIMAL_PRISON_60_CHAR	謎の人物
$LINE_OZIMAL_PRISON_60_TEXT	*しーっ！$MCG！こちらへ！
$LINE_OZIMAL_PRISON_70_CHAR	$MCG
$LINE_OZIMAL_PRISON_70_TEXT	どうして私の名前を？
$LINE_OZIMAL_PRISON_80_CHAR	謎の人物
$LINE_OZIMAL_PRISON_80_TEXT	衛兵はすぐに戻ってきます。<N>生きてここを出たいのなら、良く聞いてください。
$LINE_OZIMAL_PRISON_90_CHAR	$MCG
$LINE_OZIMAL_PRISON_90_TEXT	あなたは、誰？
$LINE_OZIMAL_PRISON_100_CHAR	謎の人物
$LINE_OZIMAL_PRISON_100_TEXT	あなたの味方ですよ。
$LINE_OZIMAL_PRISON_110_CHAR	謎の人物
$LINE_OZIMAL_PRISON_110_TEXT	聞いてください。明日、オジマルはあなたを赤服の男に<N>売るつもりです。そんなことをさせる訳にはいきません。
$LINE_OZIMAL_PRISON_120_CHAR	$MCG
$LINE_OZIMAL_PRISON_120_TEXT	・・・。
$LINE_OZIMAL_PRISON_130_CHAR	謎の人物
$LINE_OZIMAL_PRISON_130_TEXT	彼は再びあなたをコロシアムに送り、<N>その能力を披露させるつもりです。
$LINE_OZIMAL_PRISON_140_CHAR	$MCG
$LINE_OZIMAL_PRISON_140_TEXT	どうして―
$LINE_OZIMAL_PRISON_150_CHAR	謎の人物
$LINE_OZIMAL_PRISON_150_TEXT	その時、私が騒動を起こします。その隙に逃げるのです。
$LINE_OZIMAL_PRISON_160_CHAR	謎の人物
$LINE_OZIMAL_PRISON_160_TEXT	このスクラップを差し上げます。これで、囚人を買収し、助けを得るのです。<N>どうか、明日のための準備を。
$LINE_OZIMAL_PRISON_170_CHAR	$MCG
$LINE_OZIMAL_PRISON_170_TEXT	どうして、私を助けてくれるんですか？
$LINE_OZIMAL_PRISON_180_CHAR	謎の人物
$LINE_OZIMAL_PRISON_180_TEXT	今は知らない方が身のためでしょう。<N>修道院で私を見つけてください。そこで、すべてを話しましょう。
$LINE_OZIMAL_PRISON_190_CHAR	$MCG
$LINE_OZIMAL_PRISON_190_TEXT	わかりました。
$LINE_OZIMAL_PRISON_200_CHAR	謎の人物
$LINE_OZIMAL_PRISON_200_TEXT	*$MCG、彼の手にかかってはいけませんよ。
$SCENE_COLISEUM_2_INTRO_TITLE	小さなショー
$LINE_COLISEUM_2_INTRO_00_CHAR	オジマル
$LINE_COLISEUM_2_INTRO_00_TEXT	我が客人よ。外の様子はいかがかな？
$LINE_COLISEUM_2_INTRO_10_CHAR	赤服の男
$LINE_COLISEUM_2_INTRO_10_TEXT	クウェイド帝国は、死病で完全に崩壊した。<N>変わり果てた姿の感染者ども以外に、何も残っていない。
$LINE_COLISEUM_2_INTRO_20_CHAR	オジマル
$LINE_COLISEUM_2_INTRO_20_TEXT	素晴らしい知らせだ。
$LINE_COLISEUM_2_INTRO_30_CHAR	赤服の男
$LINE_COLISEUM_2_INTRO_30_TEXT	疫病はアッシュ王国にまで広がっている。<N>やつらが手を打たなければ、クウェイド戦争よりも甚大な被害を引き起こしてくれるだろう。
$LINE_COLISEUM_2_INTRO_40_CHAR	オジマル
$LINE_COLISEUM_2_INTRO_40_TEXT	慌てふためいたアッシュ王国が感染者をこの地に送り続ける限り、我々「奈落の王」は商売安泰だな。
$LINE_COLISEUM_2_INTRO_50_CHAR	オジマル
$LINE_COLISEUM_2_INTRO_50_TEXT	やり方さえ知っていれば、死病の化け物は利用しがいがあるからな。
$LINE_COLISEUM_2_INTRO_60_CHAR	赤服の男
$LINE_COLISEUM_2_INTRO_60_TEXT	世間話はもういいだろう。例の娘はどこに？
$LINE_COLISEUM_2_INTRO_70_CHAR	オジマル
$LINE_COLISEUM_2_INTRO_70_TEXT	あそこだ。きっと、彼女の能力に興味を持つだろう。
$LINE_COLISEUM_2_INTRO_80_CHAR	赤服の男
$LINE_COLISEUM_2_INTRO_80_TEXT	どうだろうな。
$LINE_COLISEUM_2_INTRO_90_CHAR	オジマル
$LINE_COLISEUM_2_INTRO_90_TEXT	彼女がトランス状態になると、連れは生と死のはざまへ旅立つのだ。
$LINE_COLISEUM_2_INTRO_100_CHAR	オジマル
$LINE_COLISEUM_2_INTRO_100_TEXT	その周りで、レブナントたちがバタバタと死んでいく。<N>まるで、見えない打撃で打ちのめされるかのようにな。
$LINE_COLISEUM_2_INTRO_110_CHAR	赤服の男
$LINE_COLISEUM_2_INTRO_110_TEXT	見せてもらおうか。
$LINE_COLISEUM_2_INTRO_120_CHAR	オジマル
$LINE_COLISEUM_2_INTRO_120_TEXT	衛兵よ！レブナントを放て！
$SCENE_COLISEUM_2_OUTRO_TITLE	大脱走
$LINE_COLISEUM_2_OUTRO_00_CHAR	赤服の男
$LINE_COLISEUM_2_OUTRO_00_TEXT	信じられん。あの娘にはやつらの真の姿が見えるのか。
$LINE_COLISEUM_2_OUTRO_10_CHAR	赤服の男
$LINE_COLISEUM_2_OUTRO_10_TEXT	彼女は、やつらの世界で戦っている。
$LINE_COLISEUM_2_OUTRO_20_CHAR	オジマル
$LINE_COLISEUM_2_OUTRO_20_TEXT	興味を持っていただけたようだな。
$LINE_COLISEUM_2_OUTRO_30_CHAR	赤服の男
$LINE_COLISEUM_2_OUTRO_30_TEXT	倍額を支払おう。対等な者とやりとりする機会もあまりないしな。
$LINE_COLISEUM_2_OUTRO_40_CHAR	赤服の男
$LINE_COLISEUM_2_OUTRO_40_TEXT	何が起きた！
$LINE_COLISEUM_2_OUTRO_50_CHAR	オジマル
$LINE_COLISEUM_2_OUTRO_50_TEXT	衛兵ども！
$LINE_COLISEUM_2_OUTRO_60_CHAR	衛兵
$LINE_COLISEUM_2_OUTRO_60_TEXT	コロシアムの南の壁が、完全に崩壊しました！
$LINE_COLISEUM_2_OUTRO_70_CHAR	衛兵
$LINE_COLISEUM_2_OUTRO_70_TEXT	囚人たちが逃げだしたようです！
$LINE_COLISEUM_2_OUTRO_80_CHAR	オジマル
$LINE_COLISEUM_2_OUTRO_80_TEXT	何だって！
$LINE_COLISEUM_2_OUTRO_90_CHAR	オジマル
$LINE_COLISEUM_2_OUTRO_90_TEXT	レブナントを放て！やつらを捕まえろ！
$SCENE_RIVER_INTRO_TITLE	川を渡って
$LINE_RIVER_INTRO_00_CHAR	$MCG
$LINE_RIVER_INTRO_00_TEXT	みんな、こっちよ！
$LINE_RIVER_INTRO_10_CHAR	$RAN
$LINE_RIVER_INTRO_10_TEXT	無理だって！捕まるよ！
$LINE_RIVER_INTRO_20_CHAR	$MCG
$LINE_RIVER_INTRO_20_TEXT	急いで川を渡って！私たちが浅瀬で食い止める！
$LINE_RIVER_INTRO_30_CHAR	$RAN
$LINE_RIVER_INTRO_30_TEXT	にしたって、あいつら、数が多すぎる！
$LINE_RIVER_INTRO_40_CHAR	$BER
$LINE_RIVER_INTRO_40_TEXT	やるこたぁ、ただ一つ・・・
$LINE_RIVER_INTRO_50_CHAR	$BER
$LINE_RIVER_INTRO_50_TEXT	我が身の危険をかえりみず、クレイジーにブチ切れて暴れまくってやろうぜ！
$LINE_RIVER_INTRO_60_CHAR	$MCG
$LINE_RIVER_INTRO_60_TEXT	あ、この感覚は一体・・・？
$LINE_RIVER_INTRO_70_CHAR	$MCG
$LINE_RIVER_INTRO_70_TEXT	*$BER!アンタの考え、悪くないかも！
$SCENE_RIVER_OUTRO_TITLE	逃亡
$NARR_RIVER_OUTRO_00_TEXT	ACT II
$NARR_RIVER_OUTRO_00_SUB_TEXT	裏切り者、名誉を闇に葬り去る者がいれば、<N>私はその者の目に唾を吐きかけましょう。<N>その者が自らの血で溺れ死なんことを。<N>その者の亡骸が地の中で朽ち果てんことを。<N>その者の骨が永遠の霜に蝕まれんことを。
$NARR_RIVER_OUTRO_00_SUB_SUB_TEXT	*$N$N$N$N$N$N$N$N-クウェイドの就任宣誓から
$LINE_RIVER_OUTRO_00_CHAR	$BER
$LINE_RIVER_OUTRO_00_TEXT	さあて、第2ラウンドといこうか！
$LINE_RIVER_OUTRO_10_CHAR	$BER
$LINE_RIVER_OUTRO_10_TEXT	お前らの顔を八つ裂きにして、頭蓋骨を観葉植物の鉢にしてやる！
$LINE_RIVER_OUTRO_20_CHAR	$MCG
$LINE_RIVER_OUTRO_20_TEXT	*$BER、もう敵はみんな死んでるよ。
$LINE_RIVER_OUTRO_30_CHAR	$BER
$LINE_RIVER_OUTRO_30_TEXT	わお。
$LINE_RIVER_OUTRO_40_CHAR	$BER
$LINE_RIVER_OUTRO_40_TEXT	じゃあ、これからどうする？
$LINE_RIVER_OUTRO_50_CHAR	$MCG
$LINE_RIVER_OUTRO_50_TEXT	えーと、あの不思議な老人が、修道院に会いに来てと言ってたから・・・。
$LINE_RIVER_OUTRO_60_CHAR	$BER
$LINE_RIVER_OUTRO_60_TEXT	ああ、奈落の谷の北側にあるセリーニ修道院のことだな。
$LINE_RIVER_OUTRO_70_CHAR	$MCG
$LINE_RIVER_OUTRO_70_TEXT	この感染者の集落に・・・アッシュ寺の僧侶たちがいるの？
$LINE_RIVER_OUTRO_80_CHAR	$BER
$LINE_RIVER_OUTRO_80_TEXT	ここより僧侶にふさわしい場所はないだろ？来いよ、道を案内するよ。
$LINE_RIVER_OUTRO_90_CHAR	$RAN
$LINE_RIVER_OUTRO_90_TEXT	あの男を信用するのか？
$LINE_RIVER_OUTRO_100_CHAR	$MCG
$LINE_RIVER_OUTRO_100_TEXT	そうね、確かに彼はものすごく狂っているけど、誠実だと思うな。<N>今は友達を選り好みする余裕はないし。
$LINE_RIVER_OUTRO_110_CHAR	$RAN
$LINE_RIVER_OUTRO_110_TEXT	あのピエロのことじゃない。不思議な老人のことを言ってるの。
$LINE_RIVER_OUTRO_120_CHAR	$MCG
$LINE_RIVER_OUTRO_120_TEXT	もし彼がアッシュ寺の僧侶なら、心配することはないわ。
$LINE_RIVER_OUTRO_130_CHAR	$RAN
$LINE_RIVER_OUTRO_130_TEXT	あなたの国の教会が過去に不正をしたことがないと思う？
$LINE_RIVER_OUTRO_140_CHAR	$MCG
$LINE_RIVER_OUTRO_140_TEXT	彼のことが信じられないなら、来なくてもいいよ。
$LINE_RIVER_OUTRO_150_CHAR	$RAN
$LINE_RIVER_OUTRO_150_TEXT	君と逃げるチャンスを不意にするとでも？<N>ここから出られるんだったら、アッシュ王国全体を相手にしてもかまわない。
$LINE_RIVER_OUTRO_160_CHAR	$RAN
$LINE_RIVER_OUTRO_160_TEXT	でも用心だけは怠らないで。
$SCENE_RANGER_TOWN_INTRO_TITLE	出発
$LINE_RANGER_TOWN_INTRO_00_CHAR	$RAN
$LINE_RANGER_TOWN_INTRO_00_TEXT	*なあ、$MCG。修道院に行くんだったら、もっと仲間が必要だと思うんだ。
$LINE_RANGER_TOWN_INTRO_10_CHAR	$MCG
$LINE_RANGER_TOWN_INTRO_10_TEXT	*まあ、でも、$BERもいるし。
$LINE_RANGER_TOWN_INTRO_20_CHAR	$RAN
$LINE_RANGER_TOWN_INTRO_20_TEXT	そうじゃなくて・・・もっとまともな人だって。
$LINE_RANGER_TOWN_INTRO_30_CHAR	$RAN
$LINE_RANGER_TOWN_INTRO_30_TEXT	戦いに安定感があって・・・。
$LINE_RANGER_TOWN_INTRO_40_CHAR	$RAN
$LINE_RANGER_TOWN_INTRO_40_TEXT	ちゃんと鎧を着てるような。
$LINE_RANGER_TOWN_INTRO_50_CHAR	$BER
$LINE_RANGER_TOWN_INTRO_50_TEXT	おいおい、この見事な肉体を隠せっていうのか？
$LINE_RANGER_TOWN_INTRO_60_CHAR	$RAN
$LINE_RANGER_TOWN_INTRO_60_TEXT	そう・・・増援兵を雇おう。
$LINE_RANGER_TOWN_INTRO_70_CHAR	$BER
$LINE_RANGER_TOWN_INTRO_70_TEXT	えっ？俺がいれば、充分だって！<N>磨き抜かれた鋼の肉体を持つこの俺が！
$LINE_RANGER_TOWN_INTRO_80_CHAR	$RAN
$LINE_RANGER_TOWN_INTRO_80_TEXT	・・・そうね、あと酔っ払いの脳みそも持ってるもんね。
$LINE_RANGER_TOWN_INTRO_90_CHAR	$BER
$LINE_RANGER_TOWN_INTRO_90_TEXT	・・・酔っ払いの神様の脳みそだぞ！
$SCENE_RANGER_TOWN_FIGHT_INTRO_TITLE	包囲
$LINE_RANGER_TOWN_FIGHT_INTRO_00_CHAR	$MCG
$LINE_RANGER_TOWN_FIGHT_INTRO_00_TEXT	敵襲よ！町が襲われる！
$LINE_RANGER_TOWN_FIGHT_INTRO_10_CHAR	オジマル
$LINE_RANGER_TOWN_FIGHT_INTRO_10_TEXT	衛兵ども、強襲をかけろ！
$LINE_RANGER_TOWN_FIGHT_INTRO_20_CHAR	オジマル
$LINE_RANGER_TOWN_FIGHT_INTRO_20_TEXT	あの娘には大金がかかっている！生け捕りにしろ！
$LINE_RANGER_TOWN_FIGHT_INTRO_30_CHAR	オジマル
$LINE_RANGER_TOWN_FIGHT_INTRO_30_TEXT	ほかは好きにしろ。
$LINE_RANGER_TOWN_FIGHT_INTRO_40_CHAR	オジマル
$LINE_RANGER_TOWN_FIGHT_INTRO_40_TEXT	レブナントを放て！
$SCENE_RANGER_TOWN_FIGHT_OUTRO_TITLE	増援兵
$LINE_RANGER_TOWN_FIGHT_OUTRO_00_CHAR	オジマル
$LINE_RANGER_TOWN_FIGHT_OUTRO_00_TEXT	なんだと！町人を皆殺しにしても、たった一人の捕虜も捕まえられないのか？
$LINE_RANGER_TOWN_FIGHT_OUTRO_10_CHAR	衛兵
$LINE_RANGER_TOWN_FIGHT_OUTRO_10_TEXT	戦いを続けるレブナントが足りません！
$LINE_RANGER_TOWN_FIGHT_OUTRO_20_CHAR	オジマル
$LINE_RANGER_TOWN_FIGHT_OUTRO_20_TEXT	状況などわかっておる！失せろ！
$LINE_RANGER_TOWN_FIGHT_OUTRO_30_CHAR	オジマル
$LINE_RANGER_TOWN_FIGHT_OUTRO_30_TEXT	役立たずの間抜けどもめ。
$LINE_RANGER_TOWN_FIGHT_OUTRO_40_CHAR	赤服の男
$LINE_RANGER_TOWN_FIGHT_OUTRO_40_TEXT	決して、取り逃してはならんぞ。
$LINE_RANGER_TOWN_FIGHT_OUTRO_50_CHAR	オジマル
$LINE_RANGER_TOWN_FIGHT_OUTRO_50_TEXT	では、どうすればいい！<N>私のレブナントは大打撃を受けたのだぞ。
$LINE_RANGER_TOWN_FIGHT_OUTRO_60_CHAR	オジマル
$LINE_RANGER_TOWN_FIGHT_OUTRO_60_TEXT	戦おうにも、兵が足りん。
$LINE_RANGER_TOWN_FIGHT_OUTRO_70_CHAR	赤服の男
$LINE_RANGER_TOWN_FIGHT_OUTRO_70_TEXT	周りを見渡せ。何が見える？
$LINE_RANGER_TOWN_FIGHT_OUTRO_80_CHAR	オジマル
$LINE_RANGER_TOWN_FIGHT_OUTRO_80_TEXT	大量の死骸だ。一匹たりとも、私たちの獲物ではないがな！
$LINE_RANGER_TOWN_FIGHT_OUTRO_90_CHAR	赤服の男
$LINE_RANGER_TOWN_FIGHT_OUTRO_90_TEXT	追跡を続けるんだ。
$LINE_RANGER_TOWN_FIGHT_OUTRO_100_CHAR	赤服の男
$LINE_RANGER_TOWN_FIGHT_OUTRO_100_TEXT	必要な増援兵は揃っている。
$SCENE_2_2_INTRO_TITLE	かつての友と新たな敵
$LINE_2_2_INTRO_00_CHAR	$RAN
$LINE_2_2_INTRO_00_TEXT	待って、道に人がいる。
$LINE_2_2_INTRO_10_CHAR	$RAN
$LINE_2_2_INTRO_10_TEXT	レンジャーかな？
$LINE_2_2_INTRO_20_CHAR	$RAN
$LINE_2_2_INTRO_20_TEXT	ほかにも村から逃げ延びた人がいるかも！
$LINE_2_2_INTRO_30_CHAR	$RAN
$LINE_2_2_INTRO_30_TEXT	待って・・・何かが、おかしい！
$LINE_2_2_INTRO_40_CHAR	レブナント
$LINE_2_2_INTRO_40_TEXT	フシュゥゥ・・・。
$LINE_2_2_INTRO_50_CHAR	$RAN
$LINE_2_2_INTRO_50_TEXT	敵襲だ！
$SCENE_2_2_OUTRO_TITLE	たった１日で
$LINE_2_2_OUTRO_00_CHAR	$MCG
$LINE_2_2_OUTRO_00_TEXT	さっきのレブナントたち・・・
$LINE_2_2_OUTRO_10_CHAR	$RAN
$LINE_2_2_OUTRO_10_TEXT	あの村の住人だった。
$LINE_2_2_OUTRO_20_CHAR	$MCG
$LINE_2_2_OUTRO_20_TEXT	つまりみんな・・・化け物に変わったってこと？
$LINE_2_2_OUTRO_30_CHAR	$RAN
$LINE_2_2_OUTRO_30_TEXT	あそこの人たちは皆、死病に免疫があったはず。<N>生き残った人は、一度は死病にかかっていたから。
$LINE_2_2_OUTRO_40_CHAR	$MCG
$LINE_2_2_OUTRO_40_TEXT	彼らがひとりでに変身したとは思えないね。
$LINE_2_2_OUTRO_50_CHAR	$RAN
$LINE_2_2_OUTRO_50_TEXT	あの赤服の男・・・。
$SCENE_CARAVAN_TOWN_INTRO_TITLE	大きいやつはブリンキー
$LINE_CARAVAN_TOWN_INTRO_00_CHAR	$MCG
$LINE_CARAVAN_TOWN_INTRO_00_TEXT	敵を撒いたようだね！
$LINE_CARAVAN_TOWN_INTRO_10_CHAR	$BER
$LINE_CARAVAN_TOWN_INTRO_10_TEXT	へっへー、レブナントのドクロをあと３つ集めりゃ、<N>ネックレスが完成するぞ！
$LINE_CARAVAN_TOWN_INTRO_20_CHAR	$BER
$LINE_CARAVAN_TOWN_INTRO_20_TEXT	ほら、見てくれよ！
$LINE_CARAVAN_TOWN_INTRO_30_CHAR	$BER
$LINE_CARAVAN_TOWN_INTRO_30_TEXT	こっちの大きいやつはブリンキー。<N>こっちの小さいのはミスター出っ歯って呼んでいるんだ。
$LINE_CARAVAN_TOWN_INTRO_40_CHAR	$MCG
$LINE_CARAVAN_TOWN_INTRO_40_TEXT	*それ、そうとう不気味よ、$BER・・・
$LINE_CARAVAN_TOWN_INTRO_50_CHAR	$RAN
$LINE_CARAVAN_TOWN_INTRO_50_TEXT	*$MCG、ここに留まっている遊牧民のキャラバンが<N>食糧を提供してくれることになったよ。もちろん、それなりの値段で。
$LINE_CARAVAN_TOWN_INTRO_60_CHAR	$RAN
$LINE_CARAVAN_TOWN_INTRO_60_TEXT	キャラバンの隊長が、祖父の5番目の妻のまたいとこだったんだ。<N>おかげで、押し問答の末かなり値引きしてもらえた。
$LINE_CARAVAN_TOWN_INTRO_70_CHAR	$RAN
$LINE_CARAVAN_TOWN_INTRO_70_TEXT	できるうちに買いだめしておいた方がいいだろうね。
$SCENE_CARAVAN_TOWN_OUTRO_TITLE	友からの贈り物
$LINE_CARAVAN_TOWN_OUTRO_00_CHAR	遊牧民
$LINE_CARAVAN_TOWN_OUTRO_00_TEXT	*もし、見知らぬ人！もしやすると、$MCGさんではありませんか？
$LINE_CARAVAN_TOWN_OUTRO_10_CHAR	$MCG
$LINE_CARAVAN_TOWN_OUTRO_10_TEXT	そうですけど？
$LINE_CARAVAN_TOWN_OUTRO_20_CHAR	遊牧民
$LINE_CARAVAN_TOWN_OUTRO_20_TEXT	スゴ素晴らしい！
$LINE_CARAVAN_TOWN_OUTRO_30_CHAR	遊牧民
$LINE_CARAVAN_TOWN_OUTRO_30_TEXT	数日前、ある老人がここに立ち寄りました。
$LINE_CARAVAN_TOWN_OUTRO_40_CHAR	遊牧民
$LINE_CARAVAN_TOWN_OUTRO_40_TEXT	彼曰く、あなたが私を追ってやって来るので、<N>そのときはこのヘンテコなブツを渡すように、と。
$LINE_CARAVAN_TOWN_OUTRO_50_CHAR	遊牧民
$LINE_CARAVAN_TOWN_OUTRO_50_TEXT	道中で役立つだろう、と言っていましたよ。
$LINE_CARAVAN_TOWN_OUTRO_60_CHAR	遊牧民
$LINE_CARAVAN_TOWN_OUTRO_60_TEXT	私に言わせてみれば、ちょっとばかし変ちくりんなヤツでしたがね。
$LINE_CARAVAN_TOWN_OUTRO_70_CHAR	遊牧民
$LINE_CARAVAN_TOWN_OUTRO_70_TEXT	でも、私の辞書によれば、紙をただで配る人は皆いい人。
$LINE_CARAVAN_TOWN_OUTRO_80_CHAR	遊牧民
$LINE_CARAVAN_TOWN_OUTRO_80_TEXT	あればっかりは、いくらあってもまだ足りない。
$LINE_CARAVAN_TOWN_OUTRO_90_CHAR	遊牧民
$LINE_CARAVAN_TOWN_OUTRO_90_TEXT	なんせ、ウマい！
$LINE_CARAVAN_TOWN_OUTRO_100_CHAR	$MCG
$LINE_CARAVAN_TOWN_OUTRO_100_TEXT	ありがとう、親切な人ね。
$SCENE_MONASTERY_GATES_INTRO_TITLE	修道院の門
$LINE_MONASTERY_GATES_INTRO_00_CHAR	$BER
$LINE_MONASTERY_GATES_INTRO_00_TEXT	さあ、着いたぜ。ここがセリーニ7番目の分家の修道院さ！
$LINE_MONASTERY_GATES_INTRO_10_CHAR	$MCG
$LINE_MONASTERY_GATES_INTRO_10_TEXT	これが、私たちが探していた修道院？
$LINE_MONASTERY_GATES_INTRO_20_CHAR	$BER
$LINE_MONASTERY_GATES_INTRO_20_TEXT	もっと違う物を想像してたのかい？
$LINE_MONASTERY_GATES_INTRO_30_CHAR	$MCG
$LINE_MONASTERY_GATES_INTRO_30_TEXT	アッシュ時代の王族の寺院みたいなのものかと。
$LINE_MONASTERY_GATES_INTRO_40_CHAR	$BER
$LINE_MONASTERY_GATES_INTRO_40_TEXT	聖歌が足りんのなら、俺が歌うぜ。
$LINE_MONASTERY_GATES_INTRO_50_CHAR	$BER
$LINE_MONASTERY_GATES_INTRO_50_TEXT	おおおおおああああああああああっっっ
$LINE_MONASTERY_GATES_INTRO_60_CHAR	$MCG
$LINE_MONASTERY_GATES_INTRO_60_TEXT	寺って言うか、砦みたいね。
$LINE_MONASTERY_GATES_INTRO_70_CHAR	赤服の男
$LINE_MONASTERY_GATES_INTRO_70_TEXT	実際、奈落の谷には多くの危険が潜んでいる。
$LINE_MONASTERY_GATES_INTRO_80_CHAR	$MCG
$LINE_MONASTERY_GATES_INTRO_80_TEXT	あっ！
$LINE_MONASTERY_GATES_INTRO_90_CHAR	赤服の男
$LINE_MONASTERY_GATES_INTRO_90_TEXT	壁の向こうのあの老いぼれが救ってくれるとでも思ってるのか？
$LINE_MONASTERY_GATES_INTRO_100_CHAR	赤服の男
$LINE_MONASTERY_GATES_INTRO_100_TEXT	道は塞いだ。たどり着けなければ、クウェイド帝国のはるか彼方にあるのも同然だ。救ってはくれんぞ。
$LINE_MONASTERY_GATES_INTRO_110_CHAR	赤服の男
$LINE_MONASTERY_GATES_INTRO_110_TEXT	レブナントよ、あいつらを倒せ！
$SCENE_MONASTERY_GATES_OUTRO_TITLE	味方の壁に守られて
$LINE_MONASTERY_GATES_OUTRO_00_CHAR	不思議な老人
$LINE_MONASTERY_GATES_OUTRO_00_TEXT	門は開いています！急いで！彼らが体勢を立て直す前に！
$LINE_MONASTERY_GATES_OUTRO_10_CHAR	$MCG
$LINE_MONASTERY_GATES_OUTRO_10_TEXT	みんな、修道院に入って！
$LINE_MONASTERY_GATES_OUTRO_20_CHAR	$MCG
$LINE_MONASTERY_GATES_OUTRO_20_TEXT	また命を助けていただきましたね、ご老師。
$LINE_MONASTERY_GATES_OUTRO_30_CHAR	不思議な老人
$LINE_MONASTERY_GATES_OUTRO_30_TEXT	あなたのためではありません。<N>自分がそうしたいからそうしているだけです。
$LINE_MONASTERY_GATES_OUTRO_40_CHAR	不思議な老人
$LINE_MONASTERY_GATES_OUTRO_40_TEXT	あなたは、自身がどれほど重要な存在なのか、<N>お気づきではないようだ。
$LINE_MONASTERY_GATES_OUTRO_50_CHAR	不思議な老人
$LINE_MONASTERY_GATES_OUTRO_50_TEXT	彼らの世界へと旅立てる者よ・・・。
$LINE_MONASTERY_GATES_OUTRO_60_CHAR	$MCG
$LINE_MONASTERY_GATES_OUTRO_60_TEXT	お願いします。<N>この一週間の出来事を、一つでも説明していただければ。
$LINE_MONASTERY_GATES_OUTRO_70_CHAR	不思議な老人
$LINE_MONASTERY_GATES_OUTRO_70_TEXT	言うべきことはたくさんある。<N>が、与えられた時間はあまりに少ない。
$LINE_MONASTERY_GATES_OUTRO_80_CHAR	不思議な老人
$LINE_MONASTERY_GATES_OUTRO_80_TEXT	敵の軍が、門の前で待ち構えています。
$LINE_MONASTERY_GATES_OUTRO_90_CHAR	$MCG
$LINE_MONASTERY_GATES_OUTRO_90_TEXT	少なくとも、これだけは教えてください。<N>誰のおかげで、私は生き延びられたのですか？
$SCENE_MONASTERY_SIEGE_INTRO_TITLE	包囲
$LINE_MONASTERY_SIEGE_INTRO_00_CHAR	オジマル
$LINE_MONASTERY_SIEGE_INTRO_00_TEXT	もうたくさんだ！
$LINE_MONASTERY_SIEGE_INTRO_10_CHAR	オジマル
$LINE_MONASTERY_SIEGE_INTRO_10_TEXT	私のレブナント軍は壊滅した。
$LINE_MONASTERY_SIEGE_INTRO_20_CHAR	オジマル
$LINE_MONASTERY_SIEGE_INTRO_20_TEXT	人間を修道院の壁に突撃させろとでもいうのか。
$LINE_MONASTERY_SIEGE_INTRO_30_CHAR	赤服の男
$LINE_MONASTERY_SIEGE_INTRO_30_TEXT	いや、あなたはまさにその通りのことをするだろう。
$LINE_MONASTERY_SIEGE_INTRO_40_CHAR	オジマル
$LINE_MONASTERY_SIEGE_INTRO_40_TEXT	盟友よ、貴様とはもう絶縁だ。クソッ！<N>お前との取引のせいで、どれほどのものを失ったか。
$LINE_MONASTERY_SIEGE_INTRO_50_CHAR	赤服の男
$LINE_MONASTERY_SIEGE_INTRO_50_TEXT	あともう少し失ってもらわなければ。
$LINE_MONASTERY_SIEGE_INTRO_60_CHAR	オジマル
$LINE_MONASTERY_SIEGE_INTRO_60_TEXT	アアアアアァァァーーッ！
$LINE_MONASTERY_SIEGE_INTRO_70_CHAR	オジマル
$LINE_MONASTERY_SIEGE_INTRO_70_TEXT	ご・・・ご主人さま・・・ぬゎ、何をお望みですかぁぁ・・・？
$LINE_MONASTERY_SIEGE_INTRO_80_CHAR	赤服の男
$LINE_MONASTERY_SIEGE_INTRO_80_TEXT	私の子どもたちよ、お前たちに任務を与える・・・。
$SCENE_MONASTERY_SIEGE_OUTRO_TITLE	前触れ
$LINE_MONASTERY_SIEGE_OUTRO_00_CHAR	$HEA
$LINE_MONASTERY_SIEGE_OUTRO_00_TEXT	敵の軍勢を一人残らず倒しました。
$LINE_MONASTERY_SIEGE_OUTRO_10_CHAR	$HEA
$LINE_MONASTERY_SIEGE_OUTRO_10_TEXT	つかの間の自由ですよ。
$LINE_MONASTERY_SIEGE_OUTRO_20_CHAR	声
$LINE_MONASTERY_SIEGE_OUTRO_20_TEXT	これで終わりだとでも？
$LINE_MONASTERY_SIEGE_OUTRO_30_CHAR	$MCG
$LINE_MONASTERY_SIEGE_OUTRO_30_TEXT	今のは何？
$LINE_MONASTERY_SIEGE_OUTRO_40_CHAR	$HEA
$LINE_MONASTERY_SIEGE_OUTRO_40_TEXT	あの男です。レブナントを通して話しています。
$LINE_MONASTERY_SIEGE_OUTRO_50_CHAR	赤服の男
$LINE_MONASTERY_SIEGE_OUTRO_50_TEXT	もう、私を止められんぞ。
$LINE_MONASTERY_SIEGE_OUTRO_60_CHAR	赤服の男
$LINE_MONASTERY_SIEGE_OUTRO_60_TEXT	娘を渡せ。そうすれば、この寺院には手出しはせん。
$LINE_MONASTERY_SIEGE_OUTRO_70_CHAR	$HEA
$LINE_MONASTERY_SIEGE_OUTRO_70_TEXT	ゼレミア。かつてのお前はそんな人間では―
$LINE_MONASTERY_SIEGE_OUTRO_80_CHAR	ゼレミア
$LINE_MONASTERY_SIEGE_OUTRO_80_TEXT	人間だと？
$LINE_MONASTERY_SIEGE_OUTRO_90_CHAR	ゼレミア
$LINE_MONASTERY_SIEGE_OUTRO_90_TEXT	人間らしさを私に説教する気か？<N>偉そうな修道僧のローブをまとい、修道院の壁の陰から<N>世界の終焉をただ眺めているだけのくせに！
$LINE_MONASTERY_SIEGE_OUTRO_100_CHAR	ゼレミア
$LINE_MONASTERY_SIEGE_OUTRO_100_TEXT	この血の海の中、手を汚さずにいるつもりか？
$LINE_MONASTERY_SIEGE_OUTRO_110_CHAR	ゼレミア
$LINE_MONASTERY_SIEGE_OUTRO_110_TEXT	お前のような甘ったれた倫理感はただのぜいたくだ。<N>私は世界救済のためなら、何だってする。
$LINE_MONASTERY_SIEGE_OUTRO_120_CHAR	ゼレミア
$LINE_MONASTERY_SIEGE_OUTRO_120_TEXT	たとえ、何を犠牲にしても。
$LINE_MONASTERY_SIEGE_OUTRO_130_CHAR	$HEA
$LINE_MONASTERY_SIEGE_OUTRO_130_TEXT	これが救済？この数百万人の死が？<N>血の海をつくったのは、お前だぞ！
$LINE_MONASTERY_SIEGE_OUTRO_140_CHAR	ゼレミア
$LINE_MONASTERY_SIEGE_OUTRO_140_TEXT	一部の死が全体を救うこともある。<N>私の記憶では、お前自身もそうしたはずだ・・・。
$LINE_MONASTERY_SIEGE_OUTRO_150_CHAR	ゼレミア
$LINE_MONASTERY_SIEGE_OUTRO_150_TEXT	・・・そう、何度も。
$LINE_MONASTERY_SIEGE_OUTRO_160_CHAR	$HEA
$LINE_MONASTERY_SIEGE_OUTRO_160_TEXT	ゼレミ――
$LINE_MONASTERY_SIEGE_OUTRO_170_CHAR	ゼレミア
$LINE_MONASTERY_SIEGE_OUTRO_170_TEXT	*もう十分だ。今、私が話したいのは$MCGだ。
$LINE_MONASTERY_SIEGE_OUTRO_180_CHAR	$MCG
$LINE_MONASTERY_SIEGE_OUTRO_180_TEXT	何が望みなの。
$LINE_MONASTERY_SIEGE_OUTRO_190_CHAR	ゼレミア
$LINE_MONASTERY_SIEGE_OUTRO_190_TEXT	今、お前が降伏すれば、数え切れないほど多くの命が救える。
$LINE_MONASTERY_SIEGE_OUTRO_200_CHAR	ゼレミア
$LINE_MONASTERY_SIEGE_OUTRO_200_TEXT	お前の存在は、あまりにも危険だ。
$LINE_MONASTERY_SIEGE_OUTRO_210_CHAR	ゼレミア
$LINE_MONASTERY_SIEGE_OUTRO_210_TEXT	一緒に来るのだ。そうすれば数千、いや、数百万の命を救える。
$LINE_MONASTERY_SIEGE_OUTRO_220_CHAR	$HEA
$LINE_MONASTERY_SIEGE_OUTRO_220_TEXT	我々を頼り、この壁の内側に立ち入った者を見捨てるわけにはいかん。
$LINE_MONASTERY_SIEGE_OUTRO_230_CHAR	ゼレミア
$LINE_MONASTERY_SIEGE_OUTRO_230_TEXT	いいだろう。
$LINE_MONASTERY_SIEGE_OUTRO_240_CHAR	ゼレミア
$LINE_MONASTERY_SIEGE_OUTRO_240_TEXT	さらばだ、友よ。また来るぞ。
$SCENE_MONASTERY_TOWN_OUTRO_TITLE	追われる者と狩られる者
$NARR_MONASTERY_TOWN_OUTRO_00_TEXT	ACT III
$NARR_MONASTERY_TOWN_OUTRO_00_SUB_TEXT	歯車、てこを恨まず。おもり、鎖を恨まず。<N>すべての部品は和して働く。創造主の意に適うため。
$NARR_MONASTERY_TOWN_OUTRO_00_SUB_SUB_TEXT	*$N$N$N$N$N$N-セリナッドから7つの王国への2回目の手紙
$LINE_MONASTERY_TOWN_OUTRO_00_CHAR	$MCG
$LINE_MONASTERY_TOWN_OUTRO_00_TEXT	死体にこんなことができるだなんて、<N>今でも信じられない・・・。
$LINE_MONASTERY_TOWN_OUTRO_10_CHAR	$HEA
$LINE_MONASTERY_TOWN_OUTRO_10_TEXT	肉体とは、魂が棲むための器にすぎないのです。
$LINE_MONASTERY_TOWN_OUTRO_20_CHAR	$HEA
$LINE_MONASTERY_TOWN_OUTRO_20_TEXT	あなたが旅する「魂の世界」では、物体としての殻ではなく、<N>敵の本質に直接触れて打つことができます。
$LINE_MONASTERY_TOWN_OUTRO_30_CHAR	$MCG
$LINE_MONASTERY_TOWN_OUTRO_30_TEXT	でも、彼らをつき動かしているは、何の魂なのでしょうか。
$LINE_MONASTERY_TOWN_OUTRO_40_CHAR	$MCG
$LINE_MONASTERY_TOWN_OUTRO_40_TEXT	ゼレミアですか？
$LINE_MONASTERY_TOWN_OUTRO_50_CHAR	$HEA
$LINE_MONASTERY_TOWN_OUTRO_50_TEXT	・・・はい。未知の力を使い、死体に意思を吹き込むのです・・・。
$LINE_MONASTERY_TOWN_OUTRO_60_CHAR	$HEA
$LINE_MONASTERY_TOWN_OUTRO_60_TEXT	彼の邪悪な目標を達成するために。
$LINE_MONASTERY_TOWN_OUTRO_70_CHAR	$HEA
$LINE_MONASTERY_TOWN_OUTRO_70_TEXT	*話すべきことが、たくさんあります。$MCG。
$LINE_MONASTERY_TOWN_OUTRO_80_CHAR	$HEA
$LINE_MONASTERY_TOWN_OUTRO_80_TEXT	・・・しかし、今は一刻を争う時。<N>この壁の向こうへ無事に出られたら、続きを話しましょう。
$SCENE_3_1_INTRO_TITLE	遥か彼方に見える煙
$LINE_3_1_INTRO_00_CHAR	$MCG
$LINE_3_1_INTRO_00_TEXT	修道院の方たちがしてくれたことに、とても感謝しています。<N>こんなところで、感染者を助けてくれる人がいるとは思いませんでした。
$LINE_3_1_INTRO_10_CHAR	$HEA
$LINE_3_1_INTRO_10_TEXT	混沌の中で秩序を建て直すことは、いつだってセリーニの強い願いです。<N>そして、今向かっているのは近くにある我々の医院です。
$LINE_3_1_INTRO_20_CHAR	$MCG
$LINE_3_1_INTRO_20_TEXT	そこは、安全ですか？
$LINE_3_1_INTRO_30_CHAR	$HEA
$LINE_3_1_INTRO_30_TEXT	いえ。でも、ある患者さんが心強い味方となってくれるかもしれません。
$LINE_3_1_INTRO_40_CHAR	$HEA
$LINE_3_1_INTRO_40_TEXT	死の淵から戻って来て、新たに奇妙な能力を得た人は、<N>あなたが初めてではないのです。
$LINE_3_1_INTRO_50_CHAR	$MCG
$LINE_3_1_INTRO_50_TEXT	ご老師、遠くに見えるあれは、煙ですか？
$LINE_3_1_INTRO_60_CHAR	$HEA
$LINE_3_1_INTRO_60_TEXT	医院ですよ！様子がおかしい！
$LINE_3_1_INTRO_70_CHAR	$HEA
$LINE_3_1_INTRO_70_TEXT	急ぎましょう！
$SCENE_3_1_OUTRO_TITLE	新たな味方
$LINE_3_1_OUTRO_00_CHAR	$HEA
$LINE_3_1_OUTRO_00_TEXT	あれが、最後の一匹です。
$LINE_3_1_OUTRO_10_CHAR	患者
$LINE_3_1_OUTRO_10_TEXT	いいところでお会いできましたね、尊敬する老師。
$LINE_3_1_OUTRO_20_CHAR	$HEA
$LINE_3_1_OUTRO_20_TEXT	医院はどうですか？
$LINE_3_1_OUTRO_30_CHAR	患者
$LINE_3_1_OUTRO_30_TEXT	この4日間で、4度目の襲撃です。
$LINE_3_1_OUTRO_40_CHAR	$HEA
$LINE_3_1_OUTRO_40_TEXT	患者たちは？
$LINE_3_1_OUTRO_50_CHAR	患者
$LINE_3_1_OUTRO_50_TEXT	まだ、全員生きていますよ。
$LINE_3_1_OUTRO_60_CHAR	患者
$LINE_3_1_OUTRO_60_TEXT	敵は、犬コロみたいに追い返してやりましたよ。
$LINE_3_1_OUTRO_70_CHAR	$HEA
$LINE_3_1_OUTRO_70_TEXT	相変わらず、喧嘩っ早いことだ。
$LINE_3_1_OUTRO_80_CHAR	$HEA
$LINE_3_1_OUTRO_80_TEXT	勝利の立役者をご紹介しましょう。
$LINE_3_1_OUTRO_90_CHAR	$MCG
$LINE_3_1_OUTRO_90_TEXT	*えーと・・・こんにちは。$MCGです。
$LINE_3_1_OUTRO_100_CHAR	患者
$LINE_3_1_OUTRO_100_TEXT	この闘争の新しい味方に出会えて、嬉しいです。
$SCENE_3_2_INTRO_TITLE	火の娘
$LINE_3_2_INTRO_00_CHAR	$MAG
$LINE_3_2_INTRO_00_TEXT	この場所が私に与えてくれたすべてに、感謝しています。
$LINE_3_2_INTRO_10_CHAR	$MAG
$LINE_3_2_INTRO_10_TEXT	私が・・・冷たくなろうとしていた時、命を助けてくれましたね。
$LINE_3_2_INTRO_20_CHAR	$MAG
$LINE_3_2_INTRO_20_TEXT	でも、今は医院の壁に閉じ込められています。
$LINE_3_2_INTRO_30_CHAR	$MAG
$LINE_3_2_INTRO_30_TEXT	四方が氷に囲まれていようとも、私の中では天なる火が燃え盛っています。
$LINE_3_2_INTRO_40_CHAR	$MAG
$LINE_3_2_INTRO_40_TEXT	敵と戦いたいのです。
$LINE_3_2_INTRO_50_CHAR	$HEA
$LINE_3_2_INTRO_50_TEXT	*そのために、ここまで来たのですよ、$MAG。
$LINE_3_2_INTRO_60_CHAR	$HEA
$LINE_3_2_INTRO_60_TEXT	私たちは・・・いや、私は・・・あなたの助けが必要なのです。
$LINE_3_2_INTRO_70_CHAR	$HEA
$LINE_3_2_INTRO_70_TEXT	明日、私はみんなを率い―
$LINE_3_2_INTRO_80_CHAR	$HEA
$LINE_3_2_INTRO_80_TEXT	今のは？
$LINE_3_2_INTRO_90_CHAR	$MAG
$LINE_3_2_INTRO_90_TEXT	門に、敵が迫っていますっ！
$LINE_3_2_INTRO_100_CHAR	$HEA
$LINE_3_2_INTRO_100_TEXT	護衛たち！敵襲です！
$LINE_3_2_INTRO_110_CHAR	$MAG
$LINE_3_2_INTRO_110_TEXT	神へ捧げた人生であっても、私は火の娘。
$LINE_3_2_INTRO_120_CHAR	$MAG
$LINE_3_2_INTRO_120_TEXT	私に楯突く敵どもは、紅蓮の炎に焼かれて死ぬぞ！
$SCENE_3_2_OUTRO_TITLE	仲間について
$LINE_3_2_OUTRO_00_CHAR	$MCG
$LINE_3_2_OUTRO_00_TEXT	あの。深い意味はないんですが、彼女はクウェイド人ですよね？
$LINE_3_2_OUTRO_10_CHAR	$HEA
$LINE_3_2_OUTRO_10_TEXT	この谷にいる人間は、大半がクウェイド人です。
$LINE_3_2_OUTRO_20_CHAR	$HEA
$LINE_3_2_OUTRO_20_TEXT	この奈落は、死病の流行以前は、<N>戦争捕虜の収容所として使われていました。
$LINE_3_2_OUTRO_30_CHAR	$HEA
$LINE_3_2_OUTRO_30_TEXT	その多くは何年も鉱山の採掘をさせられたあげく、<N>ついに死病の感染者まで送り込まれたわけです。
$LINE_3_2_OUTRO_40_CHAR	$MCG
$LINE_3_2_OUTRO_40_TEXT	だからといって、大勢の民を殺した、炎を崇拝する狂信者だという事実に変わりはありません。クウェイド帝国は―
$LINE_3_2_OUTRO_50_CHAR	$HEA
$LINE_3_2_OUTRO_50_TEXT	*$MCG、クウェイド帝国は滅びました。<N>帝国を滅ぼした者たちは、今、世界の他の地域に目を向けています。
$LINE_3_2_OUTRO_60_CHAR	$HEA
$LINE_3_2_OUTRO_60_TEXT	仲間の人種なんて、下らない議論をしている暇はありません。
$LINE_3_2_OUTRO_70_CHAR	$MCG
$LINE_3_2_OUTRO_70_TEXT	*あ、$MAG！そこにいたの？<N>気付かなかった。
$LINE_3_2_OUTRO_80_CHAR	$MCG
$LINE_3_2_OUTRO_80_TEXT	ちょっと話をしていたんだ。えーと、色々なことを・・・
$LINE_3_2_OUTRO_90_CHAR	$MAG
$LINE_3_2_OUTRO_90_TEXT	それは良かった。こういう格言がある。
$LINE_3_2_OUTRO_100_CHAR	$MAG
$LINE_3_2_OUTRO_100_TEXT	寝首をかかれるかもしれない相手のうわさ話をするなと。
$LINE_3_2_OUTRO_110_CHAR	$MCG
$LINE_3_2_OUTRO_110_TEXT	えっ、そ、そんな言葉、あんまり聞いたことがないなあ。<N>えっと・・・誰が言ったんだっけ？
$LINE_3_2_OUTRO_120_CHAR	$MAG
$LINE_3_2_OUTRO_120_TEXT	夜中に殺されてない人が言ったんでしょう、恐らく。
$LINE_3_2_OUTRO_130_CHAR	$MAG
$LINE_3_2_OUTRO_130_TEXT	殺されれば、何も言わなくなりますからね。
$LINE_3_2_OUTRO_140_CHAR	$MAG
$LINE_3_2_OUTRO_140_TEXT	ギュルギュル、ゲホゲホ・・・くらいしか言えないから。
$LINE_3_2_OUTRO_150_CHAR	$MAG
$LINE_3_2_OUTRO_150_TEXT	それで、「それって助言かい？さあ、ウンとかスンとか言えよ。」と言ってやるのです。
$LINE_3_2_OUTRO_160_CHAR	$MCG
$LINE_3_2_OUTRO_160_TEXT	・・・あなたと友達で良かったわ。
$LINE_3_2_OUTRO_170_CHAR	$MAG
$LINE_3_2_OUTRO_170_TEXT	私もですよ！友情は素晴らしいものです。<N>誰かの寝首をかく時にも押さえてって頼めますし。
$LINE_3_2_OUTRO_180_CHAR	$MCG
$LINE_3_2_OUTRO_180_TEXT	・・・それで！
$LINE_3_2_OUTRO_190_CHAR	$MCG
$LINE_3_2_OUTRO_190_TEXT	・・・あなたに聞きたいことがあるの。<N>すごく、大事なこと。
$LINE_3_2_OUTRO_200_CHAR	$MAG
$LINE_3_2_OUTRO_200_TEXT	何でしょう。
$LINE_3_2_OUTRO_210_CHAR	$MCG
$LINE_3_2_OUTRO_210_TEXT	えっと・・・氷の術って、どういうこと？<N>あなたは炎に仕える人かと思ってたから・・・。
$LINE_3_2_OUTRO_220_CHAR	$MAG
$LINE_3_2_OUTRO_220_TEXT	どうして、私が目から火を出さないのかと？
$LINE_3_2_OUTRO_230_CHAR	$MCG
$LINE_3_2_OUTRO_230_TEXT	うん、まあ、そういうこと。
$LINE_3_2_OUTRO_240_CHAR	$MAG
$LINE_3_2_OUTRO_240_TEXT	死にかけた時・・・地獄を見ました。<N>そこは、冷たい漆黒の闇が無限に広がる、光も温もりもない場所。
$LINE_3_2_OUTRO_250_CHAR	$MAG
$LINE_3_2_OUTRO_250_TEXT	すると、金色に輝く男が私の名を囁いたのです。<N>とっさに、私はその声を聞いてはいけないと思いました。
$LINE_3_2_OUTRO_260_CHAR	$MAG
$LINE_3_2_OUTRO_260_TEXT	逃げようとしました。しかし、動けなかったのです。<N>囁きは次第に大きくなり、私の叫びもかき消しました。
$LINE_3_2_OUTRO_270_CHAR	$MAG
$LINE_3_2_OUTRO_270_TEXT	でも、そこで突然、声が消えたのです。<N>気が付くと私は医院にいて、修道僧たちに介抱されていました。
$LINE_3_2_OUTRO_280_CHAR	$MAG
$LINE_3_2_OUTRO_280_TEXT	それで、地獄から逃げられたのですが、<N>その一部を持ち帰ってしまったのです。
$LINE_3_2_OUTRO_290_CHAR	$MAG
$LINE_3_2_OUTRO_290_TEXT	この・・・心の中の氷・・・こんな冷たさ、初めてです。
$LINE_3_2_OUTRO_300_CHAR	$MAG
$LINE_3_2_OUTRO_300_TEXT	心に炎が戻り、昔に戻れればと毎日思っています。<N>・・・だけど、呪いは毎日続く。
$LINE_3_2_OUTRO_310_CHAR	$MAG
$LINE_3_2_OUTRO_310_TEXT	こういう経験は私だけではありません。<N>死病を生き延びた人の多くは、レブナントとなりました。
$LINE_3_2_OUTRO_320_CHAR	$MAG
$LINE_3_2_OUTRO_320_TEXT	炎の神が憐れみを下さる時まで、<N>正義に歯向かう者にこの呪いを使うことにしたのです。
$LINE_3_2_OUTRO_330_CHAR	$MAG
$LINE_3_2_OUTRO_330_TEXT	どんなものでも、工夫ひとつで敵を倒す道具になり得るのですよ。
$SCENE_HOSPITAL_INTRO_TITLE	消したい過去
$LINE_HOSPITAL_INTRO_00_CHAR	$MCG
$LINE_HOSPITAL_INTRO_00_TEXT	ご老師、ここが安全でないならば、どうされるおつもりですか？
$LINE_HOSPITAL_INTRO_10_CHAR	$HEA
$LINE_HOSPITAL_INTRO_10_TEXT	*$MCG、私は今までの人生で、非常に多くの罪を犯しました。
$LINE_HOSPITAL_INTRO_20_CHAR	$HEA
$LINE_HOSPITAL_INTRO_20_TEXT	君を欺くことで、さらに罪を重ねたくはない。
$LINE_HOSPITAL_INTRO_30_CHAR	$HEA
$LINE_HOSPITAL_INTRO_30_TEXT	ここから先あなたを導いていくために、<N>まず私と敵について知ってもらわなければなりません。
$LINE_HOSPITAL_INTRO_40_CHAR	$MCG
$LINE_HOSPITAL_INTRO_40_TEXT	ゼレミア、ですか？
$LINE_HOSPITAL_INTRO_50_CHAR	$HEA
$LINE_HOSPITAL_INTRO_50_TEXT	・・・ええ。我が民族の長でした。かつてはとても立派な方だったが、今では、謎の力のせいで狂ってしまいました。
$LINE_HOSPITAL_INTRO_60_CHAR	$MCG
$LINE_HOSPITAL_INTRO_60_TEXT	ちょっと待って。<N>もしかして、あのゼレミア・アシャンティモン王子ですか！？
$LINE_HOSPITAL_INTRO_70_CHAR	$MCG
$LINE_HOSPITAL_INTRO_70_TEXT	でも、彼は、名誉の戦死を遂げたはずでしょう！
$LINE_HOSPITAL_INTRO_80_CHAR	$HEA
$LINE_HOSPITAL_INTRO_80_TEXT	皆、そう信じています。だが、真実はそうではありません。
$LINE_HOSPITAL_INTRO_90_CHAR	$HEA
$LINE_HOSPITAL_INTRO_90_TEXT	あなたが生まれる前、クウェイド戦争が最も激しかった頃・・・<N>国土の荒廃は、想像を絶するものでした。
$LINE_HOSPITAL_INTRO_100_CHAR	$HEA
$LINE_HOSPITAL_INTRO_100_TEXT	国は焼き尽くされ、領土すべてが踏み荒らされました。
$LINE_HOSPITAL_INTRO_110_CHAR	$HEA
$LINE_HOSPITAL_INTRO_110_TEXT	国は、壊滅寸前だったのです。
$LINE_HOSPITAL_INTRO_120_CHAR	$HEA
$LINE_HOSPITAL_INTRO_120_TEXT	私とゼレミアは、アッシュ軍の将官でした。<N>兄弟のような間柄だったのです。
$LINE_HOSPITAL_INTRO_130_CHAR	$HEA
$LINE_HOSPITAL_INTRO_130_TEXT	私たちの軍は、獅子奮迅の戦いをしました。<N>でも、敗戦は確実でした。
$LINE_HOSPITAL_INTRO_140_CHAR	$HEA
$LINE_HOSPITAL_INTRO_140_TEXT	日々、アッシュ軍が滅亡へと近づくのを目の当たりにしていたのです。
$LINE_HOSPITAL_INTRO_150_CHAR	$HEA
$LINE_HOSPITAL_INTRO_150_TEXT	そして、敵の町の瓦礫の真っ只中、ゼレミア王子は、ある発見をしました。
$LINE_HOSPITAL_INTRO_160_CHAR	$HEA
$LINE_HOSPITAL_INTRO_160_TEXT	それは、古代の力の在り処でした。<N>大昔に失われて、誰にも見つけられなかった力です。
$LINE_HOSPITAL_INTRO_170_CHAR	$HEA
$LINE_HOSPITAL_INTRO_170_TEXT	敵が門前に迫る最中、彼はある策を練りました。
$LINE_HOSPITAL_INTRO_180_CHAR	$HEA
$LINE_HOSPITAL_INTRO_180_TEXT	焦りから生まれた、邪悪な策です。
$LINE_HOSPITAL_INTRO_190_CHAR	$HEA
$LINE_HOSPITAL_INTRO_190_TEXT	私は、全く愚かなことに、彼を手伝いました。
$LINE_HOSPITAL_INTRO_200_CHAR	$HEA
$LINE_HOSPITAL_INTRO_200_TEXT	*$MCG、私はその後、ゼレミアが引き起こした荒廃を癒すことに人生を奉げてきました。
$LINE_HOSPITAL_INTRO_210_CHAR	$HEA
$LINE_HOSPITAL_INTRO_210_TEXT	理由はわかりませんが、彼は、狂気をぶつける対象にあなたを選んだ。
$LINE_HOSPITAL_INTRO_220_CHAR	$HEA
$LINE_HOSPITAL_INTRO_220_TEXT	その理由がわかれば、それで何かができるかもしれない。
$LINE_HOSPITAL_INTRO_230_CHAR	$HEA
$LINE_HOSPITAL_INTRO_230_TEXT	*彼に何ができるか、ご覧になったでしょう。<N>$MCG、私の手伝いをしてくれますか？
$LINE_HOSPITAL_INTRO_240_CHAR	$MCG
$LINE_HOSPITAL_INTRO_240_TEXT	力の限り。
$SCENE_HOSPITAL_OUTRO_TITLE	たとえ砂漠でも
$LINE_HOSPITAL_OUTRO_00_CHAR	$HEA
$LINE_HOSPITAL_OUTRO_00_TEXT	心の準備を。長い旅が私たちを待っています。
$LINE_HOSPITAL_OUTRO_10_CHAR	$MCG
$LINE_HOSPITAL_OUTRO_10_TEXT	一体どこへ？
$LINE_HOSPITAL_OUTRO_20_CHAR	$HEA
$LINE_HOSPITAL_OUTRO_20_TEXT	ゼレミアが邪悪な力の歴史を発見した、あの町です。
$LINE_HOSPITAL_OUTRO_30_CHAR	$HEA
$LINE_HOSPITAL_OUTRO_30_TEXT	その記録を調べれば、彼があなたを探して何をしようとしているのかわかるでしょう・・・。<N>そして、それへの対抗策も。
$LINE_HOSPITAL_OUTRO_40_CHAR	$MCG
$LINE_HOSPITAL_OUTRO_40_TEXT	こんな・・・奈落の谷にその町があるんですか？
$LINE_HOSPITAL_OUTRO_50_CHAR	$HEA
$LINE_HOSPITAL_OUTRO_50_TEXT	ええ。戦争よりも前の時代の遺跡です。
$LINE_HOSPITAL_OUTRO_60_CHAR	$MCG
$LINE_HOSPITAL_OUTRO_60_TEXT	ゼレミアは？以前そこに行ったことがあるのなら、その秘密を知っているのでは？
$LINE_HOSPITAL_OUTRO_70_CHAR	$HEA
$LINE_HOSPITAL_OUTRO_70_TEXT	確かに、彼が私たちの動きに勘付く危険性はあります。
$LINE_HOSPITAL_OUTRO_80_CHAR	$HEA
$LINE_HOSPITAL_OUTRO_80_TEXT	だが、ここに留まることはできません。迅速に行動すれば、<N>彼が軍を立てなおす前に町に忍び込めるでしょう。
$SCENE_3_3_INTRO_TITLE	砂漠の要塞
$LINE_3_3_INTRO_00_CHAR	$HEA
$LINE_3_3_INTRO_00_TEXT	秘密の入り口はここ、砂漠の底です。
$LINE_3_3_INTRO_10_CHAR	$RAN
$LINE_3_3_INTRO_10_TEXT	敵は、すぐそこまできてる！
$LINE_3_3_INTRO_20_CHAR	$HEA
$LINE_3_3_INTRO_20_TEXT	ゼレミアの先発隊ですね。
$LINE_3_3_INTRO_30_CHAR	$HEA
$LINE_3_3_INTRO_30_TEXT	私たちの進行が遅すぎたようですね。
$LINE_3_3_INTRO_40_CHAR	$RAN
$LINE_3_3_INTRO_40_TEXT	急いで、町に入ろう！
$LINE_3_3_INTRO_50_CHAR	$HEA
$LINE_3_3_INTRO_50_TEXT	いけません！<N>今逃げれば、門が敵の手に落ちてしまう！
$LINE_3_3_INTRO_60_CHAR	$HEA
$LINE_3_3_INTRO_60_TEXT	そうなれば全軍が追ってきて、<N>私たちは町中で袋のねずみです。
$LINE_3_3_INTRO_70_CHAR	$HEA
$LINE_3_3_INTRO_70_TEXT	軍をここで倒し、入り口を封じてから進みましょう。
$SCENE_3_3_OUTRO_TITLE	砂漠の宝石
$NARR_3_3_OUTRO_00_TEXT	ACT IV
$NARR_3_3_OUTRO_00_SUB_TEXT	*地球の奥深く、一体どれだけいたのだろう。<N>―週間か、一ヶ月か。日の光なく、怯えていた。<N>蠢く闇に。<N>その中で動くものすべてに。
$NARR_3_3_OUTRO_00_SUB_SUB_TEXT	*$N$N$N$N$N$N$N$N-遊牧民の冒険を語り伝える、クレスト・カーダ物語集から
$LINE_3_3_OUTRO_00_CHAR	$BER
$LINE_3_3_OUTRO_00_TEXT	*ヘイヘイ！この$BER様の怒りを身に刻め！逃げまどうがいい！
$LINE_3_3_OUTRO_10_CHAR	$BER
$LINE_3_3_OUTRO_10_TEXT	*逃げれるうちに逃げろ、この負け犬！<N>この、トンマなガキ！この・・・女の腐ったヤツ！
$LINE_3_3_OUTRO_20_CHAR	$HEA
$LINE_3_3_OUTRO_20_TEXT	・・・。
$LINE_3_3_OUTRO_30_CHAR	$BER
$LINE_3_3_OUTRO_30_TEXT	おっと、最後のは言い過ぎだったかな？<N>新しい侮辱を試してみたんだ。
$LINE_3_3_OUTRO_40_CHAR	$HEA
$LINE_3_3_OUTRO_40_TEXT	もう気はお済みかな？<N>入り口を封鎖しなければ。
$LINE_3_3_OUTRO_50_CHAR	$BER
$LINE_3_3_OUTRO_50_TEXT	うへー・・・念じるだけで爆発を起こせるのかい？
$LINE_3_3_OUTRO_60_CHAR	$BER
$LINE_3_3_OUTRO_60_TEXT	頼むよ！<N>念力で頭をふっ飛ばしたりしないでくれ！
$LINE_3_3_OUTRO_70_CHAR	$BER
$LINE_3_3_OUTRO_70_TEXT	アンタから盗んだ靴は返す！<N>100足、いや1000足にして返す！
$LINE_3_3_OUTRO_80_CHAR	$HEA
$LINE_3_3_OUTRO_80_TEXT	落ち着きなさい。ここのクリスタルは、不安定な性質なのです。<N>クウェイド帝国は、この鉱物を戦争用に採掘するため、この町を作ったのです。
$LINE_3_3_OUTRO_90_CHAR	$HEA
$LINE_3_3_OUTRO_90_TEXT	爆発を起こすため、導火線を取り付けたのですよ。
$LINE_3_3_OUTRO_100_CHAR	$BER
$LINE_3_3_OUTRO_100_TEXT	む、そうなのか？じゃあ、さっきのは忘れてくれよ。
$SCENE_3_4_INTRO_TITLE	悪い予感
$LINE_3_4_INTRO_00_CHAR	$HEA
$LINE_3_4_INTRO_00_TEXT	何年も前、ゼレミアと一緒にこのホールを歩きました。<N>戦いの返り血を浴びたまま。
$LINE_3_4_INTRO_10_CHAR	$MCG
$LINE_3_4_INTRO_10_TEXT	ここが、ゼレミアが力の源を見つけた場所ですか？
$LINE_3_4_INTRO_20_CHAR	$HEA
$LINE_3_4_INTRO_20_TEXT	いや、ここで我々が見つけたのは秘密の歴史でした。<N>古代クウェイド語で書かれており、熟練の学者であったゼレミアでも、解読できませんでした。
$LINE_3_4_INTRO_30_CHAR	$MCG
$LINE_3_4_INTRO_30_TEXT	では、古代の力は他のところに？ここでは一体何をすれば？
$LINE_3_4_INTRO_40_CHAR	$HEA
$LINE_3_4_INTRO_40_TEXT	ゼレミアはあなたを恐れている。<N>おそらく、ここに書かれていたことが原因でしょう。<N>―あの時、私には明かしてくれなかった何かがあるはずです。
$LINE_3_4_INTRO_50_CHAR	$HEA
$LINE_3_4_INTRO_50_TEXT	・・・彼の計画には、そういう隠し事が多かった。
$LINE_3_4_INTRO_60_CHAR	$MCG
$LINE_3_4_INTRO_60_TEXT	あなたには知り得なかったことです。
$LINE_3_4_INTRO_70_CHAR	$HEA
$LINE_3_4_INTRO_70_TEXT	しかし、見ぬくべきでした。
$LINE_3_4_INTRO_80_CHAR	$HEA
$LINE_3_4_INTRO_80_TEXT	しかし、後悔は、何の役にも立たない。<N>生み出してしまったモンスターを正さなければ。
$LINE_3_4_INTRO_90_CHAR	$HEA
$LINE_3_4_INTRO_90_TEXT	だから、その秘密の記録を見つけなければなりません。<N>ゼレミアが恐れているものが何なのか、発見しなければ。
$LINE_3_4_INTRO_100_CHAR	$MCG
$LINE_3_4_INTRO_100_TEXT	今度は読めそうですか？
$LINE_3_4_INTRO_110_CHAR	$HEA
$LINE_3_4_INTRO_110_TEXT	あれから何年も調べてきました。<N>それに、今回は――クウェイド帝国の王女がいますからね。
$LINE_3_4_INTRO_120_CHAR	$MCG
$LINE_3_4_INTRO_120_TEXT	彼女は助けてくれるかしら？<N>あなたの過去を知れば――
$LINE_3_4_INTRO_130_CHAR	$HEA
$LINE_3_4_INTRO_130_TEXT	*$MCG！何かが動いています！
$LINE_3_4_INTRO_140_CHAR	$MCG
$LINE_3_4_INTRO_140_TEXT	でも、入り口はあなたが封じたはず！
$LINE_3_4_INTRO_150_CHAR	$HEA
$LINE_3_4_INTRO_150_TEXT	ええ。他の所から来たようですね！
$LINE_3_4_INTRO_160_CHAR	$MCG
$LINE_3_4_INTRO_160_TEXT	皆、力を貸して！
$SCENE_3_4_OUTRO_TITLE	戦闘兵器の燃料
$LINE_3_4_OUTRO_00_CHAR	$MCG
$LINE_3_4_OUTRO_00_TEXT	あのクリスタルは、一体？
$LINE_3_4_OUTRO_10_CHAR	$HEA
$LINE_3_4_OUTRO_10_TEXT	クエイドの攻城兵器に、欠かせないものでした。
$LINE_3_4_OUTRO_20_CHAR	$HEA
$LINE_3_4_OUTRO_20_TEXT	町の下の坑道は、そこら中にクリスタルが散りばめられています。
$LINE_3_4_OUTRO_30_CHAR	$MCG
$LINE_3_4_OUTRO_30_TEXT	レブナントは、そこから来たのでしょうか？
$LINE_3_4_OUTRO_40_CHAR	$HEA
$LINE_3_4_OUTRO_40_TEXT	いや、彼らはアッシュ軍の兵装をしていました。<N>もはやボロボロですが・・・。
$LINE_3_4_OUTRO_50_CHAR	$HEA
$LINE_3_4_OUTRO_50_TEXT	彼らは、アッシュ王国の騎士だったのです。
$LINE_3_4_OUTRO_60_CHAR	$MCG
$LINE_3_4_OUTRO_60_TEXT	入り口は封鎖したはずなのに！<N>どうやってここまで来たんだろう？
$LINE_3_4_OUTRO_70_CHAR	$HEA
$LINE_3_4_OUTRO_70_TEXT	わからない・・・。
$LINE_3_4_OUTRO_80_CHAR	$HEA
$LINE_3_4_OUTRO_80_TEXT	が、もう引き返すことはできません。
$LINE_3_4_OUTRO_90_CHAR	$HEA
$LINE_3_4_OUTRO_90_TEXT	私たちの目的は、王室記録の間にあります。
$LINE_3_4_OUTRO_100_CHAR	$MCG
$LINE_3_4_OUTRO_100_TEXT	そうか・・・あのクリスタルは・・・
$LINE_3_4_OUTRO_110_CHAR	$MCG
$LINE_3_4_OUTRO_110_TEXT	あの物質は、魂に動かされてるんだ。
$LINE_3_4_OUTRO_120_CHAR	$MCG
$LINE_3_4_OUTRO_120_TEXT	そう、魂・・・適した目の持ち主には、見える・・・呼び出すこともできる・・・
$LINE_3_4_OUTRO_130_CHAR	$MCG
$LINE_3_4_OUTRO_130_TEXT	その術がわかったわ。
$SCENE_3_5_INTRO_TITLE	騎士との出会い
$LINE_3_5_INTRO_00_CHAR	$RAN
$LINE_3_5_INTRO_00_TEXT	・・・私が町をつくるなら、別の場所にしただろうね。
$LINE_3_5_INTRO_10_CHAR	$RAN
$LINE_3_5_INTRO_10_TEXT	たとえば、地下に100万トンの爆発物が埋まってない場所とか。
$LINE_3_5_INTRO_20_CHAR	孤独な騎士
$LINE_3_5_INTRO_20_TEXT	見なさい！また来ますよ！
$LINE_3_5_INTRO_30_CHAR	$RAN
$LINE_3_5_INTRO_30_TEXT	あんた、誰よ？
$SCENE_3_5_OUTRO_TITLE	王室の借り
$LINE_3_5_OUTRO_00_CHAR	$KNI
$LINE_3_5_OUTRO_00_TEXT	すんでのところで助かりました。<N>あなた達が現れるのがあと少し遅かったら・・・
$LINE_3_5_OUTRO_10_CHAR	$KNI
$LINE_3_5_OUTRO_10_TEXT	恩に着ます、お嬢様。
$LINE_3_5_OUTRO_20_CHAR	$KNI
$LINE_3_5_OUTRO_20_TEXT	この乱世では恩や義理は忘れられがちですが、私は家訓にしたがいます。
$LINE_3_5_OUTRO_30_CHAR	$KNI
$LINE_3_5_OUTRO_30_TEXT	命の恩は命で返せ。<N>この借りを返せる時まで、あなたにお仕えしましょう。
$LINE_3_5_OUTRO_40_CHAR	$KNI
$LINE_3_5_OUTRO_40_TEXT	アッシュ王家にとっては、当然のことです。
$LINE_3_5_OUTRO_50_CHAR	$MCG
$LINE_3_5_OUTRO_50_TEXT	王家？あなた、もしかして―
$LINE_3_5_OUTRO_60_CHAR	$KNI
$LINE_3_5_OUTRO_60_TEXT	正確には傍流なのですが。<N>しかし、私に流れる王家の血が名誉を守れと言っています。
$LINE_3_5_OUTRO_70_CHAR	$MCG
$LINE_3_5_OUTRO_70_TEXT	王子様、こちらこそ光栄です。
$LINE_3_5_OUTRO_80_CHAR	$KNI
$LINE_3_5_OUTRO_80_TEXT	お嬢様、私にお辞儀などしないで下さい。私があなたにお仕えするのですから。
$LINE_3_5_OUTRO_90_CHAR	$KNI
$LINE_3_5_OUTRO_90_TEXT	あなたがどこへ行こうとも、何を為そうとも、私の剣が力添えいたします。
$LINE_3_5_OUTRO_100_CHAR	$KNI
$LINE_3_5_OUTRO_100_TEXT	もちろん、常識の範囲内で、ですよ。
$LINE_3_5_OUTRO_110_CHAR	$KNI
$LINE_3_5_OUTRO_110_TEXT	やれ片足立ちになって「ティプシータイガー」を逆に歌え、というのはごめんですからね！しかも裏声で、なんていうのは特に！
$LINE_3_5_OUTRO_120_CHAR	$KNI
$LINE_3_5_OUTRO_120_TEXT	「命の恩を返します」と聞くと、とんでもない恩返しを考える連中がいるんですよ、意外に。
$LINE_3_5_OUTRO_130_CHAR	$MCG
$LINE_3_5_OUTRO_130_TEXT	ティプシータイガーの歌？どんなのかしら…？
$LINE_3_5_OUTRO_140_CHAR	$KNI
$LINE_3_5_OUTRO_140_TEXT	おっと、変な気を起こさないように。
$SCENE_GUARD_TOWN_INTRO_TITLE	見張りの隠れ家
$LINE_GUARD_TOWN_INTRO_00_CHAR	$HEA
$LINE_GUARD_TOWN_INTRO_00_TEXT	砦で、まだ生きている者に出会えるとは思いませんでした。
$LINE_GUARD_TOWN_INTRO_10_CHAR	$KNI
$LINE_GUARD_TOWN_INTRO_10_TEXT	奈落の民は、衛兵が死病に感染しても全く同情してくれませんからね。
$LINE_GUARD_TOWN_INTRO_20_CHAR	$KNI
$LINE_GUARD_TOWN_INTRO_20_TEXT	民衆によるつるし上げもまあ、楽しいもんではありませんな。
$LINE_GUARD_TOWN_INTRO_30_CHAR	$KNI
$LINE_GUARD_TOWN_INTRO_30_TEXT	ともかく、古株の老兵士たちが砦の秘密の入り口を知っていたのです。――報復を受けずに済む場所をね。
$LINE_GUARD_TOWN_INTRO_40_CHAR	$KNI
$LINE_GUARD_TOWN_INTRO_40_TEXT	しかし、ここにいても、死病からは逃れられませんがね。
$LINE_GUARD_TOWN_INTRO_50_CHAR	$HEA
$LINE_GUARD_TOWN_INTRO_50_TEXT	鎧を着たレブナントのことですね。
$LINE_GUARD_TOWN_INTRO_60_CHAR	$KNI
$LINE_GUARD_TOWN_INTRO_60_TEXT	彼らもかつては、この駐屯地の一員でした。<N>この呪われた死病で味方が一人死ぬごとに、敵が一人増えます。
$LINE_GUARD_TOWN_INTRO_70_CHAR	$HEA
$LINE_GUARD_TOWN_INTRO_70_TEXT	ならばここに長居するのは、危険ですね。
$SCENE_GUARD_TOWN_OUTRO_TITLE	警告の言葉
$LINE_GUARD_TOWN_OUTRO_00_CHAR	$KNI
$LINE_GUARD_TOWN_OUTRO_00_TEXT	さらに中心部へと進まれるおつもりですか？
$LINE_GUARD_TOWN_OUTRO_10_CHAR	$HEA
$LINE_GUARD_TOWN_OUTRO_10_TEXT	なんとしても、王家記録の間まで行かなければ。
$LINE_GUARD_TOWN_OUTRO_20_CHAR	$HEA
$LINE_GUARD_TOWN_OUTRO_20_TEXT	そこで得た情報で、この惨状をくつがえせるかもしれません。
$LINE_GUARD_TOWN_OUTRO_30_CHAR	$KNI
$LINE_GUARD_TOWN_OUTRO_30_TEXT	忠告しておきますが、ここにはレブナント以外にも多くの危険が潜んでいます。
$LINE_GUARD_TOWN_OUTRO_40_CHAR	$KNI
$LINE_GUARD_TOWN_OUTRO_40_TEXT	炎を操る生物が、この暗闇で眠っているのです。
$LINE_GUARD_TOWN_OUTRO_50_CHAR	$HEA
$LINE_GUARD_TOWN_OUTRO_50_TEXT	どんな危険にも立ち向かおう。
$LINE_GUARD_TOWN_OUTRO_60_CHAR	$KNI
$LINE_GUARD_TOWN_OUTRO_60_TEXT	ですが、しかし・・・。
$LINE_GUARD_TOWN_OUTRO_70_CHAR	$KNI
$LINE_GUARD_TOWN_OUTRO_70_TEXT	その地に竜、住まう。
$LINE_GUARD_TOWN_OUTRO_80_CHAR	$KNI
$LINE_GUARD_TOWN_OUTRO_80_TEXT	実はこんなセリフ、前から言ってみたかったんです。
$LINE_GUARD_TOWN_OUTRO_90_CHAR	$KNI
$LINE_GUARD_TOWN_OUTRO_90_TEXT	でも、ホントにドラゴンですよ、ドラゴン。
$SCENE_SIDEQUEST_5_GET_TITLE	動く影
$LINE_SIDEQUEST_5_GET_00_CHAR	$BER
$LINE_SIDEQUEST_5_GET_00_TEXT	おーい、悪党さ～ん。そこにいるかい？
$LINE_SIDEQUEST_5_GET_10_CHAR	$BER
$LINE_SIDEQUEST_5_GET_10_TEXT	・・・。
$LINE_SIDEQUEST_5_GET_20_CHAR	$BER
$LINE_SIDEQUEST_5_GET_20_TEXT	いない？ああ、そうかい。じゃ、役目は終わり。何か食いに行くか！
$LINE_SIDEQUEST_5_GET_30_CHAR	$KNI
$LINE_SIDEQUEST_5_GET_30_TEXT	あのな・・・見張りに立つって、そういうことじゃないぞ。
$LINE_SIDEQUEST_5_GET_40_CHAR	$BER
$LINE_SIDEQUEST_5_GET_40_TEXT	あ、そうだな！一番かんじんなことを忘れていた。
$LINE_SIDEQUEST_5_GET_50_CHAR	$BER
$LINE_SIDEQUEST_5_GET_50_TEXT	ええかっこすることさ！
$LINE_SIDEQUEST_5_GET_60_CHAR	$KNI
$LINE_SIDEQUEST_5_GET_60_TEXT	・・・。
$LINE_SIDEQUEST_5_GET_70_CHAR	$KNI
$LINE_SIDEQUEST_5_GET_70_TEXT	ええかっこすると、何か役に立つと？
$LINE_SIDEQUEST_5_GET_80_CHAR	$BER
$LINE_SIDEQUEST_5_GET_80_TEXT	俺たちは恐ろしいんだぞと思わせなきゃいけない。<N>お前のような弱虫野郎が立ってると、敵の攻撃を誘っているようなもんだ。
$LINE_SIDEQUEST_5_GET_90_CHAR	$KNI
$LINE_SIDEQUEST_5_GET_90_TEXT	・・・。
$LINE_SIDEQUEST_5_GET_100_CHAR	$KNI
$LINE_SIDEQUEST_5_GET_100_TEXT	あれは何だ？
$LINE_SIDEQUEST_5_GET_110_CHAR	$BER
$LINE_SIDEQUEST_5_GET_110_TEXT	*これか？俺様の発見した新しい筋肉群だ。その名も$BER筋だ。
$LINE_SIDEQUEST_5_GET_120_CHAR	$KNI
$LINE_SIDEQUEST_5_GET_120_TEXT	違う、バカもん！あそこを見なさい！<N>誰かがついて来ています。
$LINE_SIDEQUEST_5_GET_130_CHAR	$BER
$LINE_SIDEQUEST_5_GET_130_TEXT	俺の発する荒々しい男らしさのオーラに魅せられ、抗うことができなかったんだな。
$LINE_SIDEQUEST_5_GET_140_CHAR	$KNI
$LINE_SIDEQUEST_5_GET_140_TEXT	か、敵のスパイでしょうね。<N>ここにいてください。私が確認してきます。
$LINE_SIDEQUEST_5_GET_150_CHAR	$BER
$LINE_SIDEQUEST_5_GET_150_TEXT	何だと？戦うんなら、俺も混ぜてよ！待って！
$SCENE_SIDEQUEST_5_INTRO_TITLE	闇に消える
$LINE_SIDEQUEST_5_INTRO_00_CHAR	$KNI
$LINE_SIDEQUEST_5_INTRO_00_TEXT	誰だ？名を名乗れ！
$LINE_SIDEQUEST_5_INTRO_10_CHAR	謎の女
$LINE_SIDEQUEST_5_INTRO_10_TEXT	ワープ！
$LINE_SIDEQUEST_5_INTRO_20_CHAR	$KNI
$LINE_SIDEQUEST_5_INTRO_20_TEXT	何？
$LINE_SIDEQUEST_5_INTRO_30_CHAR	謎の女
$LINE_SIDEQUEST_5_INTRO_30_TEXT	どうしてここへ？
$LINE_SIDEQUEST_5_INTRO_40_CHAR	$KNI
$LINE_SIDEQUEST_5_INTRO_40_TEXT	貴様、何やつだ？
$LINE_SIDEQUEST_5_INTRO_50_CHAR	謎の女
$LINE_SIDEQUEST_5_INTRO_50_TEXT	・・・間違えてあなたを連れてきてしまったようだ。<N>ということは、まさか・・・。
$LINE_SIDEQUEST_5_INTRO_60_CHAR	$BER
$LINE_SIDEQUEST_5_INTRO_60_TEXT	よお。
$LINE_SIDEQUEST_5_INTRO_70_CHAR	$KNI
$LINE_SIDEQUEST_5_INTRO_70_TEXT	素晴らしい。他について来たお仲間は？
$LINE_SIDEQUEST_5_INTRO_80_CHAR	$BER
$LINE_SIDEQUEST_5_INTRO_80_TEXT	幾千幾万ものレブナントが外にいるけどな。
$LINE_SIDEQUEST_5_INTRO_90_CHAR	謎の女
$LINE_SIDEQUEST_5_INTRO_90_TEXT	何ですって？
$LINE_SIDEQUEST_5_INTRO_100_CHAR	謎の女
$LINE_SIDEQUEST_5_INTRO_100_TEXT	どうしてこんなことに！？ダメ！早過ぎる！
$LINE_SIDEQUEST_5_INTRO_110_CHAR	謎の女
$LINE_SIDEQUEST_5_INTRO_110_TEXT	逃げなくては！
$LINE_SIDEQUEST_5_INTRO_120_CHAR	$KNI
$LINE_SIDEQUEST_5_INTRO_120_TEXT	どこへ行く気だ？
$LINE_SIDEQUEST_5_INTRO_130_CHAR	謎の女
$LINE_SIDEQUEST_5_INTRO_130_TEXT	あなたたちを連れてもう一度姿を消さなければ。
$LINE_SIDEQUEST_5_INTRO_140_CHAR	謎の女
$LINE_SIDEQUEST_5_INTRO_140_TEXT	それまで、やつらを近づけるな！
$SCENE_SIDEQUEST_5_OUTRO_TITLE	謎について熟考する
$LINE_SIDEQUEST_5_OUTRO_00_CHAR	$KNI
$LINE_SIDEQUEST_5_OUTRO_00_TEXT	よし、全部、退治したぞ。そろそろ、答えてもらおうか。
$LINE_SIDEQUEST_5_OUTRO_10_CHAR	謎の女
$LINE_SIDEQUEST_5_OUTRO_10_TEXT	この線一本でお前は・・・
$LINE_SIDEQUEST_5_OUTRO_20_CHAR	$KNI
$LINE_SIDEQUEST_5_OUTRO_20_TEXT	待て、貴様は誰だ。何をするつもりだ？どうやってここまで―
$LINE_SIDEQUEST_5_OUTRO_30_CHAR	謎の女
$LINE_SIDEQUEST_5_OUTRO_30_TEXT	ワープ！
$LINE_SIDEQUEST_5_OUTRO_40_CHAR	$MCG
$LINE_SIDEQUEST_5_OUTRO_40_TEXT	*あら、こういうおバカなことするのは$BERだけだと思ってたけど、$KNI、あなたが？
$LINE_SIDEQUEST_5_OUTRO_50_CHAR	$RAN
$LINE_SIDEQUEST_5_OUTRO_50_TEXT	まあまあ、これで焦げものじゃない具ができたじゃない。
$LINE_SIDEQUEST_5_OUTRO_60_CHAR	$MCG
$LINE_SIDEQUEST_5_OUTRO_60_TEXT	私の料理への当て付け？みんながあんたのように生焼けが好きじゃないのよ。
$LINE_SIDEQUEST_5_OUTRO_70_CHAR	$RAN
$LINE_SIDEQUEST_5_OUTRO_70_TEXT	*$MCG、君は、いろんなことが得意かもしれないけどね、ぜーんぶ、私の方が上手にできるんだよね。いいかげん認めたら？
$LINE_SIDEQUEST_5_OUTRO_80_CHAR	$MCG
$LINE_SIDEQUEST_5_OUTRO_80_TEXT	おたまで顔を叩かれるのは、私より上手よね！
$LINE_SIDEQUEST_5_OUTRO_90_CHAR	$KNI
$LINE_SIDEQUEST_5_OUTRO_90_TEXT	私がスープの鍋に立っていることは、誰も気になさらないんですか！？
$LINE_SIDEQUEST_5_OUTRO_100_CHAR	$RAN
$LINE_SIDEQUEST_5_OUTRO_100_TEXT	まあ、そう言われると気にならないでもないけど・・・
$LINE_SIDEQUEST_5_OUTRO_110_CHAR	$MCG
$LINE_SIDEQUEST_5_OUTRO_110_TEXT	そうそう、そんなところで何しているの？
$LINE_SIDEQUEST_5_OUTRO_120_CHAR	$RAN
$LINE_SIDEQUEST_5_OUTRO_120_TEXT	味を良くしようとしてた、とか。
$LINE_SIDEQUEST_5_OUTRO_130_CHAR	$MCG
$LINE_SIDEQUEST_5_OUTRO_130_TEXT	私のおたまがどれだけ痛いか知りたいみたいね？
$LINE_SIDEQUEST_5_OUTRO_140_CHAR	$BER
$LINE_SIDEQUEST_5_OUTRO_140_TEXT	女のケンカだ！キャットファイトだ！
$LINE_SIDEQUEST_5_OUTRO_150_CHAR	$MCG
$LINE_SIDEQUEST_5_OUTRO_150_TEXT	アンタ、今までどこにいたの？
$LINE_SIDEQUEST_5_OUTRO_160_CHAR	$BER
$LINE_SIDEQUEST_5_OUTRO_160_TEXT	*ああ、俺と$KNIは、魔女に誘拐されてたんだ。<N>悪だくみして俺たちの後をつけてたみたいだな。でも、問いただす前に逃げちまった。
$LINE_SIDEQUEST_5_OUTRO_170_CHAR	$MCG
$LINE_SIDEQUEST_5_OUTRO_170_TEXT	えっ？何で早く言わないの？
$LINE_SIDEQUEST_5_OUTRO_180_CHAR	$BER
$LINE_SIDEQUEST_5_OUTRO_180_TEXT	*そりゃあ$KNIにとっちゃあ、鍋の中につっ立っていることの方が大事だったんだろうよ。
$LINE_SIDEQUEST_5_OUTRO_190_CHAR	$KNI
$LINE_SIDEQUEST_5_OUTRO_190_TEXT	・・・。
$LINE_SIDEQUEST_5_OUTRO_200_CHAR	$KNI
$LINE_SIDEQUEST_5_OUTRO_200_TEXT	ちょっと、そのおたま貸していただけます？
$LINE_SIDEQUEST_5_OUTRO_210_CHAR	$MCG
$LINE_SIDEQUEST_5_OUTRO_210_TEXT	じゃあ、そいつは、私と同じように、あなたを生と死のはざまに連れ込んだと？
$LINE_SIDEQUEST_5_OUTRO_220_CHAR	$KNI
$LINE_SIDEQUEST_5_OUTRO_220_TEXT	いや、それ以上です。彼女は、ワープもできます。
$LINE_SIDEQUEST_5_OUTRO_230_CHAR	$MCG
$LINE_SIDEQUEST_5_OUTRO_230_TEXT	私なら、ワープができたらこんな奈落の谷なんかおさらばなのに。
$LINE_SIDEQUEST_5_OUTRO_240_CHAR	$KNI
$LINE_SIDEQUEST_5_OUTRO_240_TEXT	何かを探しているんじゃないでしょうか。<N>私たちが変な遺跡に辿り着いた時、彼女は「早過ぎる」と言っていました。
$LINE_SIDEQUEST_5_OUTRO_250_CHAR	$KNI
$LINE_SIDEQUEST_5_OUTRO_250_TEXT	それに、何かを手にしていましたね。
$LINE_SIDEQUEST_5_OUTRO_260_CHAR	$KNI
$LINE_SIDEQUEST_5_OUTRO_260_TEXT	あと、何かの記号を手の平に彫ろうとしていた。
$LINE_SIDEQUEST_5_OUTRO_270_CHAR	$KNI
$LINE_SIDEQUEST_5_OUTRO_270_TEXT	何だったのかわかりませんが、彫り終わるまで待つ気はありませんでした。
$LINE_SIDEQUEST_5_OUTRO_280_CHAR	$MCG
$LINE_SIDEQUEST_5_OUTRO_280_TEXT	何だったの？
$LINE_SIDEQUEST_5_OUTRO_290_CHAR	$KNI
$LINE_SIDEQUEST_5_OUTRO_290_TEXT	昔見た、遊牧民の武器のようなものでした。<N>でも、最近のものに比べるとはるかに高度な細工が施されていましたね。
$LINE_SIDEQUEST_5_OUTRO_300_CHAR	$MCG
$LINE_SIDEQUEST_5_OUTRO_300_TEXT	・・・図書館で、そういう武器のスケッチを見たことがあるな・・・古代のものだった・・・。
$LINE_SIDEQUEST_5_OUTRO_310_CHAR	$MCG
$LINE_SIDEQUEST_5_OUTRO_310_TEXT	何者なのかはわからないけど、恐ろしく博識みたいね。
$LINE_SIDEQUEST_5_OUTRO_320_CHAR	$KNI
$LINE_SIDEQUEST_5_OUTRO_320_TEXT	ともかく、今後気をつけなければなりませんね。
$LINE_SIDEQUEST_5_OUTRO_330_CHAR	$MCG
$LINE_SIDEQUEST_5_OUTRO_330_TEXT	まったくです。
$SCENE_3_6_INTRO_TITLE	イケメン喧嘩屋
$LINE_3_6_INTRO_00_CHAR	$BER
$LINE_3_6_INTRO_00_TEXT	おい、新入り！ここのルールを教えてやるよ。
$LINE_3_6_INTRO_10_CHAR	$BER
$LINE_3_6_INTRO_10_TEXT	ワイルドイケメン喧嘩屋の役は、もう俺に決まってるんだ。
$LINE_3_6_INTRO_20_CHAR	$BER
$LINE_3_6_INTRO_20_TEXT	新入りは女々しく遠くから弾でも撃ってな。
$LINE_3_6_INTRO_30_CHAR	$BER
$LINE_3_6_INTRO_30_TEXT	前線で怪我されちゃ困るからな。<N>マニキュアにヒビが入ったら嫌だろう？
$LINE_3_6_INTRO_40_CHAR	$KNI
$LINE_3_6_INTRO_40_TEXT	*私の名は、$KNIです。あなたの話し方は、いかがなものかと思いますね。
$LINE_3_6_INTRO_50_CHAR	$BER
$LINE_3_6_INTRO_50_TEXT	そうかい、このタフガイさんよー。<N>男らしい鎧に守ってもらうってのは、一体どんな気分なのよ？
$LINE_3_6_INTRO_60_CHAR	$KNI
$LINE_3_6_INTRO_60_TEXT	この兵装は由緒ある―
$LINE_3_6_INTRO_70_CHAR	$BER
$LINE_3_6_INTRO_70_TEXT	・・・由緒ある女の子向けアクセサリーだろ？殴られるのが怖いやつのな！
$LINE_3_6_INTRO_80_CHAR	$KNI
$LINE_3_6_INTRO_80_TEXT	おっしゃる意味がわかりませんな。<N>わざわざ斬られたくて戦う人がいますか？
$LINE_3_6_INTRO_90_CHAR	$KNI
$LINE_3_6_INTRO_90_TEXT	貴様でさえ、戦いにはズボンをはいて行くだろう？
$LINE_3_6_INTRO_100_CHAR	$BER
$LINE_3_6_INTRO_100_TEXT	これからは違うな！
$LINE_3_6_INTRO_110_CHAR	$KNI
$LINE_3_6_INTRO_110_TEXT	何ですか―？
$LINE_3_6_INTRO_120_CHAR	$MCG
$LINE_3_6_INTRO_120_TEXT	またレブナントが来た！
$SCENE_3_6_OUTRO_TITLE	一人じゃない
$LINE_3_6_OUTRO_00_CHAR	$KNI
$LINE_3_6_OUTRO_00_TEXT	今のは、私の部下ではありませんね。
$LINE_3_6_OUTRO_10_CHAR	$KNI
$LINE_3_6_OUTRO_10_TEXT	どこか別の所から侵入して来たのでしょう。
$LINE_3_6_OUTRO_20_CHAR	$HEA
$LINE_3_6_OUTRO_20_TEXT	では、秘密の入り口が見つかったということか。
$LINE_3_6_OUTRO_30_CHAR	$HEA
$LINE_3_6_OUTRO_30_TEXT	ここを去りましょう。
$LINE_3_6_OUTRO_40_CHAR	$HEA
$LINE_3_6_OUTRO_40_TEXT	ゼレミアが私たちを追っている。
$SCENE_3_7_INTRO_TITLE	招かれざる客
$LINE_3_7_INTRO_00_CHAR	$MCG
$LINE_3_7_INTRO_00_TEXT	*$KNIったら、レブナントが倒れるのを見て感動してる。
$LINE_3_7_INTRO_10_CHAR	$HEA
$LINE_3_7_INTRO_10_TEXT	あなたが初めてレブナントを倒した時に、<N>私たちが感動したのと同じようにね。
$LINE_3_7_INTRO_20_CHAR	$MCG
$LINE_3_7_INTRO_20_TEXT	他の人にはできないのに、どうして私にはレブナントが倒せるのかしら？
$LINE_3_7_INTRO_30_CHAR	$HEA
$LINE_3_7_INTRO_30_TEXT	私たちがレブナントと呼んでいるものは、ゼレミアの意思通りに動く操り人形に過ぎないのです。
$LINE_3_7_INTRO_40_CHAR	$HEA
$LINE_3_7_INTRO_40_TEXT	その力については、まだ理解できませんが、彼の精神が死体を動かしているのは確かです。
$LINE_3_7_INTRO_50_CHAR	$HEA
$LINE_3_7_INTRO_50_TEXT	あなたの意思を剣で切ることができないのと同じように、<N>ゼレミアが死体にかけた力を解くことは不可能です。
$LINE_3_7_INTRO_60_CHAR	$MCG
$LINE_3_7_INTRO_60_TEXT	でも、私なら！
$LINE_3_7_INTRO_70_CHAR	$HEA
$LINE_3_7_INTRO_70_TEXT	そう、あなたは死の淵に立ち、片足を魂の世界に踏み込める。<N>この世ではないところです。
$LINE_3_7_INTRO_80_CHAR	$HEA
$LINE_3_7_INTRO_80_TEXT	そこでなら、君の意思は、ゼレミアの意思を断ち切れるでしょう。
$LINE_3_7_INTRO_90_CHAR	$HEA
$LINE_3_7_INTRO_90_TEXT	そうすれば、レブナントたちは、また死の世界に戻れる・・・。
$LINE_3_7_INTRO_100_CHAR	$MCG
$LINE_3_7_INTRO_100_TEXT	なるほど。それなら―
$LINE_3_7_INTRO_110_CHAR	どう猛なドラゴン
$LINE_3_7_INTRO_110_TEXT	何者だ！人間のぶんざいで神の前に出る無礼者どもは。
$LINE_3_7_INTRO_120_CHAR	$HEA
$LINE_3_7_INTRO_120_TEXT	みんな、下がれ！
$LINE_3_7_INTRO_130_CHAR	どう猛なドラゴン
$LINE_3_7_INTRO_130_TEXT	答えよ！焼き殺してくれるぞ！
$LINE_3_7_INTRO_140_CHAR	$HEA
$LINE_3_7_INTRO_140_TEXT	そんな場合じゃない！<N>レブナントが近付いて来ている！
$LINE_3_7_INTRO_150_CHAR	どう猛なドラゴン
$LINE_3_7_INTRO_150_TEXT	あの害虫どもか？あいつらは、神の怒りに触れるだろうよ！
$SCENE_3_7_OUTRO_TITLE	ドラゴンの言葉
$LINE_3_7_OUTRO_00_CHAR	$DRA
$LINE_3_7_OUTRO_00_TEXT	人間にしては、よく戦ったな。
$LINE_3_7_OUTRO_10_CHAR	$DRA
$LINE_3_7_OUTRO_10_TEXT	しかし、ここに踏み入れた無礼が許されたわけではないぞ。
$LINE_3_7_OUTRO_20_CHAR	$DRA
$LINE_3_7_OUTRO_20_TEXT	・・・。
$LINE_3_7_OUTRO_30_CHAR	$DRA
$LINE_3_7_OUTRO_30_TEXT	だが、私のため仕事を引きうけてくれるのなら、その無礼を許してやらんでもない。
$LINE_3_7_OUTRO_40_CHAR	$MCG
$LINE_3_7_OUTRO_40_TEXT	許す、というのは？
$LINE_3_7_OUTRO_50_CHAR	$DRA
$LINE_3_7_OUTRO_50_TEXT	生きたままローストにするのは、控えてやろうということだ。
$LINE_3_7_OUTRO_60_CHAR	$RAN
$LINE_3_7_OUTRO_60_TEXT	なかなかいい取り引きだな。
$LINE_3_7_OUTRO_70_CHAR	$MCG
$LINE_3_7_OUTRO_70_TEXT	でも、もうちょっと見返りがないとね。
$LINE_3_7_OUTRO_80_CHAR	$DRA
$LINE_3_7_OUTRO_80_TEXT	なんだと、本気か？
$LINE_3_7_OUTRO_90_CHAR	$MCG
$LINE_3_7_OUTRO_90_TEXT	王室記録の間に連れてって。そしたら、手伝ってあげる。
$LINE_3_7_OUTRO_100_CHAR	$DRA
$LINE_3_7_OUTRO_100_TEXT	・・・人間が神と取り引きするとは、世も末だな。
$LINE_3_7_OUTRO_110_CHAR	$DRA
$LINE_3_7_OUTRO_110_TEXT	運が良かったな。――私は今、機嫌がいい。<N>契約締結だ。約束は守ろう。
$LINE_3_7_OUTRO_120_CHAR	$DRA
$LINE_3_7_OUTRO_120_TEXT	ついて来い。仕事だ。
$LINE_3_7_OUTRO_130_CHAR	$RAN
$LINE_3_7_OUTRO_130_TEXT	ちょっと！次に怪物を怒らせるときは、先に言ってよ。私は離れてるから。
$LINE_3_7_OUTRO_140_CHAR	$MCG
$LINE_3_7_OUTRO_140_TEXT	あのドラゴンが私たちを殺そうと思ったのなら、もう殺してるよ。<N>きっと、私たちの力が必要なんだ。
$LINE_3_7_OUTRO_150_CHAR	$MCG
$LINE_3_7_OUTRO_150_TEXT	・・・それに、ドラゴンを利用できたら、儲けものでしょ。
$LINE_3_7_OUTRO_160_CHAR	$RAN
$LINE_3_7_OUTRO_160_TEXT	まあね。でも・・・
$LINE_3_7_OUTRO_170_CHAR	$RAN
$LINE_3_7_OUTRO_170_TEXT	あいつがいるときは、君のそばにはいない方が良いな。
$LINE_3_7_OUTRO_180_CHAR	$MAG
$LINE_3_7_OUTRO_180_TEXT	ドラゴンと取引を？
$LINE_3_7_OUTRO_190_CHAR	$MCG
$LINE_3_7_OUTRO_190_TEXT	こういうの好きでしょ？・・・火炎とか、そういうの。
$LINE_3_7_OUTRO_200_CHAR	$MCG
$LINE_3_7_OUTRO_200_TEXT	似た者同士じゃない？
$LINE_3_7_OUTRO_210_CHAR	$MAG
$LINE_3_7_OUTRO_210_TEXT	自分を神だと言っていたのを聞きましたか？
$LINE_3_7_OUTRO_220_CHAR	$MAG
$LINE_3_7_OUTRO_220_TEXT	あれは、天なる火に仕える竜ではありませんよ。
$LINE_3_7_OUTRO_230_CHAR	$MAG
$LINE_3_7_OUTRO_230_TEXT	闇に転じた竜かもしれません。<N>・・・火の秘法を自らの欲望のために使うやつらです。
$LINE_3_7_OUTRO_240_CHAR	$MCG
$LINE_3_7_OUTRO_240_TEXT	でも、どんなに恐ろしくても、使いようで善をなすかもしれないじゃない。
$LINE_3_7_OUTRO_250_CHAR	$MAG
$LINE_3_7_OUTRO_250_TEXT	それはいい心がけです、$MCG。しかし、危険ですよ。<N>過去にも、闇の勢力を手玉に取れると考えた者は多くいます。
$LINE_3_7_OUTRO_260_CHAR	$MAG
$LINE_3_7_OUTRO_260_TEXT	調子に乗って、だまされることがないように。
$LINE_3_7_OUTRO_270_CHAR	$MCG
$LINE_3_7_OUTRO_270_TEXT	*わかってるよ、$MAG。私たちが・・・
$LINE_3_7_OUTRO_280_CHAR	$MCG
$LINE_3_7_OUTRO_280_TEXT	・・・火遊びしてるってことでしょ？
$LINE_3_7_OUTRO_290_CHAR	$MAG
$LINE_3_7_OUTRO_290_TEXT	あなたはまったく・・・
$LINE_3_7_OUTRO_300_CHAR	$MCG
$LINE_3_7_OUTRO_300_TEXT	元気出してよ、面白かったでしょ？
$LINE_3_7_OUTRO_310_CHAR	$MAG
$LINE_3_7_OUTRO_310_TEXT	・・・うう、心の寒さで震える・・・。
$SCENE_3_8_INTRO_TITLE	巣を守れ
$LINE_3_8_INTRO_00_CHAR	$MCG
$LINE_3_8_INTRO_00_TEXT	じゃあ、信頼できるドラゴンもいるの？
$LINE_3_8_INTRO_10_CHAR	$MAG
$LINE_3_8_INTRO_10_TEXT	そもそもドラゴンは火の神に仕えていました。
$LINE_3_8_INTRO_20_CHAR	$MAG
$LINE_3_8_INTRO_20_TEXT	・・・火の神は人間に模範を示すため、<N>ドラゴンをこの世界に送り込みました。
$LINE_3_8_INTRO_30_CHAR	$MAG
$LINE_3_8_INTRO_30_TEXT	しかし、一部のドラゴンは人間の作った金や宝石を見て、激しい羨望にかられました。
$LINE_3_8_INTRO_40_CHAR	$MAG
$LINE_3_8_INTRO_40_TEXT	やがて彼らは、天なる火への忠義を失い、さらなる富と力を求めて能力を悪用するようになりました。
$LINE_3_8_INTRO_50_CHAR	$MAG
$LINE_3_8_INTRO_50_TEXT	略奪をくりかえしては宝の山を築き、堕落した哀れな生き物となったのです。元の目的とはかけ離れた存在になってしまいました。
$LINE_3_8_INTRO_60_CHAR	$MAG
$LINE_3_8_INTRO_60_TEXT	一方で他のドラゴンは、あまりにも長く俗世にいたために、自分たちを遣わした存在を忘れてしまいました。
$LINE_3_8_INTRO_70_CHAR	$MAG
$LINE_3_8_INTRO_70_TEXT	彼らは堕落したわけではないですが、真の使命が何なのか、おぼろげな記憶しかないまま、大地をさまよいました。
$LINE_3_8_INTRO_80_CHAR	$MAG
$LINE_3_8_INTRO_80_TEXT	しかし、ごく限られた聡明なドラゴンは、火の神に忠実であり続けたのです。
$LINE_3_8_INTRO_90_CHAR	$MAG
$LINE_3_8_INTRO_90_TEXT	顔を合わせたいと思えるのは、そのドラゴンだけですね。
$LINE_3_8_INTRO_100_CHAR	$MAG
$LINE_3_8_INTRO_100_TEXT	使命を忘れたやつらは、危険で行動の予測がつきません。ですが、ときに恩恵や財宝をもたらします。
$LINE_3_8_INTRO_110_CHAR	$MAG
$LINE_3_8_INTRO_110_TEXT	ただし、堕落したドラゴンは、破滅を招くのみでしょう。
$LINE_3_8_INTRO_120_CHAR	$MCG
$LINE_3_8_INTRO_120_TEXT	私たちの旅のお供はどのドラゴンかしら？
$LINE_3_8_INTRO_130_CHAR	$MAG
$LINE_3_8_INTRO_130_TEXT	堕落したドラゴンか、使命を忘れたドラゴンか、どちらかでしょう。願わくば――
$LINE_3_8_INTRO_140_CHAR	$DRA
$LINE_3_8_INTRO_140_TEXT	ここだ、人間ども！
$LINE_3_8_INTRO_150_CHAR	$DRA
$LINE_3_8_INTRO_150_TEXT	さぁ、早く仕事を始めろ。
$LINE_3_8_INTRO_160_CHAR	$MCG
$LINE_3_8_INTRO_160_TEXT	これって・・・巣？
$LINE_3_8_INTRO_170_CHAR	$DRA
$LINE_3_8_INTRO_170_TEXT	毎晩毎晩、敵が巣を襲いに来るのだ。
$LINE_3_8_INTRO_180_CHAR	$DRA
$LINE_3_8_INTRO_180_TEXT	何百匹も追い返した。それでも夜になると来る。
$LINE_3_8_INTRO_190_CHAR	$DRA
$LINE_3_8_INTRO_190_TEXT	朝になると、子どもがまた一匹消えている。
$LINE_3_8_INTRO_200_CHAR	$MCG
$LINE_3_8_INTRO_200_TEXT	どうして、レブナントがドラゴンをほしがるのかしら？
$LINE_3_8_INTRO_210_CHAR	$DRA
$LINE_3_8_INTRO_210_TEXT	人間よ、今は質問の時間じゃないぞ。
$LINE_3_8_INTRO_220_CHAR	$MCG
$LINE_3_8_INTRO_220_TEXT	敵だ！
$LINE_3_8_INTRO_230_CHAR	$DRA
$LINE_3_8_INTRO_230_TEXT	今は火の時間さ！
$SCENE_3_8_OUTRO_TITLE	最後の一つ
$NARR_3_8_OUTRO_00_TEXT	ACT V
$NARR_3_8_OUTRO_00_SUB_TEXT	*殺されし者の血、我らのために踊れ！$N主の栄光のために歌え！$N血を流せ、吹き出せ、世界を血に染めよ。$N主が戻るその日まで！
$NARR_3_8_OUTRO_00_SUB_SUB_TEXT	*$N$N$N$N$N$N$N$N- ブラッドマッド教徒の歌　生き残ったゲカ民族の口述による
$LINE_3_8_OUTRO_00_CHAR	$MCG
$LINE_3_8_OUTRO_00_TEXT	子どもは無事よ。
$LINE_3_8_OUTRO_10_CHAR	$DRA
$LINE_3_8_OUTRO_10_TEXT	よくやってくれた、人間よ。
$LINE_3_8_OUTRO_20_CHAR	$MCG
$LINE_3_8_OUTRO_20_TEXT	約束は果たしたわよ。
$LINE_3_8_OUTRO_30_CHAR	$DRA
$LINE_3_8_OUTRO_30_TEXT	そうだな・・・うむ、確かにそうだ。
$LINE_3_8_OUTRO_40_CHAR	$DRA
$LINE_3_8_OUTRO_40_TEXT	でも、子どもたちが腹を空かせてるんだ。このままではお前たちが探している場所へ行くことはできんな。
$LINE_3_8_OUTRO_50_CHAR	$DRA
$LINE_3_8_OUTRO_50_TEXT	最後にご飯を食わせてから、何ヶ月も経つんだ・・・。
$LINE_3_8_OUTRO_60_CHAR	$MCG
$LINE_3_8_OUTRO_60_TEXT	ご飯、持って来てあげようか？
$LINE_3_8_OUTRO_70_CHAR	$DRA
$LINE_3_8_OUTRO_70_TEXT	お前、人間にしては勇敢だな。
$LINE_3_8_OUTRO_80_CHAR	$DRA
$LINE_3_8_OUTRO_80_TEXT	ふむ・・・こういうのはどうだ。
$LINE_3_8_OUTRO_90_CHAR	$DRA
$LINE_3_8_OUTRO_90_TEXT	お前の連れの中に、腹が膨れそうな奴がいるだろ？
$LINE_3_8_OUTRO_100_CHAR	$DRA
$LINE_3_8_OUTRO_100_TEXT	変な目つきをした馬鹿とか。
$LINE_3_8_OUTRO_110_CHAR	$DRA
$LINE_3_8_OUTRO_110_TEXT	人間不信の、だんまりむっつりの娘とか。
$LINE_3_8_OUTRO_120_CHAR	$MCG
$LINE_3_8_OUTRO_120_TEXT	他には？
$LINE_3_8_OUTRO_130_CHAR	$MCG
$LINE_3_8_OUTRO_130_TEXT	例えば、そう・・・羊は？
$LINE_3_8_OUTRO_140_CHAR	$MCG
$LINE_3_8_OUTRO_140_TEXT	若くて美味しいジューシーな羊は？？
$LINE_3_8_OUTRO_150_CHAR	$DRA
$LINE_3_8_OUTRO_150_TEXT	うーむ・・・。
$LINE_3_8_OUTRO_160_CHAR	$DRA
$LINE_3_8_OUTRO_160_TEXT	うむ、それは良いな。
$LINE_3_8_OUTRO_170_CHAR	$DRA
$LINE_3_8_OUTRO_170_TEXT	しかし、急げよ！もう堪忍袋の緒が切れそうなんだ！
$SCENE_3_9_INTRO_TITLE	羊肉
$LINE_3_9_INTRO_00_CHAR	$RAN
$LINE_3_9_INTRO_00_TEXT	羊？ホントに？それしか言えなかったの？
$LINE_3_9_INTRO_10_CHAR	$MCG
$LINE_3_9_INTRO_10_TEXT	何よ、誰のおかげで食べられずにすんだと思ってるの。
$LINE_3_9_INTRO_20_CHAR	$RAN
$LINE_3_9_INTRO_20_TEXT	もし、その羊が見つかられなかったら、どうなる？
$LINE_3_9_INTRO_30_CHAR	$MCG
$LINE_3_9_INTRO_30_TEXT	まあ、思いついたことを言っただけだしね。
$LINE_3_9_INTRO_40_CHAR	$RAN
$LINE_3_9_INTRO_40_TEXT	よりによって羊を思いつくか？ここに牧草地があるとでも？羊がどこにいる？
$LINE_3_9_INTRO_50_CHAR	$MCG
$LINE_3_9_INTRO_50_TEXT	最初に思いついたのは、むかつくガリガリ女をドラゴンに差し出すことだよ。黒髪で喋り続けているヤツをね。
$LINE_3_9_INTRO_60_CHAR	$RAN
$LINE_3_9_INTRO_60_TEXT	何だ、それ。誰のことを言ってるんだ！？
$LINE_3_9_INTRO_70_CHAR	$MCG
$LINE_3_9_INTRO_70_TEXT	羊を探すか、そいつを差し出すかだね。
$LINE_3_9_INTRO_80_CHAR	$RAN
$LINE_3_9_INTRO_80_TEXT	はあ、まったく信じられない。だって、羊なんてさ・・・
$LINE_3_9_INTRO_90_CHAR	羊
$LINE_3_9_INTRO_90_TEXT	メェェェェ
$LINE_3_9_INTRO_100_CHAR	$RAN
$LINE_3_9_INTRO_100_TEXT	・・・。
$LINE_3_9_INTRO_110_CHAR	$RAN
$LINE_3_9_INTRO_110_TEXT	んな、アホな・・・。
$LINE_3_9_INTRO_120_CHAR	$MAG
$LINE_3_9_INTRO_120_TEXT	*さすがですね、$MCG。
$LINE_3_9_INTRO_130_CHAR	$MAG
$LINE_3_9_INTRO_130_TEXT	クウェイドの町の地下に、羊の養育所が隠されていることを知っている者は、そう多くはありません。
$LINE_3_9_INTRO_140_CHAR	$MAG
$LINE_3_9_INTRO_140_TEXT	通常は、町が包囲された時のためのものですが、今は緊急事態ですからね。
$LINE_3_9_INTRO_150_CHAR	$MAG
$LINE_3_9_INTRO_150_TEXT	ただ、あの羊が・・・凶暴化していなければいいのですが。
$LINE_3_9_INTRO_160_CHAR	$MCG
$LINE_3_9_INTRO_160_TEXT	凶暴化？
$LINE_3_9_INTRO_170_CHAR	$MAG
$LINE_3_9_INTRO_170_TEXT	長期間、町が放置されていましたから、ほとんど食べるものがなかったはずです。きのこを食べるか、共食いする他ないですから。
$LINE_3_9_INTRO_180_CHAR	$MAG
$LINE_3_9_INTRO_180_TEXT	だから、荒々しい性格になっているかと。
$LINE_3_9_INTRO_190_CHAR	$MCG
$LINE_3_9_INTRO_190_TEXT	いつか、私を殺そうとしない人や動物に会える日が来ないかしら。
$LINE_3_9_INTRO_200_CHAR	$MAG
$LINE_3_9_INTRO_200_TEXT	どうやら、今日はその日ではなさそうですね。
$SCENE_3_9_OUTRO_TITLE	お腹いっぱい
$LINE_3_9_OUTRO_00_CHAR	$DRA
$LINE_3_9_OUTRO_00_TEXT	子どもたちは、たらふく食べて、元気になったぞ。
$LINE_3_9_OUTRO_10_CHAR	$MCG
$LINE_3_9_OUTRO_10_TEXT	*約束は果たしたわよ、$DRA。
$LINE_3_9_OUTRO_20_CHAR	$DRA
$LINE_3_9_OUTRO_20_TEXT	よくやってくれた。お前たちを王室記録の間に連れて行ってやろう。しかし、条件がある。
$LINE_3_9_OUTRO_30_CHAR	$DRA
$LINE_3_9_OUTRO_30_TEXT	お前たちの用事が済んだら、私を奈落の谷から連れ出してくれ。
$LINE_3_9_OUTRO_40_CHAR	$MCG
$LINE_3_9_OUTRO_40_TEXT	翼があるじゃない。飛んで出れば？
$LINE_3_9_OUTRO_50_CHAR	$DRA
$LINE_3_9_OUTRO_50_TEXT	質問が多いぞ、人間めが。
$LINE_3_9_OUTRO_60_CHAR	$DRA
$LINE_3_9_OUTRO_60_TEXT	お前のような有用な者でも、あまり調子に乗ると焼き殺してやるぞ。
$LINE_3_9_OUTRO_70_CHAR	$MCG
$LINE_3_9_OUTRO_70_TEXT	わかったわよ。喜んで、一緒に連れ出してあげる。
$LINE_3_9_OUTRO_80_CHAR	$DRA
$LINE_3_9_OUTRO_80_TEXT	そうだろう、喜ばしいだろう。
$LINE_3_9_OUTRO_90_CHAR	$MCG
$LINE_3_9_OUTRO_90_TEXT	でも、アンタも戦うのよ！
$LINE_3_9_OUTRO_100_CHAR	$DRA
$LINE_3_9_OUTRO_100_TEXT	・・・。
$LINE_3_9_OUTRO_110_CHAR	$DRA
$LINE_3_9_OUTRO_110_TEXT	駆け引きが上手いな、人間め。
$LINE_3_9_OUTRO_120_CHAR	$DRA
$LINE_3_9_OUTRO_120_TEXT	・・・大胆なヤツだな。面白い。
$LINE_3_9_OUTRO_130_CHAR	$DRA
$LINE_3_9_OUTRO_130_TEXT	子どもたちを救えるのなら、お前たちの敵を焼き殺してやろう。
$SCENE_DRAGON_LAIR_INTRO_TITLE	ドラゴンの秘密の宝庫
$LINE_DRAGON_LAIR_INTRO_00_CHAR	$DRA
$LINE_DRAGON_LAIR_INTRO_00_TEXT	長年に渡り、人間の武器や鎧を集めてきた。
$LINE_DRAGON_LAIR_INTRO_10_CHAR	$DRA
$LINE_DRAGON_LAIR_INTRO_10_TEXT	我々にとっては無用の長物だが、きらきらしてるからな。我々は、輝いている物が好きなのだ。
$LINE_DRAGON_LAIR_INTRO_20_CHAR	$DRA
$LINE_DRAGON_LAIR_INTRO_20_TEXT	お前らのような戦団なら、これを使いこなせるだろう。
$LINE_DRAGON_LAIR_INTRO_30_CHAR	$DRA
$LINE_DRAGON_LAIR_INTRO_30_TEXT	もちろん、それなりの代償でな・・・。
$LINE_DRAGON_LAIR_INTRO_40_CHAR	$BER
$LINE_DRAGON_LAIR_INTRO_40_TEXT	ああ、あの羊のスープ、チョーうまかったな！
$LINE_DRAGON_LAIR_INTRO_50_CHAR	$DRA
$LINE_DRAGON_LAIR_INTRO_50_TEXT	あれか？私が子どものために噛んで吐き出したものだ。
$LINE_DRAGON_LAIR_INTRO_60_CHAR	$BER
$LINE_DRAGON_LAIR_INTRO_60_TEXT	・・・。
$LINE_DRAGON_LAIR_INTRO_70_CHAR	$DRA
$LINE_DRAGON_LAIR_INTRO_70_TEXT	・・・。
$LINE_DRAGON_LAIR_INTRO_80_CHAR	$BER
$LINE_DRAGON_LAIR_INTRO_80_TEXT	もう一杯ないか？
$SCENE_DRAGON_LAIR_OUTRO_TITLE	長話
$LINE_DRAGON_LAIR_OUTRO_00_CHAR	$MCG
$LINE_DRAGON_LAIR_OUTRO_00_TEXT	さあ、行きましょうか。
$LINE_DRAGON_LAIR_OUTRO_10_CHAR	$MCG
$LINE_DRAGON_LAIR_OUTRO_10_TEXT	*・・・$HEAご老師？
$LINE_DRAGON_LAIR_OUTRO_20_CHAR	$HEA
$LINE_DRAGON_LAIR_OUTRO_20_TEXT	世界を破滅に導くのは、簡単でした。恐ろしいほどに。
$LINE_DRAGON_LAIR_OUTRO_30_CHAR	$HEA
$LINE_DRAGON_LAIR_OUTRO_30_TEXT	ゼレミアは私を連れ出しました。――遠く東の砂漠にある、暗い洞穴へ。
$LINE_DRAGON_LAIR_OUTRO_40_CHAR	$HEA
$LINE_DRAGON_LAIR_OUTRO_40_TEXT	そして、立派なクリスタルを見つけました。10m近くの高さに及ぶクリスタルです。
$LINE_DRAGON_LAIR_OUTRO_50_CHAR	$HEA
$LINE_DRAGON_LAIR_OUTRO_50_TEXT	そこで、私たちは自らに傷をつけ、血を岩面に注ぎました。
$LINE_DRAGON_LAIR_OUTRO_60_CHAR	$HEA
$LINE_DRAGON_LAIR_OUTRO_60_TEXT	その時の傷は、今も癒えていません。
$LINE_DRAGON_LAIR_OUTRO_70_CHAR	$HEA
$LINE_DRAGON_LAIR_OUTRO_70_TEXT	最初は、異変に気づきませんでした。
$LINE_DRAGON_LAIR_OUTRO_80_CHAR	$HEA
$LINE_DRAGON_LAIR_OUTRO_80_TEXT	でも、ゼレミア・・・彼は、トランス状態に陥ったのです。私はただ様子を見ていました。
$LINE_DRAGON_LAIR_OUTRO_90_CHAR	$HEA
$LINE_DRAGON_LAIR_OUTRO_90_TEXT	太陽が沈み、周囲に砂漠の獣たちの遠吠えが響き渡った。それでも、ゼレミアは動きませんでした。
$LINE_DRAGON_LAIR_OUTRO_100_CHAR	$HEA
$LINE_DRAGON_LAIR_OUTRO_100_TEXT	宿に、狼が跳び込んで来た時さえね・・・。
$LINE_DRAGON_LAIR_OUTRO_110_CHAR	$HEA
$LINE_DRAGON_LAIR_OUTRO_110_TEXT	私は、狼を叩き斬った！ 狼は、ゼレミアの足元で事切れた。
$LINE_DRAGON_LAIR_OUTRO_120_CHAR	$HEA
$LINE_DRAGON_LAIR_OUTRO_120_TEXT	しかし、ゼレミアは気づきもせず、3日が過ぎました。
$LINE_DRAGON_LAIR_OUTRO_130_CHAR	$HEA
$LINE_DRAGON_LAIR_OUTRO_130_TEXT	3日目の夜明け、彼は3度瞬きをして、立ち上がりました。
$LINE_DRAGON_LAIR_OUTRO_140_CHAR	$HEA
$LINE_DRAGON_LAIR_OUTRO_140_TEXT	『我々の問題は、解決した。』・・・彼は、そう言ったのです。
$LINE_DRAGON_LAIR_OUTRO_150_CHAR	$HEA
$LINE_DRAGON_LAIR_OUTRO_150_TEXT	宿に戻ると、敵軍は全滅していました。
$LINE_DRAGON_LAIR_OUTRO_160_CHAR	$HEA
$LINE_DRAGON_LAIR_OUTRO_160_TEXT	それからです。死病の蔓延が始まったのは。
$LINE_DRAGON_LAIR_OUTRO_170_CHAR	$HEA
$LINE_DRAGON_LAIR_OUTRO_170_TEXT	彼が・・・恍惚とした様子で、どこか別の世界に心を開いているような状態ですごす時間は、日ごとに増えました。
$LINE_DRAGON_LAIR_OUTRO_180_CHAR	$HEA
$LINE_DRAGON_LAIR_OUTRO_180_TEXT	一ヶ月も経たぬうちに、クウェイド帝国の人民の半数はもう死亡したか、死にかけたか、死よりも恐ろしい状態にいました。
$LINE_DRAGON_LAIR_OUTRO_190_CHAR	$HEA
$LINE_DRAGON_LAIR_OUTRO_190_TEXT	地平線は、火葬の明かりでぎらぎらと光り・・・町々は混乱の中崩壊していきました。戦争を経験した私でさえ、目を覆いたくなるような光景です。
$LINE_DRAGON_LAIR_OUTRO_200_CHAR	$HEA
$LINE_DRAGON_LAIR_OUTRO_200_TEXT	終わらせなければ。私はそう言いました。
$LINE_DRAGON_LAIR_OUTRO_210_CHAR	$HEA
$LINE_DRAGON_LAIR_OUTRO_210_TEXT	しかし、もはやゼレミアは――私の言葉など受けつけなくなっていました。
$LINE_DRAGON_LAIR_OUTRO_220_CHAR	$HEA
$LINE_DRAGON_LAIR_OUTRO_220_TEXT	彼が取りつかれる時間は、日に日に伸び、ついに抜け出すことさえなくなりました。
$LINE_DRAGON_LAIR_OUTRO_230_CHAR	$HEA
$LINE_DRAGON_LAIR_OUTRO_230_TEXT	三日間、待ちました。毎日、数千人もの人が死にました。
$LINE_DRAGON_LAIR_OUTRO_240_CHAR	$HEA
$LINE_DRAGON_LAIR_OUTRO_240_TEXT	ある日の明け方、私は彼のテントに入ったのです。
$LINE_DRAGON_LAIR_OUTRO_250_CHAR	$HEA
$LINE_DRAGON_LAIR_OUTRO_250_TEXT	彼は、私の存在に気付きませんでした。・・・もう、すべてに気づかなくなってしまっていたのです。
$LINE_DRAGON_LAIR_OUTRO_260_CHAR	$HEA
$LINE_DRAGON_LAIR_OUTRO_260_TEXT	私は、彼を剣で突き刺しました・・・。
$LINE_DRAGON_LAIR_OUTRO_270_CHAR	$HEA
$LINE_DRAGON_LAIR_OUTRO_270_TEXT	そして、砂漠に埋めたのです。
$LINE_DRAGON_LAIR_OUTRO_280_CHAR	$HEA
$LINE_DRAGON_LAIR_OUTRO_280_TEXT	それでも、感染症の蔓延は続き、やがて国境を越え、すべてを破壊しました。
$LINE_DRAGON_LAIR_OUTRO_290_CHAR	$HEA
$LINE_DRAGON_LAIR_OUTRO_290_TEXT	長い長い帰路の途中、私は、セリーニの僧の一団と出会いました。
$LINE_DRAGON_LAIR_OUTRO_300_CHAR	$HEA
$LINE_DRAGON_LAIR_OUTRO_300_TEXT	私は剣を投げ捨て、彼らの足元にひれ伏しました。それ以来、私は僧としての生活を送っています。
$LINE_DRAGON_LAIR_OUTRO_310_CHAR	$HEA
$LINE_DRAGON_LAIR_OUTRO_310_TEXT	・・・殺したはずの旧友が、今、モンスターとなって再び現れた。
$LINE_DRAGON_LAIR_OUTRO_320_CHAR	$HEA
$LINE_DRAGON_LAIR_OUTRO_320_TEXT	*これが、私たちが戦う相手、闇の魔法なのですよ、$MCG。
$LINE_DRAGON_LAIR_OUTRO_330_CHAR	$HEA
$LINE_DRAGON_LAIR_OUTRO_330_TEXT	ここに記された記録が、闇の魔法を滅ぼす鍵を示してくれることを、強く願っています。
$LINE_DRAGON_LAIR_OUTRO_340_CHAR	$MCG
$LINE_DRAGON_LAIR_OUTRO_340_TEXT	私たちもみな、同じ気持ちです。
$SCENE_SIDEQUEST_6_GET_TITLE	堕ちた寺院
$LINE_SIDEQUEST_6_GET_00_CHAR	$KNI
$LINE_SIDEQUEST_6_GET_00_TEXT	*$MCG？
$LINE_SIDEQUEST_6_GET_10_CHAR	$MCG
$LINE_SIDEQUEST_6_GET_10_TEXT	初めて、下の名前で呼んでくれたね。
$LINE_SIDEQUEST_6_GET_20_CHAR	$KNI
$LINE_SIDEQUEST_6_GET_20_TEXT	あなたの仲間の選び方をとやかく言うつもりはありません。<N>しかし、あの異国のお姫様は・・・ゴホン・・・ちょっとイカれています。彼女のおかげで、みんな死んでしまいますよ。
$LINE_SIDEQUEST_6_GET_30_CHAR	$MCG
$LINE_SIDEQUEST_6_GET_30_TEXT	*$MAGはそれほど悪い人じゃないよ。ちょっと殺人狂なところもあるけど、そこを慣れればね。
$LINE_SIDEQUEST_6_GET_40_CHAR	$KNI
$LINE_SIDEQUEST_6_GET_40_TEXT	彼女から殺人狂なところを除いたら、何も残りませんよ。
$LINE_SIDEQUEST_6_GET_50_CHAR	$MCG
$LINE_SIDEQUEST_6_GET_50_TEXT	一度ゆっくり、話してみたら？
$LINE_SIDEQUEST_6_GET_60_CHAR	$KNI
$LINE_SIDEQUEST_6_GET_60_TEXT	元囚人と元衛兵が話ですか。これは大した取り合わせですな。
$LINE_SIDEQUEST_6_GET_70_CHAR	$KNI
$LINE_SIDEQUEST_6_GET_70_TEXT	友情の力で、虹に乗って奈落から出られるかもしれませんね。
$LINE_SIDEQUEST_6_GET_80_CHAR	$MCG
$LINE_SIDEQUEST_6_GET_80_TEXT	何が言いたいの？
$LINE_SIDEQUEST_6_GET_90_CHAR	$KNI
$LINE_SIDEQUEST_6_GET_90_TEXT	このあたりに、汚されたクウェイドの寺院があるのです。
$LINE_SIDEQUEST_6_GET_100_CHAR	$KNI
$LINE_SIDEQUEST_6_GET_100_TEXT	*$MAGが気づいたようで、それでつまり・・・何て言えば。
$LINE_SIDEQUEST_6_GET_110_CHAR	$KNI
$LINE_SIDEQUEST_6_GET_110_TEXT	お嬢様は司書でしょう？<N>これを示す形容詞がありますか？
$LINE_SIDEQUEST_6_GET_120_CHAR	$KNI
$LINE_SIDEQUEST_6_GET_120_TEXT	「常識ある人間としての仮面を脱ぎ、グツグツと煮えたぎる狂気の本性をあらわにした」という意味の形容詞が。
$LINE_SIDEQUEST_6_GET_130_CHAR	$BER
$LINE_SIDEQUEST_6_GET_130_TEXT	*$MCG！
$LINE_SIDEQUEST_6_GET_140_CHAR	$MCG
$LINE_SIDEQUEST_6_GET_140_TEXT	どうしたの？
$LINE_SIDEQUEST_6_GET_150_CHAR	$BER
$LINE_SIDEQUEST_6_GET_150_TEXT	*ズルいぜ！$MAGが一人占めしようとしてる！
$LINE_SIDEQUEST_6_GET_160_CHAR	$MCG
$LINE_SIDEQUEST_6_GET_160_TEXT	一体、何の話？
$LINE_SIDEQUEST_6_GET_170_CHAR	$BER
$LINE_SIDEQUEST_6_GET_170_TEXT	*$MAGが、超イカした寺院を見つけてよ。<N>えっと・・・無量大数の次の数字って何だ？
$LINE_SIDEQUEST_6_GET_180_CHAR	$MCG
$LINE_SIDEQUEST_6_GET_180_TEXT	無量大数プラス１？
$LINE_SIDEQUEST_6_GET_190_CHAR	$BER
$LINE_SIDEQUEST_6_GET_190_TEXT	*そうそう、そこに無量大数プラス１のレブナントがいるのに、$MAGが戦わせてくれないんだ！
$LINE_SIDEQUEST_6_GET_200_CHAR	$MCG
$LINE_SIDEQUEST_6_GET_200_TEXT	アンタには、必要なければ戦わないっていう発想はないの？
$LINE_SIDEQUEST_6_GET_210_CHAR	$BER
$LINE_SIDEQUEST_6_GET_210_TEXT	・・・。
$LINE_SIDEQUEST_6_GET_220_CHAR	$BER
$LINE_SIDEQUEST_6_GET_220_TEXT	・・・そういう、おかしな、ヘンテコな、理屈は、理解できない・・・。
$LINE_SIDEQUEST_6_GET_230_CHAR	$BER
$LINE_SIDEQUEST_6_GET_230_TEXT	*とにかくさ、$MAGがその神殿はまるごと彼女のもので足を踏み入れようとする者は殺すってよ。
$LINE_SIDEQUEST_6_GET_240_CHAR	$BER
$LINE_SIDEQUEST_6_GET_240_TEXT	そんなのフェアじゃないぜ！<N>あいつの顔を溶かしちまおう！
$LINE_SIDEQUEST_6_GET_250_CHAR	$MCG
$LINE_SIDEQUEST_6_GET_250_TEXT	なんでムカつくと顔を溶かすのよ。
$LINE_SIDEQUEST_6_GET_260_CHAR	$KNI
$LINE_SIDEQUEST_6_GET_260_TEXT	どうですか？<N>この狂人でさえ混乱させてしまうほど、彼女は狂っているのですよ。
$LINE_SIDEQUEST_6_GET_270_CHAR	$MCG
$LINE_SIDEQUEST_6_GET_270_TEXT	真実を確かめましょう。
$SCENE_SIDEQUEST_6_INTRO_TITLE	炎の神のしもべ
$LINE_SIDEQUEST_6_INTRO_00_CHAR	$MAG
$LINE_SIDEQUEST_6_INTRO_00_TEXT	我こそは、炎の娘！
$LINE_SIDEQUEST_6_INTRO_10_CHAR	$BER
$LINE_SIDEQUEST_6_INTRO_10_TEXT	*お前が誰だろうが関係ねー、オレたちも混ぜろ！<N>って$MCGが言ってるぜ！
$LINE_SIDEQUEST_6_INTRO_20_CHAR	$MCG
$LINE_SIDEQUEST_6_INTRO_20_TEXT	そんなこと言ってないわよ。
$LINE_SIDEQUEST_6_INTRO_30_CHAR	$MAG
$LINE_SIDEQUEST_6_INTRO_30_TEXT	この寺院の敵を追い払うのは、私一人で十分です。他の者に立ち入られては、寺院の浄化にならない！
$LINE_SIDEQUEST_6_INTRO_40_CHAR	$MCG
$LINE_SIDEQUEST_6_INTRO_40_TEXT	*$MAG、よく聞いて。あなた一人では無理だよ。
$LINE_SIDEQUEST_6_INTRO_50_CHAR	$MAG
$LINE_SIDEQUEST_6_INTRO_50_TEXT	*我は$MAG・ラン・ラクスミ、火の神の高僧なり！<N>死者であろうと生者であろうと、火宿る場所に立ち入ることは許さん！
$LINE_SIDEQUEST_6_INTRO_60_CHAR	$MCG
$LINE_SIDEQUEST_6_INTRO_60_TEXT	*$MAG？私はただ―
$LINE_SIDEQUEST_6_INTRO_70_CHAR	$MAG
$LINE_SIDEQUEST_6_INTRO_70_TEXT	*$MCG、止めろ、さもないと貴様も殺すぞ！<N>これは私が決めたことではないのです。真実を知る者が宿りし寺院には、何人たりとも立ち入ることはできません。
$LINE_SIDEQUEST_6_INTRO_80_CHAR	$MAG
$LINE_SIDEQUEST_6_INTRO_80_TEXT	何が何でも、忠誠と名誉を守ると誓ったのです。<N>友を殺したくはない。
$LINE_SIDEQUEST_6_INTRO_90_CHAR	$MCG
$LINE_SIDEQUEST_6_INTRO_90_TEXT	じゃあ、私なしでどうやってレブナントを殺すつもり？
$LINE_SIDEQUEST_6_INTRO_100_CHAR	$MAG
$LINE_SIDEQUEST_6_INTRO_100_TEXT	・・・考え中です。
$LINE_SIDEQUEST_6_INTRO_110_CHAR	$MCG
$LINE_SIDEQUEST_6_INTRO_110_TEXT	*あなた、死にたいの？そういうことなの、$MAG？
$LINE_SIDEQUEST_6_INTRO_120_CHAR	$MAG
$LINE_SIDEQUEST_6_INTRO_120_TEXT	私は、火の神に仕えるのみ！
$LINE_SIDEQUEST_6_INTRO_130_CHAR	$MCG
$LINE_SIDEQUEST_6_INTRO_130_TEXT	へぇ、火の神に仕えるって、進んで死ぬことなの？<N>クウェイドの家系をここで終わらせることなの？
$LINE_SIDEQUEST_6_INTRO_140_CHAR	$MCG
$LINE_SIDEQUEST_6_INTRO_140_TEXT	で、神判の日にこう言うんだ。
$LINE_SIDEQUEST_6_INTRO_150_CHAR	$MCG
$LINE_SIDEQUEST_6_INTRO_150_TEXT	目の前の使命が大きすぎて、下さった手段も気に入らなかったので、死ぬことにしました。
$LINE_SIDEQUEST_6_INTRO_160_CHAR	$MAG
$LINE_SIDEQUEST_6_INTRO_160_TEXT	そうではない！
$LINE_SIDEQUEST_6_INTRO_170_CHAR	$MCG
$LINE_SIDEQUEST_6_INTRO_170_TEXT	ホント？そんな風にしか見えないよ。<N>で、お墓には「帝国再建には臆病すぎた者。自ら死ぬことにした。」って書かれるんだ。
$LINE_SIDEQUEST_6_INTRO_180_CHAR	$MAG
$LINE_SIDEQUEST_6_INTRO_180_TEXT	そうではない！！
$LINE_SIDEQUEST_6_INTRO_190_CHAR	$MCG
$LINE_SIDEQUEST_6_INTRO_190_TEXT	じゃあ、私も連れて行ってよ。
$LINE_SIDEQUEST_6_INTRO_200_CHAR	$MAG
$LINE_SIDEQUEST_6_INTRO_200_TEXT	しかし・・・
$LINE_SIDEQUEST_6_INTRO_210_CHAR	$MCG
$LINE_SIDEQUEST_6_INTRO_210_TEXT	一人で行ったら、敵の援軍になって帰ってくるのがオチよ。
$LINE_SIDEQUEST_6_INTRO_220_CHAR	$MCG
$LINE_SIDEQUEST_6_INTRO_220_TEXT	あなた、誰の味方？
$LINE_SIDEQUEST_6_INTRO_230_CHAR	$MAG
$LINE_SIDEQUEST_6_INTRO_230_TEXT	私は・・・火の神に仕えし者・・・。
$LINE_SIDEQUEST_6_INTRO_240_CHAR	$MCG
$LINE_SIDEQUEST_6_INTRO_240_TEXT	じゃあ、一緒に寺院を浄化しましょう。
$SCENE_SIDEQUEST_6_OUTRO_TITLE	ピースを集めて
$LINE_SIDEQUEST_6_OUTRO_00_CHAR	$MAG
$LINE_SIDEQUEST_6_OUTRO_00_TEXT	貴様、なぜここに！？
$LINE_SIDEQUEST_6_OUTRO_10_CHAR	$DRA
$LINE_SIDEQUEST_6_OUTRO_10_TEXT	む、忘れたのか、このちっぽけな人間め。<N>私も火の秘法を知る者だぞ！
$LINE_SIDEQUEST_6_OUTRO_20_CHAR	$MAG
$LINE_SIDEQUEST_6_OUTRO_20_TEXT	お前は外道だ！歪んだ存在だ！天への冒とくだ！
$LINE_SIDEQUEST_6_OUTRO_30_CHAR	$MCG
$LINE_SIDEQUEST_6_OUTRO_30_TEXT	*$MAG、彼女も助けてくれたんだし。
$LINE_SIDEQUEST_6_OUTRO_40_CHAR	$MAG
$LINE_SIDEQUEST_6_OUTRO_40_TEXT	貴様の息で、この土地が汚れる。失せろ！
$LINE_SIDEQUEST_6_OUTRO_50_CHAR	$DRA
$LINE_SIDEQUEST_6_OUTRO_50_TEXT	私は神だからな。どこでも行きたいところへ行く。
$LINE_SIDEQUEST_6_OUTRO_60_CHAR	$MAG
$LINE_SIDEQUEST_6_OUTRO_60_TEXT	失せろ！！
$LINE_SIDEQUEST_6_OUTRO_70_CHAR	$MCG
$LINE_SIDEQUEST_6_OUTRO_70_TEXT	・・・。
$LINE_SIDEQUEST_6_OUTRO_80_CHAR	$MCG
$LINE_SIDEQUEST_6_OUTRO_80_TEXT	話、してもいい？
$LINE_SIDEQUEST_6_OUTRO_90_CHAR	$MAG
$LINE_SIDEQUEST_6_OUTRO_90_TEXT	言葉など、無駄ですよ。
$LINE_SIDEQUEST_6_OUTRO_100_CHAR	$MCG
$LINE_SIDEQUEST_6_OUTRO_100_TEXT	それは違うと思うよ。じゃなかったら、司書なんかやってないよ。
$LINE_SIDEQUEST_6_OUTRO_110_CHAR	$MAG
$LINE_SIDEQUEST_6_OUTRO_110_TEXT	では、あなたは選べたのですね。私は・・・
$LINE_SIDEQUEST_6_OUTRO_120_CHAR	$MAG
$LINE_SIDEQUEST_6_OUTRO_120_TEXT	・・・どのあばら屋を訪ねても、どの掘っ立て小屋のそばを通っても、生き残った民の視線を感じるのです。彼らは私を知っている。
$LINE_SIDEQUEST_6_OUTRO_130_CHAR	$MAG
$LINE_SIDEQUEST_6_OUTRO_130_TEXT	彼らは私が町へと導くと思っている。あの、もう存在すらしていない町に！
$LINE_SIDEQUEST_6_OUTRO_140_CHAR	$MAG
$LINE_SIDEQUEST_6_OUTRO_140_TEXT	この場所こそが、私の居場所！この、墓場となった寺が！
$LINE_SIDEQUEST_6_OUTRO_150_CHAR	$MAG
$LINE_SIDEQUEST_6_OUTRO_150_TEXT	散り散りになって生き残った民が、私の救済を待っている。しかし、私にはこの朽ちた寺院よりもいい場所を与えられない。
$LINE_SIDEQUEST_6_OUTRO_160_CHAR	$MAG
$LINE_SIDEQUEST_6_OUTRO_160_TEXT	私は子供の頃から、囚人捕虜だった・・・あなたには想像もできないでしょう・・・彼らが私をどのように扱ったか。
$LINE_SIDEQUEST_6_OUTRO_170_CHAR	$MAG
$LINE_SIDEQUEST_6_OUTRO_170_TEXT	いや・・・違う、あなたたちが私をどう扱ったかだ！
$LINE_SIDEQUEST_6_OUTRO_180_CHAR	$MAG
$LINE_SIDEQUEST_6_OUTRO_180_TEXT	頭の中で、いつも叫び声が聞こえる。あの日の私の叫び声が。目を閉じれば、血だまりに立つ妹たちの姿が見える・・・。
$LINE_SIDEQUEST_6_OUTRO_190_CHAR	$MCG
$LINE_SIDEQUEST_6_OUTRO_190_TEXT	*$MAG・・・。
$LINE_SIDEQUEST_6_OUTRO_200_CHAR	$MAG
$LINE_SIDEQUEST_6_OUTRO_200_TEXT	容赦なく照りつける日差しの中・・・私は壊れた矢頭を握りしめ、監視人が背を向けるのを待っている。首を狙って・・・
$LINE_SIDEQUEST_6_OUTRO_210_CHAR	$MAG
$LINE_SIDEQUEST_6_OUTRO_210_TEXT	そして私だけが残った。大勢いたのに・・・私は、王室最後の生き残りなのです。
$LINE_SIDEQUEST_6_OUTRO_220_CHAR	$MAG
$LINE_SIDEQUEST_6_OUTRO_220_TEXT	自分の心を律することさえできない！一国の指導者になれるわけがない。
$LINE_SIDEQUEST_6_OUTRO_230_CHAR	$MAG
$LINE_SIDEQUEST_6_OUTRO_230_TEXT	民のために、何ができるというのですか？
$LINE_SIDEQUEST_6_OUTRO_240_CHAR	$MCG
$LINE_SIDEQUEST_6_OUTRO_240_TEXT	*$MAG、私は司書です。そして、あなたはクウェイド帝国の戦う姫君。
$LINE_SIDEQUEST_6_OUTRO_250_CHAR	$MCG
$LINE_SIDEQUEST_6_OUTRO_250_TEXT	あなたは指導者になる人。私は・・・本を積み上げて、変な館長にじろじろ見られる人。
$LINE_SIDEQUEST_6_OUTRO_260_CHAR	$MCG
$LINE_SIDEQUEST_6_OUTRO_260_TEXT	どうしたらいいか全然わからないし、みんなのを引っ張っていくのは怖い。<N>・・・どうにかまとめていこうとしてるけど、息をするので精一杯な時もある。
$LINE_SIDEQUEST_6_OUTRO_270_CHAR	$MCG
$LINE_SIDEQUEST_6_OUTRO_270_TEXT	私だったら、自分みたいな人間についていかない。
$LINE_SIDEQUEST_6_OUTRO_280_CHAR	$MCG
$LINE_SIDEQUEST_6_OUTRO_280_TEXT	あなたを見ていて思うの。その勇気や決断力の10分の1でもあったらなって。
$LINE_SIDEQUEST_6_OUTRO_290_CHAR	$MCG
$LINE_SIDEQUEST_6_OUTRO_290_TEXT	でも、なくて良かったかも。あったら、谷から逃げ出すだけじゃ収まらないで、自分で帝国を打ち建てようとしちゃうかも。
$LINE_SIDEQUEST_6_OUTRO_300_CHAR	$MAG
$LINE_SIDEQUEST_6_OUTRO_300_TEXT	・・・
$LINE_SIDEQUEST_6_OUTRO_310_CHAR	$MAG
$LINE_SIDEQUEST_6_OUTRO_310_TEXT	*ありがとう、$MCG。
$LINE_SIDEQUEST_6_OUTRO_320_CHAR	$MAG
$LINE_SIDEQUEST_6_OUTRO_320_TEXT	・・・言葉は大事ですね。
$LINE_SIDEQUEST_6_OUTRO_330_CHAR	$MCG
$LINE_SIDEQUEST_6_OUTRO_330_TEXT	・・・ハグしてあげようか？
$LINE_SIDEQUEST_6_OUTRO_340_CHAR	$MAG
$LINE_SIDEQUEST_6_OUTRO_340_TEXT	ハグって何ですか？
$SCENE_3_10_INTRO_TITLE	王室記録の間
$LINE_3_10_INTRO_00_CHAR	$DRA
$LINE_3_10_INTRO_00_TEXT	人間ども。ここが王室記録の間だ。
$LINE_3_10_INTRO_10_CHAR	$MCG
$LINE_3_10_INTRO_10_TEXT	どういう意味かしら？
$LINE_3_10_INTRO_20_CHAR	$HEA
$LINE_3_10_INTRO_20_TEXT	あのとき、血を注いだ意味がわかりました。封印の儀式に関係しているようです。
$LINE_3_10_INTRO_30_CHAR	$HEA
$LINE_3_10_INTRO_30_TEXT	子孫・・・第一子の・・・血・・・
$LINE_3_10_INTRO_40_CHAR	$HEA
$LINE_3_10_INTRO_40_TEXT	我々は先祖の血による封印を解いたのです。
$LINE_3_10_INTRO_50_CHAR	$HEA
$LINE_3_10_INTRO_50_TEXT	封印を解けるのは、封印をほどこした者の血だけ―
$LINE_3_10_INTRO_60_CHAR	$MCG
$LINE_3_10_INTRO_60_TEXT	でも、何年も前に、死んでしまったんでしょう？
$LINE_3_10_INTRO_70_CHAR	$HEA
$LINE_3_10_INTRO_70_TEXT	ええ、しかし、その血は、子孫に受け継がれています。第一子の血・・・
$LINE_3_10_INTRO_80_CHAR	$MCG
$LINE_3_10_INTRO_80_TEXT	でも、何を封じているのでしょう？ゼレミアが奪った力？
$LINE_3_10_INTRO_90_CHAR	$HEA
$LINE_3_10_INTRO_90_TEXT	*よくわかりません。難解な言葉だ・・・。<N>もしかすると、$MAGなら読めるかもしれない。
$LINE_3_10_INTRO_100_CHAR	$MAG
$LINE_3_10_INTRO_100_TEXT	これは、今までに見たどんなクウェイド語よりも古いな・・・。
$LINE_3_10_INTRO_110_CHAR	$MAG
$LINE_3_10_INTRO_110_TEXT	・・・自由な民の指導者たち・・・集結し・・・<N>苦しみといさかいの地で・・・
$LINE_3_10_INTRO_120_CHAR	$MAG
$LINE_3_10_INTRO_120_TEXT	偉大な王が倒れた――きっと、クウェイドの王のことですね。
$LINE_3_10_INTRO_130_CHAR	$MAG
$LINE_3_10_INTRO_130_TEXT	倒れた・・・しかし、彼の仲間たちは・・・
$LINE_3_10_INTRO_140_CHAR	$MAG
$LINE_3_10_INTRO_140_TEXT	悪を封じ込めた・・・血の代償により・・・アシャンティ王とその忠実な宰相、コムナット・コザール・・・
$LINE_3_10_INTRO_150_CHAR	$MAG
$LINE_3_10_INTRO_150_TEXT	そして、もう一人運命の呼び声に応えた者・・・一兵士・・・
$LINE_3_10_INTRO_160_CHAR	$MAG
$LINE_3_10_INTRO_160_TEXT	その一族のネフィール家、以後は王室の・・・この言葉は「収集物」かな？・・・をつかさどるようになる・・・
$LINE_3_10_INTRO_170_CHAR	$MAG
$LINE_3_10_INTRO_170_TEXT	この3人がみずからの血をもって抑え込んだ悪・・・。
$LINE_3_10_INTRO_180_CHAR	$MAG
$LINE_3_10_INTRO_180_TEXT	エズティル・テノク・・・。
$LINE_3_10_INTRO_190_CHAR	$MCG
$LINE_3_10_INTRO_190_TEXT	エズティル・テノク？
$LINE_3_10_INTRO_200_CHAR	$MAG
$LINE_3_10_INTRO_200_TEXT	知らないな・・・これはクウェイド語じゃない。
$LINE_3_10_INTRO_210_CHAR	$MCG
$LINE_3_10_INTRO_210_TEXT	私も聞いたことのない言語ね。
$LINE_3_10_INTRO_220_CHAR	$RAN
$LINE_3_10_INTRO_220_TEXT	今、エズティル・テノクって言った？
$LINE_3_10_INTRO_230_CHAR	$MAG
$LINE_3_10_INTRO_230_TEXT	知ってるのか？
$LINE_3_10_INTRO_240_CHAR	$RAN
$LINE_3_10_INTRO_240_TEXT	極東に住む、ブラッドマッド族が崇拝している神だ。
$LINE_3_10_INTRO_250_CHAR	$MAG
$LINE_3_10_INTRO_250_TEXT	血を飲むヤツらか？私の祖父が王だった頃、奴らを根絶やしにしようと手を焼いたな。
$LINE_3_10_INTRO_260_CHAR	$RAN
$LINE_3_10_INTRO_260_TEXT	いや、飲むんじゃない。血で絵を描くだけさ。
$LINE_3_10_INTRO_270_CHAR	$BER
$LINE_3_10_INTRO_270_TEXT	そりゃスゴそうだな。<N>でもよ、ここにいる大量のレブナントをぶち殺す方が先だぜ。
$LINE_3_10_INTRO_280_CHAR	$BER
$LINE_3_10_INTRO_280_TEXT	ああ、お前は何もしなくていいよ。<N>俺がたった一人で状況を打開するのを、指を咥えて見てりゃあいいんだ。
$LINE_3_10_INTRO_290_CHAR	$BER
$LINE_3_10_INTRO_290_TEXT	いや、まぁ、たった一人ってわけじゃない・・・。俺にはいつも、「デスティニー」「ジャスティス」という味方がついているからな！
$LINE_3_10_INTRO_300_CHAR	$BER
$LINE_3_10_INTRO_300_TEXT	あと、「サンダー」「ライトニング」「カルネージ」「ケイオス」「ビクトリー」そして、「デストロイヤー」もな。
$LINE_3_10_INTRO_310_CHAR	$RAN
$LINE_3_10_INTRO_310_TEXT	・・・。
$LINE_3_10_INTRO_320_CHAR	$BER
$LINE_3_10_INTRO_320_TEXT	あ、これ俺の腹筋たちの名前ね。
$LINE_3_10_INTRO_330_CHAR	$BER
$LINE_3_10_INTRO_330_TEXT	なんだって？大殿筋はどうかって？
$LINE_3_10_INTRO_340_CHAR	$RAN
$LINE_3_10_INTRO_340_TEXT	いや、聞いてないって。
$LINE_3_10_INTRO_350_CHAR	$BER
$LINE_3_10_INTRO_350_TEXT	心配すんな！<N>シリーンとケッツがサボることはねえ！
$LINE_3_10_INTRO_360_CHAR	$RAN
$LINE_3_10_INTRO_360_TEXT	ケッツってお前・・・お尻に名前を付けているのか？
$LINE_3_10_INTRO_370_CHAR	$BER
$LINE_3_10_INTRO_370_TEXT	尻というよりは片ケツにな。
$LINE_3_10_INTRO_380_CHAR	$BER
$LINE_3_10_INTRO_380_TEXT	しかし、ケツの下にあるのは何て言やぁいいんだ？<N>これって、上の筋肉とは別？もしそうだったら、名前をつけなきゃいかんが・・・うーん、わからん・・・感触でいうと・・・
$LINE_3_10_INTRO_390_CHAR	$RAN
$LINE_3_10_INTRO_390_TEXT	おお、レブナントが来た！ああ、助かった。
$SCENE_3_10_OUTRO_TITLE	十分にタメて
$LINE_3_10_OUTRO_00_CHAR	$MCG
$LINE_3_10_OUTRO_00_TEXT	さっきのが最後の一体だったね。
$LINE_3_10_OUTRO_10_CHAR	$HEA
$LINE_3_10_OUTRO_10_TEXT	この記録・・・
$LINE_3_10_OUTRO_20_CHAR	$HEA
$LINE_3_10_OUTRO_20_TEXT	*$MCG、君の家は、どれくらいの間、王室図書館に勤めてきた？
$LINE_3_10_OUTRO_30_CHAR	$MCG
$LINE_3_10_OUTRO_30_TEXT	・・・小さい頃、図書館で働いているおじいさんに会った記憶がある。
$LINE_3_10_OUTRO_40_CHAR	$MCG
$LINE_3_10_OUTRO_40_TEXT	私が知っている限り、家族はずっと図書館に勤めています。
$LINE_3_10_OUTRO_50_CHAR	$MCG
$LINE_3_10_OUTRO_50_TEXT	私の名字は、「図書館の」という意味ですから。
$LINE_3_10_OUTRO_60_CHAR	$HEA
$LINE_3_10_OUTRO_60_TEXT	この話からすると、あの兵士が――
$LINE_3_10_OUTRO_70_CHAR	$BER
$LINE_3_10_OUTRO_70_TEXT	おい、これ、見ろよ！
$LINE_3_10_OUTRO_80_CHAR	$HEA
$LINE_3_10_OUTRO_80_TEXT	奈落の地図ですね！・・・おや、それは――？
$LINE_3_10_OUTRO_90_CHAR	$BER
$LINE_3_10_OUTRO_90_TEXT	おい、せっかく解説しているのに結論を言っちゃうなよ！
$LINE_3_10_OUTRO_100_CHAR	$BER
$LINE_3_10_OUTRO_100_TEXT	アンタが口を挟む前に言ったぜ、これは奈落の地図だ。で、よく見ろ。
$LINE_3_10_OUTRO_110_CHAR	$BER
$LINE_3_10_OUTRO_110_TEXT	・・・十分にタメて・・・
$LINE_3_10_OUTRO_120_CHAR	$BER
$LINE_3_10_OUTRO_120_TEXT	出口だ！
$SCENE_3_11_INTRO_TITLE	ゼレミア出現
$LINE_3_11_INTRO_00_CHAR	$HEA
$LINE_3_11_INTRO_00_TEXT	*$MCG、わかりませんか？あなたこそが―
$LINE_3_11_INTRO_10_CHAR	ゼレミア
$LINE_3_11_INTRO_10_TEXT	パズルの最後のピースだ。
$LINE_3_11_INTRO_20_CHAR	ゼレミア
$LINE_3_11_INTRO_20_TEXT	一兵士の自己犠牲が、世界を救ったのだ。王室は、彼の子孫に恩賞を与えた。<N>宮殿において名誉ある地位を与えたのだ。
$LINE_3_11_INTRO_30_CHAR	ゼレミア
$LINE_3_11_INTRO_30_TEXT	その末裔がこの娘だ。
$LINE_3_11_INTRO_40_CHAR	$MCG
$LINE_3_11_INTRO_40_TEXT	私が、最後の封印？
$LINE_3_11_INTRO_50_CHAR	ゼレミア
$LINE_3_11_INTRO_50_TEXT	そう、封印の血を持つ者だ。他の2つは、すでに解かれた。
$LINE_3_11_INTRO_60_CHAR	$MCG
$LINE_3_11_INTRO_60_TEXT	あなたが解いたのでしょう・・・！
$LINE_3_11_INTRO_70_CHAR	ゼレミア
$LINE_3_11_INTRO_70_TEXT	そうだ。そして今、この過ちを取り返さねばならない。
$LINE_3_11_INTRO_80_CHAR	ゼレミア
$LINE_3_11_INTRO_80_TEXT	ヤツにとって邪魔なのは、お前なのだ。
$LINE_3_11_INTRO_90_CHAR	ゼレミア
$LINE_3_11_INTRO_90_TEXT	ヤツはまだ実力の半分も出せないのに、このありさまだ。<N>完全に解き放たれたらどうなるか、想像にも及ぶまい。
$LINE_3_11_INTRO_100_CHAR	ゼレミア
$LINE_3_11_INTRO_100_TEXT	ヤツがお前の血をたった一滴でも手に入れれば、自由になってしまう。
$LINE_3_11_INTRO_110_CHAR	$MCG
$LINE_3_11_INTRO_110_TEXT	ヤツ？
$LINE_3_11_INTRO_120_CHAR	$MCG
$LINE_3_11_INTRO_120_TEXT	もしかして、エズティル・テノクのこと？
$LINE_3_11_INTRO_130_CHAR	ゼレミア
$LINE_3_11_INTRO_130_TEXT	まだわかっていないようだな。<N>観念的な力の源について話してるんじゃない。
$LINE_3_11_INTRO_140_CHAR	ゼレミア
$LINE_3_11_INTRO_140_TEXT	ヤツは実体を持っている。知能もある。私やお前と同じように、実際に存在しているんだ。そして、とてつもなく、危険だ。
$LINE_3_11_INTRO_150_CHAR	ゼレミア
$LINE_3_11_INTRO_150_TEXT	我々は――私は、パワーのおこぼれを授かるかわりに、部分的に解放してしまった。
$LINE_3_11_INTRO_160_CHAR	ゼレミア
$LINE_3_11_INTRO_160_TEXT	ヤツは、今の拘束状態に満足していない。お前を追っている。今も手下がお前の血を求めて砂漠をうろついている。
$LINE_3_11_INTRO_170_CHAR	ゼレミア
$LINE_3_11_INTRO_170_TEXT	安全な道はただ一つ。
$LINE_3_11_INTRO_180_CHAR	ゼレミア
$LINE_3_11_INTRO_180_TEXT	お前が死ぬことだ。
$LINE_3_11_INTRO_190_CHAR	$MCG
$LINE_3_11_INTRO_190_TEXT	狂気は、時に、抑えが利かないものよ・・・。
$LINE_3_11_INTRO_200_CHAR	$MCG
$LINE_3_11_INTRO_200_TEXT	力を追い求めることしか、考えられなくなる。
$LINE_3_11_INTRO_210_CHAR	$MCG
$LINE_3_11_INTRO_210_TEXT	封印を弱めて、あなたは死人を操れるようになった。
$LINE_3_11_INTRO_220_CHAR	$MCG
$LINE_3_11_INTRO_220_TEXT	今度は封印を完全に解いて、もっと強い力を手に入れるつもりでしょう。
$LINE_3_11_INTRO_230_CHAR	ゼレミア
$LINE_3_11_INTRO_230_TEXT	私が自分のためにやっていると？<N>どうやって証明すれば・・・いや。
$LINE_3_11_INTRO_240_CHAR	ゼレミア
$LINE_3_11_INTRO_240_TEXT	どう思おうとも関係のないことだ。お前は死なねばならない。
$LINE_3_11_INTRO_250_CHAR	ゼレミア
$LINE_3_11_INTRO_250_TEXT	・・・友よ。君なら理解してくれると思ったが。
$LINE_3_11_INTRO_260_CHAR	$HEA
$LINE_3_11_INTRO_260_TEXT	理解できんな。
$LINE_3_11_INTRO_270_CHAR	$HEA
$LINE_3_11_INTRO_270_TEXT	もう、罪なき人を殺させはしない。
$LINE_3_11_INTRO_280_CHAR	ゼレミア
$LINE_3_11_INTRO_280_TEXT	世界が焼失するのだぞ！<N>そんなことに縛られている場合か！
$LINE_3_11_INTRO_290_CHAR	ゼレミア
$LINE_3_11_INTRO_290_TEXT	レブナントよ！ヤツらを殺せ！
$SCENE_3_11_OUTRO_TITLE	序の口
$LINE_3_11_OUTRO_00_CHAR	$MCG
$LINE_3_11_OUTRO_00_TEXT	思っていたより、楽勝だったね。
$LINE_3_11_OUTRO_10_CHAR	$HEA
$LINE_3_11_OUTRO_10_TEXT	これはまだ序の口に過ぎません。
$LINE_3_11_OUTRO_20_CHAR	$HEA
$LINE_3_11_OUTRO_20_TEXT	全面戦争を起こすのは危険です。特に、全軍を率いているゼレミアとは。
$LINE_3_11_OUTRO_30_CHAR	$HEA
$LINE_3_11_OUTRO_30_TEXT	抜け道として使える下水道があります。
$LINE_3_11_OUTRO_40_CHAR	$HEA
$LINE_3_11_OUTRO_40_TEXT	敵が再び集まる前に、早く逃げ出しましょう！
$LINE_3_11_OUTRO_50_CHAR	$MCG
$LINE_3_11_OUTRO_50_TEXT	まあ、下水道ですって。
$LINE_3_11_OUTRO_60_CHAR	$MCG
$LINE_3_11_OUTRO_60_TEXT	文明の利器もなく、ここまでやってきたのだから、皆もう忘れたかもしれないけど・・・
$LINE_3_11_OUTRO_70_CHAR	$MCG
$LINE_3_11_OUTRO_70_TEXT	下水道って、なにげに下水があふれているのよね、実は。
$LINE_3_11_OUTRO_80_CHAR	$MCG
$LINE_3_11_OUTRO_80_TEXT	ほら、下水道には下水って言葉が入ってるでしょう？
$LINE_3_11_OUTRO_90_CHAR	$MCG
$LINE_3_11_OUTRO_90_TEXT	ビックリな話でしょ？でも大丈夫、私を信じて。私は図書館司書。一日中、言葉にどっぷり浸かって働いてるのよ。
$LINE_3_11_OUTRO_100_CHAR	$MCG
$LINE_3_11_OUTRO_100_TEXT	・・・でも、そんな私が滅亡した文明の汚い落としものにどっぷり浸かるなんて。
$LINE_3_11_OUTRO_110_CHAR	$MCG
$LINE_3_11_OUTRO_110_TEXT	できればそんなの、ずっと浸かりたくなかったけど。
$LINE_3_11_OUTRO_120_CHAR	$MCG
$LINE_3_11_OUTRO_120_TEXT	でもね、私の話を聞いてくれるあなたのために、そういう意地は捨てようって思ったのよ。
$LINE_3_11_OUTRO_130_CHAR	$MCG
$LINE_3_11_OUTRO_130_TEXT	誰も聞いてないけどね。
$LINE_3_11_OUTRO_140_CHAR	$MCG
$LINE_3_11_OUTRO_140_TEXT	・・・
$LINE_3_11_OUTRO_150_CHAR	$MCG
$LINE_3_11_OUTRO_150_TEXT	*構わないわ。$MCG、私が聞いてるよ。あなたの考えに100%賛成！
$LINE_3_11_OUTRO_160_CHAR	$MCG
$LINE_3_11_OUTRO_160_TEXT	*ありがとう、$MCG、誰かが私の意見を気にかけてくれているなんて、嬉しいな。
$LINE_3_11_OUTRO_170_CHAR	$MCG
$LINE_3_11_OUTRO_170_TEXT	お互いに助け合いましょう！私たちは、ここで唯一まともな精神を保っている人間なんだから。
$LINE_3_11_OUTRO_180_CHAR	$MCG
$LINE_3_11_OUTRO_180_TEXT	ありがとう。話し相手がいて、うれしいわ。
$LINE_3_11_OUTRO_190_CHAR	$KNI
$LINE_3_11_OUTRO_190_TEXT	・・・あ。ゴホン。
$LINE_3_11_OUTRO_200_CHAR	$MCG
$LINE_3_11_OUTRO_200_TEXT	*あらっ、こんなところに！$KNI！
$LINE_3_11_OUTRO_210_CHAR	$MCG
$LINE_3_11_OUTRO_210_TEXT	いつから、いたの？
$LINE_3_11_OUTRO_220_CHAR	$KNI
$LINE_3_11_OUTRO_220_TEXT	・・・あなたが話している間、ずっと。
$LINE_3_11_OUTRO_230_CHAR	$MCG
$LINE_3_11_OUTRO_230_TEXT	えっと、今のは・・・私・・・
$LINE_3_11_OUTRO_240_CHAR	$MCG
$LINE_3_11_OUTRO_240_TEXT	残りの人生は、穴に隠れて過ごします！じゃあね！
$LINE_3_11_OUTRO_250_CHAR	$KNI
$LINE_3_11_OUTRO_250_TEXT	いつも、変な女と関わり合いになる。なぜ？なぜ、私にばかり？
$LINE_3_11_OUTRO_260_CHAR	$KNI
$LINE_3_11_OUTRO_260_TEXT	次は、「助けてくれてありがとう」くらいにしとこう。忠誠を誓う前に――完全にイッちゃっている人でないか確認しないと。
$LINE_3_11_OUTRO_270_CHAR	$BER
$LINE_3_11_OUTRO_270_TEXT	おい！何を独り言を言ってるんだ、この変人！
$SCENE_3_12_INTRO_TITLE	脱出用トンネル
$LINE_3_12_INTRO_00_CHAR	$RAN
$LINE_3_12_INTRO_00_TEXT	下水道の中に脱出口があるのか？
$LINE_3_12_INTRO_10_CHAR	$RAN
$LINE_3_12_INTRO_10_TEXT	まったく、こんな都市計画をしたのは、どこのどいつだ。
$LINE_3_12_INTRO_20_CHAR	$HEA
$LINE_3_12_INTRO_20_TEXT	この道は、鉱山に続いている。ここからなら―
$LINE_3_12_INTRO_30_CHAR	ゼレミア
$LINE_3_12_INTRO_30_TEXT	私から逃げられる、本気でそう思ったのか？
$LINE_3_12_INTRO_40_CHAR	ゼレミア
$LINE_3_12_INTRO_40_TEXT	この町の秘密を知っているのは、お前一人ではないんだぞ。
$LINE_3_12_INTRO_50_CHAR	ゼレミア
$LINE_3_12_INTRO_50_TEXT	我が人民を守るためなら、私はどんなことでもするつもりだということを、よく覚えておけ。
$LINE_3_12_INTRO_60_CHAR	$HEA
$LINE_3_12_INTRO_60_TEXT	王子よ、我らが血の封印を解いた時のようにか？
$LINE_3_12_INTRO_70_CHAR	ゼレミア
$LINE_3_12_INTRO_70_TEXT	我らは滅亡の危機に瀕していたのだ。<N>クウェイド帝国は、我々を抹殺する気でいた。
$LINE_3_12_INTRO_80_CHAR	ゼレミア
$LINE_3_12_INTRO_80_TEXT	王国の東側がどれほど荒廃したか、忘れたのか？
$LINE_3_12_INTRO_90_CHAR	ゼレミア
$LINE_3_12_INTRO_90_TEXT	まるで海のように、我が人民から血が流された。<N>その時、私は誓ったのだ。アッシュ王国を荒廃から救うためならば、何だってやると。
$LINE_3_12_INTRO_100_CHAR	ゼレミア
$LINE_3_12_INTRO_100_TEXT	この誓いを破るつもりはない。
$LINE_3_12_INTRO_110_CHAR	$HEA
$LINE_3_12_INTRO_110_TEXT	それで、貴様はこの娘を殺すのか？
$LINE_3_12_INTRO_120_CHAR	$HEA
$LINE_3_12_INTRO_120_TEXT	それに、死病が本当に闇の知性の仕業だとしても、やつの唯一の逃げ道を奪ったあとはどうする気だ？
$LINE_3_12_INTRO_130_CHAR	$HEA
$LINE_3_12_INTRO_130_TEXT	あの者が死にもの狂いになったらどうなる？
$LINE_3_12_INTRO_140_CHAR	ゼレミア
$LINE_3_12_INTRO_140_TEXT	当然、想定しているさ。必要になれば手は打つ。
$LINE_3_12_INTRO_150_CHAR	ゼレミア
$LINE_3_12_INTRO_150_TEXT	しかし、まずやるべきことは彼女を葬ることだ。
$SCENE_3_12_OUTRO_TITLE	数多の死人の泣き声
$LINE_3_12_OUTRO_00_CHAR	$HEA
$LINE_3_12_OUTRO_00_TEXT	どうにか食い止められている今のうちに、早く逃げましょう！
$LINE_3_12_OUTRO_10_CHAR	$MAG
$LINE_3_12_OUTRO_10_TEXT	ゼレミアを！
$LINE_3_12_OUTRO_20_CHAR	$HEA
$LINE_3_12_OUTRO_20_TEXT	彼は、必要だと思う決断をしました。
$LINE_3_12_OUTRO_30_CHAR	$MAG
$LINE_3_12_OUTRO_30_TEXT	死に値する決断です。
$LINE_3_12_OUTRO_40_CHAR	$HEA
$LINE_3_12_OUTRO_40_TEXT	*$MAGよ、今は復讐の出る幕ではない。
$LINE_3_12_OUTRO_50_CHAR	$MAG
$LINE_3_12_OUTRO_50_TEXT	復讐ではありません。これは正義です。名誉なのです。
$LINE_3_12_OUTRO_60_CHAR	$MAG
$LINE_3_12_OUTRO_60_TEXT	帝国に対する罪を、見過ごすわけには！
$LINE_3_12_OUTRO_70_CHAR	$MAG
$LINE_3_12_OUTRO_70_TEXT	ゼレミアの血なくして、天の火の神に対面することなど！
$LINE_3_12_OUTRO_80_CHAR	$MAG
$LINE_3_12_OUTRO_80_TEXT	失われた数百万もの命が、それを求めているのです！
$LINE_3_12_OUTRO_90_CHAR	$HEA
$LINE_3_12_OUTRO_90_TEXT	ならば、正義は明日のためにとっておきなさい。
$LINE_3_12_OUTRO_100_CHAR	$HEA
$LINE_3_12_OUTRO_100_TEXT	逃げられるうちに逃げるのです！
$LINE_3_12_OUTRO_110_CHAR	$KNI
$LINE_3_12_OUTRO_110_TEXT	お嬢様。
$LINE_3_12_OUTRO_120_CHAR	$MCG
$LINE_3_12_OUTRO_120_TEXT	どうしたの？
$LINE_3_12_OUTRO_130_CHAR	$KNI
$LINE_3_12_OUTRO_130_TEXT	敵に囲まれそうです・・・。
$LINE_3_12_OUTRO_140_CHAR	$KNI
$LINE_3_12_OUTRO_140_TEXT	役に立つかはわかりませんが・・・こんな話があります。
$LINE_3_12_OUTRO_150_CHAR	$KNI
$LINE_3_12_OUTRO_150_TEXT	昔お会いした聡明な剣士が、こう言いました。
$LINE_3_12_OUTRO_160_CHAR	$KNI
$LINE_3_12_OUTRO_160_TEXT	肉体の強さではなく、精神の強さで斬れ。<N>心と体を一つにすれば、どんな敵も退けることができる。
$LINE_3_12_OUTRO_170_CHAR	$KNI
$LINE_3_12_OUTRO_170_TEXT	理解するまでに、何年もかかりました。
$LINE_3_12_OUTRO_180_CHAR	$KNI
$LINE_3_12_OUTRO_180_TEXT	彼が言おうとしたのは、おそらく――
$LINE_3_12_OUTRO_190_CHAR	$MCG
$LINE_3_12_OUTRO_190_TEXT	待って。精神の強さ・・・敵を退ける・・・
$LINE_3_12_OUTRO_200_CHAR	$MCG
$LINE_3_12_OUTRO_200_TEXT	わかったわ！
$LINE_3_12_OUTRO_210_CHAR	$KNI
$LINE_3_12_OUTRO_210_TEXT	何たるスピード。私は3年掛ったのに。
$LINE_3_12_OUTRO_220_CHAR	$KNI
$LINE_3_12_OUTRO_220_TEXT	正直・・・今、あなたがちょっとムカつく。
$SCENE_3_13_INTRO_TITLE	決死の脱出
$LINE_3_13_INTRO_00_CHAR	$RAN
$LINE_3_13_INTRO_00_TEXT	ちょっと待って。脱出路は危険を逃れるためのものでしょ。それが爆弾だらけだというの？
$LINE_3_13_INTRO_10_CHAR	$RAN
$LINE_3_13_INTRO_10_TEXT	いったいどんなやつがこんな町を考えたんだ！
$LINE_3_13_INTRO_20_CHAR	$RAN
$LINE_3_13_INTRO_20_TEXT	そいつの住所が知りたいもんだよ。<N>見つけたら、ぶっ飛ばしてやるのに。
$LINE_3_13_INTRO_30_CHAR	$BER
$LINE_3_13_INTRO_30_TEXT	そうかな。俺は、最高に面白い町だと思ったけどな。
$LINE_3_13_INTRO_40_CHAR	$RAN
$LINE_3_13_INTRO_40_TEXT	考えてもみろよ。ゾンビをひっ連れた殺りく狂が、私たちを殺そうとやっきになって追ってくる。
$LINE_3_13_INTRO_50_CHAR	$RAN
$LINE_3_13_INTRO_50_TEXT	そんなときに、まわりは爆弾だらけ！
$LINE_3_13_INTRO_60_CHAR	$HEA
$LINE_3_13_INTRO_60_TEXT	これは、私たちが姿を消すのに絶好の手段です。
$LINE_3_13_INTRO_70_CHAR	$RAN
$LINE_3_13_INTRO_70_TEXT	なんて恐ろしい響き。文字通りの意味じゃないことを願います。
$LINE_3_13_INTRO_80_CHAR	$HEA
$LINE_3_13_INTRO_80_TEXT	時間を稼いでください。その間に、私が鉱山全体を連鎖爆発させます。
$LINE_3_13_INTRO_90_CHAR	$HEA
$LINE_3_13_INTRO_90_TEXT	ゼレミアが私たちを追って出てくる前に下水道は崩れ、彼は下敷きになるでしょう。
$SCENE_3_13_OUTRO_TITLE	さらなる強敵
$NARR_3_13_OUTRO_00_TEXT	ACT VI
$NARR_3_13_OUTRO_00_SUB_TEXT	*心の中、栄光と高慢は、似て非なるものである。<N>前者は、世に貢献できたことの正当なる喜び。<N>後者は、天なる火の誉を我が物とせんこと、破滅への道なり。
$NARR_3_13_OUTRO_00_SUB_SUB_TEXT	*$N$N$N$N$N$N$N-隠遁者ラワクランの書籍集
$LINE_3_13_OUTRO_00_CHAR	$MAG
$LINE_3_13_OUTRO_00_TEXT	ついに倒しましたね。
$LINE_3_13_OUTRO_10_CHAR	$HEA
$LINE_3_13_OUTRO_10_TEXT	ええ。
$LINE_3_13_OUTRO_20_CHAR	$HEA
$LINE_3_13_OUTRO_20_TEXT	そうだといいのだが。・・・旧友に願うには、妙な願いだが。
$LINE_3_13_OUTRO_30_CHAR	$HEA
$LINE_3_13_OUTRO_30_TEXT	生きている間に味わえなかった安らぎを、<N>どうかあの世で得られんことを。
$LINE_3_13_OUTRO_40_CHAR	$MAG
$LINE_3_13_OUTRO_40_TEXT	あの殺人鬼の死をいたむのですか？悪魔と誓いを交わしたやつなのに？
$LINE_3_13_OUTRO_50_CHAR	$HEA
$LINE_3_13_OUTRO_50_TEXT	私にとっては、兄弟のような存在だった。昔の話だが。
$LINE_3_13_OUTRO_60_CHAR	$MAG
$LINE_3_13_OUTRO_60_TEXT	しかし今は、敵です。
$LINE_3_13_OUTRO_70_CHAR	$MAG
$LINE_3_13_OUTRO_70_TEXT	自業自得でしょう。
$LINE_3_13_OUTRO_80_CHAR	$MAG
$LINE_3_13_OUTRO_80_TEXT	我らは敵を倒したのです。
$LINE_3_13_OUTRO_90_CHAR	$MAG
$LINE_3_13_OUTRO_90_TEXT	どうかその死体が、地下で朽ち果てますように。
$LINE_3_13_OUTRO_100_CHAR	$HEA
$LINE_3_13_OUTRO_100_TEXT	一時の安堵に酔いしれてはならん。
$LINE_3_13_OUTRO_110_CHAR	$HEA
$LINE_3_13_OUTRO_110_TEXT	奈落には、まだまだ多くの危険がある。必要以上に、ここに留まってはいけない。
$LINE_3_13_OUTRO_120_CHAR	$MAG
$LINE_3_13_OUTRO_120_TEXT	勝って兜の緒を締めよ、ということですね。
$LINE_3_13_OUTRO_130_CHAR	$MCG
$LINE_3_13_OUTRO_130_TEXT	彼が言っていたことは本当でしょうか？
$LINE_3_13_OUTRO_140_CHAR	$HEA
$LINE_3_13_OUTRO_140_TEXT	*$MCG、それを確かめる術はありませんよ。<N>ゼレミアは・・・死を迎える前に、正気を失ってしまいましたから。
$LINE_3_13_OUTRO_150_CHAR	$MCG
$LINE_3_13_OUTRO_150_TEXT	でも、もし本当で・・・私の血が彼を解放してしまうのなら――
$LINE_3_13_OUTRO_160_CHAR	$HEA
$LINE_3_13_OUTRO_160_TEXT	どうする？自殺でもされるおつもりか？
$LINE_3_13_OUTRO_170_CHAR	$MCG
$LINE_3_13_OUTRO_170_TEXT	それで世界が平和になるのなら・・・そうしないのは、私のわがままでは・・・。
$LINE_3_13_OUTRO_180_CHAR	$HEA
$LINE_3_13_OUTRO_180_TEXT	血の封印が本当ならば、奈落であなたの血を流すことは最も避けるべきことです。
$LINE_3_13_OUTRO_190_CHAR	$HEA
$LINE_3_13_OUTRO_190_TEXT	ゼレミアは、手下があなたを探していると言っていた。
$LINE_3_13_OUTRO_200_CHAR	$HEA
$LINE_3_13_OUTRO_200_TEXT	たとえあなたが死んだとしても、彼らはその血を追い続けるだろう。
$LINE_3_13_OUTRO_210_CHAR	$MCG
$LINE_3_13_OUTRO_210_TEXT	そうだとは思うけど、でも、私が存在していて、いいのでしょうか。
$LINE_3_13_OUTRO_220_CHAR	$HEA
$LINE_3_13_OUTRO_220_TEXT	あなたが誰かのために生きているのなら。
$LINE_3_13_OUTRO_230_CHAR	$HEA
$LINE_3_13_OUTRO_230_TEXT	あなたがいなければ、ここにいる皆、捕らわれたままか、死んでいたのですよ。
$LINE_3_13_OUTRO_240_CHAR	$HEA
$LINE_3_13_OUTRO_240_TEXT	彼らは、あなたを必要としている。私もあなたを必要としている。
$LINE_3_13_OUTRO_250_CHAR	$MCG
$LINE_3_13_OUTRO_250_TEXT	・・・ありがとう。
$LINE_3_13_OUTRO_260_CHAR	$MCG
$LINE_3_13_OUTRO_260_TEXT	・・・手下が探しているって言っていたけど、何者なのかしら。
$LINE_3_13_OUTRO_270_CHAR	$HEA
$LINE_3_13_OUTRO_270_TEXT	わからない・・・。
$LINE_3_13_OUTRO_280_CHAR	$HEA
$LINE_3_13_OUTRO_280_TEXT	・・・しかし、じきにわかるでしょうね。
$SCENE_GHOST_TOWN_INTRO_TITLE	ゴーストタウン
$LINE_GHOST_TOWN_INTRO_00_CHAR	村人
$LINE_GHOST_TOWN_INTRO_00_TEXT	ようこそ。私たちの・・・町へ。
$LINE_GHOST_TOWN_INTRO_10_CHAR	$MCG
$LINE_GHOST_TOWN_INTRO_10_TEXT	みんな、どこへ行ったの？
$LINE_GHOST_TOWN_INTRO_20_CHAR	村人
$LINE_GHOST_TOWN_INTRO_20_TEXT	・・・死んだか・・・変身させられた・・・。
$LINE_GHOST_TOWN_INTRO_30_CHAR	村人
$LINE_GHOST_TOWN_INTRO_30_TEXT	それでも私たちは・・・水晶を掘り続けている・・・<N>今までずっとそうしてきたように・・・。
$LINE_GHOST_TOWN_INTRO_40_CHAR	$MCG
$LINE_GHOST_TOWN_INTRO_40_TEXT	あのクリスタルのこと？
$LINE_GHOST_TOWN_INTRO_50_CHAR	村人
$LINE_GHOST_TOWN_INTRO_50_TEXT	・・・帝国の・・・栄光は・・・<N>我々の双肩にかかっている・・・。
$LINE_GHOST_TOWN_INTRO_60_CHAR	村人
$LINE_GHOST_TOWN_INTRO_60_TEXT	・・・ブラッドマッドの脅威にさらされても・・・<N>私たちは・・・奉仕し続けます・・・。
$SCENE_4_1_INTRO_TITLE	温かな歓迎
$LINE_4_1_INTRO_00_CHAR	巡礼者
$LINE_4_1_INTRO_00_TEXT	私たちの村へようこそ！
$LINE_4_1_INTRO_10_CHAR	巡礼者
$LINE_4_1_INTRO_10_TEXT	砂漠で他の巡礼者にお会いできるのはいつでもうれしいことです。
$LINE_4_1_INTRO_20_CHAR	$MCG
$LINE_4_1_INTRO_20_TEXT	どちらへ行かれるのですか？
$LINE_4_1_INTRO_30_CHAR	巡礼者
$LINE_4_1_INTRO_30_TEXT	ほう、どちらへ行かれる、と。
$LINE_4_1_INTRO_40_CHAR	巡礼者
$LINE_4_1_INTRO_40_TEXT	偉大なる石の元へですよ。捧げものを持ってね。
$LINE_4_1_INTRO_50_CHAR	$RAN
$LINE_4_1_INTRO_50_TEXT	*$MCG、ここを去りましょう。今すぐに。
$LINE_4_1_INTRO_60_CHAR	巡礼者
$LINE_4_1_INTRO_60_TEXT	*$MCG、と言いましたか？
$LINE_4_1_INTRO_70_CHAR	巡礼者
$LINE_4_1_INTRO_70_TEXT	ああ、どうして気づかなかったのだろう。
$LINE_4_1_INTRO_80_CHAR	ブラッドマッド教信者
$LINE_4_1_INTRO_80_TEXT	血・・・彼女の血を！
$LINE_4_1_INTRO_90_CHAR	ブラッドマッド教信者
$LINE_4_1_INTRO_90_TEXT	主の熱意が体の中に満ちてくる！
$LINE_4_1_INTRO_100_CHAR	ブラッドマッド教信者
$LINE_4_1_INTRO_100_TEXT	主よ、あなたの意思に従いましょう！<N>偉大な石のために！
$SCENE_4_1_OUTRO_TITLE	意を決する時
$LINE_4_1_OUTRO_00_CHAR	$MCG
$LINE_4_1_OUTRO_00_TEXT	あれは、一体、何？
$LINE_4_1_OUTRO_10_CHAR	$MCG
$LINE_4_1_OUTRO_10_TEXT	自らレブナントに変身したの？
$LINE_4_1_OUTRO_20_CHAR	$MCG
$LINE_4_1_OUTRO_20_TEXT	今までとは違う・・・彼らを動かしている力が・・・違ったみたい。
$LINE_4_1_OUTRO_30_CHAR	$RAN
$LINE_4_1_OUTRO_30_TEXT	この仮面、見たことあるな・・・。
$LINE_4_1_OUTRO_40_CHAR	$RAN
$LINE_4_1_OUTRO_40_TEXT	血に彩られ、水晶の粒が埋め込まれている・・・。
$LINE_4_1_OUTRO_50_CHAR	$RAN
$LINE_4_1_OUTRO_50_TEXT	これは、ブラッドマッド教のものだよ。<N>極東の呪われた民族だ。
$LINE_4_1_OUTRO_60_CHAR	$RAN
$LINE_4_1_OUTRO_60_TEXT	*君がいてくれて、良かったよ。$MCG。
$LINE_4_1_OUTRO_70_CHAR	$RAN
$LINE_4_1_OUTRO_70_TEXT	私たち全員、あいつらの生贄にされていたところだ。
$LINE_4_1_OUTRO_80_CHAR	$MCG
$LINE_4_1_OUTRO_80_TEXT	・・・エズティル・テノクの手下ね。
$LINE_4_1_OUTRO_90_CHAR	$MCG
$LINE_4_1_OUTRO_90_TEXT	ゼレミアが言ったことは本当だったんだ。
$LINE_4_1_OUTRO_100_CHAR	$RAN
$LINE_4_1_OUTRO_100_TEXT	あいつらは、東の砂漠を荒らしている・・・いつも、旅人を狙うんだ。
$LINE_4_1_OUTRO_110_CHAR	$RAN
$LINE_4_1_OUTRO_110_TEXT	・・・でも、奈落の谷であいつらに会うとは思わなかったな。
$LINE_4_1_OUTRO_120_CHAR	$HEA
$LINE_4_1_OUTRO_120_TEXT	彼らは我々を追い掛けています。
$LINE_4_1_OUTRO_130_CHAR	$HEA
$LINE_4_1_OUTRO_130_TEXT	私たちに残された選択肢は、出口を探すことです。
$LINE_4_1_OUTRO_140_CHAR	$MCG
$LINE_4_1_OUTRO_140_TEXT	その後はどうするの？
$LINE_4_1_OUTRO_150_CHAR	$HEA
$LINE_4_1_OUTRO_150_TEXT	それは、その時、考えましょう。
$LINE_4_1_OUTRO_160_CHAR	$HEA
$LINE_4_1_OUTRO_160_TEXT	今大事なことは、あなたをヤツらの手に届かぬ場所まで逃がすことです。
$LINE_4_1_OUTRO_170_CHAR	$MCG
$LINE_4_1_OUTRO_170_TEXT	届かない場所・・・。
$LINE_4_1_OUTRO_180_CHAR	$HEA
$LINE_4_1_OUTRO_180_TEXT	すべてが真実ならば、いずれ、私たちはゼレミアよりも大きな力に直面するでしょう。
$LINE_4_1_OUTRO_190_CHAR	$HEA
$LINE_4_1_OUTRO_190_TEXT	意を決する時ですよ。<N>私たちが旅を続けているこの瞬間にも、敵は強くなっています。
$SCENE_4_2_INTRO_TITLE	ウィザードの領域
$LINE_4_2_INTRO_00_CHAR	$MCG
$LINE_4_2_INTRO_00_TEXT	ここはどこ？　クウェイドの町？
$LINE_4_2_INTRO_10_CHAR	$MAG
$LINE_4_2_INTRO_10_TEXT	いえ、クウェイドの建築ではないようです。
$LINE_4_2_INTRO_20_CHAR	$MAG
$LINE_4_2_INTRO_20_TEXT	言語もまったく違う。
$LINE_4_2_INTRO_30_CHAR	$MCG
$LINE_4_2_INTRO_30_TEXT	こんなに・・・古いものを見たのは、初めて。
$LINE_4_2_INTRO_40_CHAR	$MCG
$LINE_4_2_INTRO_40_TEXT	どうして、今まで誰も気づかなかったんだろう？<N>こんな堂々と目に付く場所にあるのに。
$LINE_4_2_INTRO_50_CHAR	$MAG
$LINE_4_2_INTRO_50_TEXT	何年も前にここに来たことがありますが、<N>その時、ここは砂漠でした。こんな遺跡、なかったはずなのに。
$LINE_4_2_INTRO_60_CHAR	$MAG
$LINE_4_2_INTRO_60_TEXT	砂の奥に埋もれていたのかしら。
$LINE_4_2_INTRO_70_CHAR	$MCG
$LINE_4_2_INTRO_70_TEXT	この、引っかき傷。
$LINE_4_2_INTRO_80_CHAR	$MCG
$LINE_4_2_INTRO_80_TEXT	・・・レブナントが掘り返したのかしら？
$LINE_4_2_INTRO_90_CHAR	$MAG
$LINE_4_2_INTRO_90_TEXT	気をつけて！レブナントが棲みついているんだ！
$SCENE_4_2_OUTRO_TITLE	住まいし場所
$LINE_4_2_OUTRO_00_CHAR	$MCG
$LINE_4_2_OUTRO_00_TEXT	この壁に彫られた文字が読めますか？
$LINE_4_2_OUTRO_10_CHAR	$MCG
$LINE_4_2_OUTRO_10_TEXT	もしかしたら、この場所についてわかるかも。
$LINE_4_2_OUTRO_20_CHAR	$HEA
$LINE_4_2_OUTRO_20_TEXT	北方の言語に似ていますが・・・かなり古い言葉ですね。
$LINE_4_2_OUTRO_30_CHAR	$HEA
$LINE_4_2_OUTRO_30_TEXT	少しだけわかる部分もありますね・・・。
$LINE_4_2_OUTRO_40_CHAR	$MCG
$LINE_4_2_OUTRO_40_TEXT	なんて書いてあるのかしら？
$LINE_4_2_OUTRO_50_CHAR	$HEA
$LINE_4_2_OUTRO_50_TEXT	そこに存在する・・・力の源が・・・
$LINE_4_2_OUTRO_60_CHAR	$HEA
$LINE_4_2_OUTRO_60_TEXT	やはり、わからない言葉も多いですね・・・それから・・・
$LINE_4_2_OUTRO_70_CHAR	$HEA
$LINE_4_2_OUTRO_70_TEXT	・・・天から舞い降りた・・・
$LINE_4_2_OUTRO_80_CHAR	$HEA
$LINE_4_2_OUTRO_80_TEXT	エズティル・テノク・・・
$LINE_4_2_OUTRO_90_CHAR	$MCG
$LINE_4_2_OUTRO_90_TEXT	ここがヤツの住みかね。
$LINE_4_2_OUTRO_100_CHAR	$HEA
$LINE_4_2_OUTRO_100_TEXT	慎重に進みましょう。
$LINE_4_2_OUTRO_110_CHAR	$HEA
$LINE_4_2_OUTRO_110_TEXT	まだ、昔の主人に仕えている者がいるかもしれません。
$SCENE_4_3_INTRO_TITLE	神なる王の間
$LINE_4_3_INTRO_00_CHAR	$BER
$LINE_4_3_INTRO_00_TEXT	ここは何だろな？
$LINE_4_3_INTRO_10_CHAR	$MCG
$LINE_4_3_INTRO_10_TEXT	どうやら、王の部屋だったようね。
$LINE_4_3_INTRO_20_CHAR	$BER
$LINE_4_3_INTRO_20_TEXT	誰かが暴れてこの部屋をメチャクチャにしたみたいだな。
$LINE_4_3_INTRO_30_CHAR	$MCG
$LINE_4_3_INTRO_30_TEXT	それから、壁に名前を彫ったのかな・・・。
$LINE_4_3_INTRO_40_CHAR	$BER
$LINE_4_3_INTRO_40_TEXT	王座もーらいッ！
$LINE_4_3_INTRO_50_CHAR	$MCG
$LINE_4_3_INTRO_50_TEXT	これは、古代アッシュ語で書かれてる。
$LINE_4_3_INTRO_60_CHAR	$MCG
$LINE_4_3_INTRO_60_TEXT	・・・ここで、多くの命が・・・一部の人のために・・・
$LINE_4_3_INTRO_70_CHAR	$MCG
$LINE_4_3_INTRO_70_TEXT	悪魔は抑え込まれた・・・生贄によって封印された・・・
$LINE_4_3_INTRO_80_CHAR	$MCG
$LINE_4_3_INTRO_80_TEXT	・・・彼の町は、破壊された・・・
$LINE_4_3_INTRO_90_CHAR	$RAN
$LINE_4_3_INTRO_90_TEXT	*$MCG、私たち、追われてる。
$LINE_4_3_INTRO_100_CHAR	$RAN
$LINE_4_3_INTRO_100_TEXT	どれくらいかわからないけど・・・
$LINE_4_3_INTRO_110_CHAR	$RAN
$LINE_4_3_INTRO_110_TEXT	でも、ものすごい数・・・ホントに大軍だよ。
$LINE_4_3_INTRO_120_CHAR	$MCG
$LINE_4_3_INTRO_120_TEXT	準備はできた。戦いましょう。
$LINE_4_3_INTRO_130_CHAR	ブラッドマッド教信者
$LINE_4_3_INTRO_130_TEXT	声が聞こえないか？
$LINE_4_3_INTRO_140_CHAR	ブラッドマッド教信者
$LINE_4_3_INTRO_140_TEXT	長年の沈黙は破かれた。
$LINE_4_3_INTRO_150_CHAR	ブラッドマッド教信者
$LINE_4_3_INTRO_150_TEXT	主は、我らを偉大なる石へと誘う。
$LINE_4_3_INTRO_160_CHAR	ブラッドマッド教信者
$LINE_4_3_INTRO_160_TEXT	主を解放するのだ。
$LINE_4_3_INTRO_170_CHAR	ブラッドマッド教信者
$LINE_4_3_INTRO_170_TEXT	お前にも主の声が聞こえるようにしてやろう。
$SCENE_4_3_OUTRO_TITLE	ささやく声
$LINE_4_3_OUTRO_00_CHAR	$MCG
$LINE_4_3_OUTRO_00_TEXT	まだいるかな？
$LINE_4_3_OUTRO_10_CHAR	$RAN
$LINE_4_3_OUTRO_10_TEXT	もう安全だと思うよ・・・今のところは。
$LINE_4_3_OUTRO_20_CHAR	$RAN
$LINE_4_3_OUTRO_20_TEXT	ちょっと周囲を調べてくるよ。
$LINE_4_3_OUTRO_30_CHAR	不思議な声
$LINE_4_3_OUTRO_30_TEXT	何年もの間・・・
$LINE_4_3_OUTRO_40_CHAR	$MCG
$LINE_4_3_OUTRO_40_TEXT	この声は！
$LINE_4_3_OUTRO_50_CHAR	エズティル・テノク
$LINE_4_3_OUTRO_50_TEXT	何年もの間、囚われの身だった。連れもなく、自分の心だけが話し相手だった。
$LINE_4_3_OUTRO_60_CHAR	$MCG
$LINE_4_3_OUTRO_60_TEXT	黄金の・・・男・・・。
$LINE_4_3_OUTRO_70_CHAR	エズティル・テノク
$LINE_4_3_OUTRO_70_TEXT	お前には十分な恩賞を与えてやったかもしれないのに・・・お前は神になれたかもしれないのに。
$LINE_4_3_OUTRO_80_CHAR	エズティル・テノク
$LINE_4_3_OUTRO_80_TEXT	しかし、お前は死を選んだ。
$LINE_4_3_OUTRO_90_CHAR	エズティル・テノク
$LINE_4_3_OUTRO_90_TEXT	この世に存在する苦痛の中で最も激しい苦痛を与えてやる。
$LINE_4_3_OUTRO_100_CHAR	$MCG
$LINE_4_3_OUTRO_100_TEXT	近寄らないで！
$LINE_4_3_OUTRO_110_CHAR	$MCG
$LINE_4_3_OUTRO_110_TEXT	頭の中から出てってよ！
$LINE_4_3_OUTRO_120_CHAR	$MCG
$LINE_4_3_OUTRO_120_TEXT	・・・
$LINE_4_3_OUTRO_130_CHAR	$BER
$LINE_4_3_OUTRO_130_TEXT	*おい、大丈夫かよ、$MCG？
$LINE_4_3_OUTRO_140_CHAR	$MCG
$LINE_4_3_OUTRO_140_TEXT	エズティル・テノクが見えたような気がしたの。
$LINE_4_3_OUTRO_150_CHAR	$MCG
$LINE_4_3_OUTRO_150_TEXT	絶対に私たちと戦う気でいるわ・・・。
$LINE_4_3_OUTRO_160_CHAR	$MCG
$LINE_4_3_OUTRO_160_TEXT	だったら、こっちから仕掛けよう。
$LINE_4_3_OUTRO_170_CHAR	$BER
$LINE_4_3_OUTRO_170_TEXT	・・・！
$SCENE_TREASURE_CHAMBER_INTRO_TITLE	真実の愛
$LINE_TREASURE_CHAMBER_INTRO_00_CHAR	$DRA
$LINE_TREASURE_CHAMBER_INTRO_00_TEXT	人間ども・・・近くに何かあるぞ・・・。
$LINE_TREASURE_CHAMBER_INTRO_10_CHAR	$DRA
$LINE_TREASURE_CHAMBER_INTRO_10_TEXT	匂いでわかる。
$LINE_TREASURE_CHAMBER_INTRO_20_CHAR	$MCG
$LINE_TREASURE_CHAMBER_INTRO_20_TEXT	レブナントよ！戦う準備を！
$LINE_TREASURE_CHAMBER_INTRO_30_CHAR	$DRA
$LINE_TREASURE_CHAMBER_INTRO_30_TEXT	いや・・・何か・・・別のものだ・・・。
$LINE_TREASURE_CHAMBER_INTRO_40_CHAR	$MCG
$LINE_TREASURE_CHAMBER_INTRO_40_TEXT	えっ？
$LINE_TREASURE_CHAMBER_INTRO_50_CHAR	$DRA
$LINE_TREASURE_CHAMBER_INTRO_50_TEXT	宝だ！
$LINE_TREASURE_CHAMBER_INTRO_60_CHAR	$BER
$LINE_TREASURE_CHAMBER_INTRO_60_TEXT	おい、見ろよ、すげーぜ！
$LINE_TREASURE_CHAMBER_INTRO_70_CHAR	$DRA
$LINE_TREASURE_CHAMBER_INTRO_70_TEXT	気をつけろ、人間ども。
$LINE_TREASURE_CHAMBER_INTRO_80_CHAR	$BER
$LINE_TREASURE_CHAMBER_INTRO_80_TEXT	ええっ？
$LINE_TREASURE_CHAMBER_INTRO_90_CHAR	$DRA
$LINE_TREASURE_CHAMBER_INTRO_90_TEXT	見つけたのは私だ。全部私のものだぞ。
$LINE_TREASURE_CHAMBER_INTRO_100_CHAR	$BER
$LINE_TREASURE_CHAMBER_INTRO_100_TEXT	でも、お前、武器持てねぇだろ！
$LINE_TREASURE_CHAMBER_INTRO_110_CHAR	$BER
$LINE_TREASURE_CHAMBER_INTRO_110_TEXT	俺たちはもう強い絆で結ばれているんだ！<N>俺はコイツをこう呼ぶ。
$LINE_TREASURE_CHAMBER_INTRO_120_CHAR	$BER
$LINE_TREASURE_CHAMBER_INTRO_120_TEXT	偉大なる骨砕き、はらわたをまき散らす者、肉を切り裂き、たてつくものすべてを去勢し・・・
$LINE_TREASURE_CHAMBER_INTRO_130_CHAR	$BER
$LINE_TREASURE_CHAMBER_INTRO_130_TEXT	数千人もの人の血を飲みし者！
$LINE_TREASURE_CHAMBER_INTRO_140_CHAR	$BER
$LINE_TREASURE_CHAMBER_INTRO_140_TEXT	略して、エブニ。
$LINE_TREASURE_CHAMBER_INTRO_150_CHAR	$BER
$LINE_TREASURE_CHAMBER_INTRO_150_TEXT	俺たちの仲を引き裂かないでくれないか？<N>これは・・・真実の愛なんだ・・・。
$LINE_TREASURE_CHAMBER_INTRO_160_CHAR	$DRA
$LINE_TREASURE_CHAMBER_INTRO_160_TEXT	そうだな・・・正当な金額がもらえれば、譲ってやってもよかろう。
$SCENE_TREASURE_CHAMBER_OUTRO_TITLE	手が届く
$LINE_TREASURE_CHAMBER_OUTRO_00_CHAR	$MCG
$LINE_TREASURE_CHAMBER_OUTRO_00_TEXT	山が見えるわ！もうすぐ出られる！
$LINE_TREASURE_CHAMBER_OUTRO_10_CHAR	$HEA
$LINE_TREASURE_CHAMBER_OUTRO_10_TEXT	*$MCG・・・私はここに残ろうと思う。
$LINE_TREASURE_CHAMBER_OUTRO_20_CHAR	$MCG
$LINE_TREASURE_CHAMBER_OUTRO_20_TEXT	えっ？
$LINE_TREASURE_CHAMBER_OUTRO_30_CHAR	$HEA
$LINE_TREASURE_CHAMBER_OUTRO_30_TEXT	あなたの勝利は、すぐそこです。<N>あとは、私がいなくてもどうにかなるでしょう。
$LINE_TREASURE_CHAMBER_OUTRO_40_CHAR	$HEA
$LINE_TREASURE_CHAMBER_OUTRO_40_TEXT	もともと、この旅を生きて終えるつもりはなかった。
$LINE_TREASURE_CHAMBER_OUTRO_50_CHAR	$HEA
$LINE_TREASURE_CHAMBER_OUTRO_50_TEXT	それに、この堕ちた町は、いい死に場所でしょう。
$LINE_TREASURE_CHAMBER_OUTRO_60_CHAR	$MCG
$LINE_TREASURE_CHAMBER_OUTRO_60_TEXT	ここから私を連れ出してくれるという約束は？
$LINE_TREASURE_CHAMBER_OUTRO_70_CHAR	$HEA
$LINE_TREASURE_CHAMBER_OUTRO_70_TEXT	*$MCG。私の手は、数百万人もの人間の血で汚れています。
$LINE_TREASURE_CHAMBER_OUTRO_80_CHAR	$HEA
$LINE_TREASURE_CHAMBER_OUTRO_80_TEXT	ゼレミアは、その報いを受けた。
$LINE_TREASURE_CHAMBER_OUTRO_90_CHAR	$HEA
$LINE_TREASURE_CHAMBER_OUTRO_90_TEXT	今度は、私が報いを受ける番なのです。
$LINE_TREASURE_CHAMBER_OUTRO_100_CHAR	$MCG
$LINE_TREASURE_CHAMBER_OUTRO_100_TEXT	私は・・・
$LINE_TREASURE_CHAMBER_OUTRO_110_CHAR	$HEA
$LINE_TREASURE_CHAMBER_OUTRO_110_TEXT	これ以上、言うことはありません。行きなさい。
$LINE_TREASURE_CHAMBER_OUTRO_120_CHAR	$MCG
$LINE_TREASURE_CHAMBER_OUTRO_120_TEXT	・・・
$LINE_TREASURE_CHAMBER_OUTRO_130_CHAR	$MAG
$LINE_TREASURE_CHAMBER_OUTRO_130_TEXT	ご老師・・・。
$LINE_TREASURE_CHAMBER_OUTRO_140_CHAR	$HEA
$LINE_TREASURE_CHAMBER_OUTRO_140_TEXT	*$MAG・・・。君は、ゼレミアを殺そうとしていたね。<N>私の手は、やつと同じくらい汚れている。
$LINE_TREASURE_CHAMBER_OUTRO_150_CHAR	$MAG
$LINE_TREASURE_CHAMBER_OUTRO_150_TEXT	知っています・・・。
$LINE_TREASURE_CHAMBER_OUTRO_160_CHAR	$HEA
$LINE_TREASURE_CHAMBER_OUTRO_160_TEXT	では、私をここで死なせてください。
$LINE_TREASURE_CHAMBER_OUTRO_170_CHAR	$MAG
$LINE_TREASURE_CHAMBER_OUTRO_170_TEXT	しかし、あなたは私を救ってくれたただ一人の人です。<N>私は・・・
$LINE_TREASURE_CHAMBER_OUTRO_180_CHAR	$HEA
$LINE_TREASURE_CHAMBER_OUTRO_180_TEXT	*$MAG。私は、君の帝国の民を殺したんだ。
$LINE_TREASURE_CHAMBER_OUTRO_190_CHAR	$HEA
$LINE_TREASURE_CHAMBER_OUTRO_190_TEXT	私に報いを受けさせてくれ。
$LINE_TREASURE_CHAMBER_OUTRO_200_CHAR	$MAG
$LINE_TREASURE_CHAMBER_OUTRO_200_TEXT	いけません。
$LINE_TREASURE_CHAMBER_OUTRO_210_CHAR	$MAG
$LINE_TREASURE_CHAMBER_OUTRO_210_TEXT	あなたの命はあなただけのものじゃない。<N>粗末にしないで！
$LINE_TREASURE_CHAMBER_OUTRO_220_CHAR	$MAG
$LINE_TREASURE_CHAMBER_OUTRO_220_TEXT	私のものでもあるはずです。<N>民の命を奪ったあなたに、自殺する自由などありません！
$LINE_TREASURE_CHAMBER_OUTRO_230_CHAR	$HEA
$LINE_TREASURE_CHAMBER_OUTRO_230_TEXT	そうか。
$LINE_TREASURE_CHAMBER_OUTRO_240_CHAR	$HEA
$LINE_TREASURE_CHAMBER_OUTRO_240_TEXT	では、殺してくれ。それがふさわしい結末だ。
$LINE_TREASURE_CHAMBER_OUTRO_250_CHAR	$MAG
$LINE_TREASURE_CHAMBER_OUTRO_250_TEXT	・・・。
$LINE_TREASURE_CHAMBER_OUTRO_260_CHAR	$MAG
$LINE_TREASURE_CHAMBER_OUTRO_260_TEXT	それを決めるのは私です。あなたではない。
$LINE_TREASURE_CHAMBER_OUTRO_270_CHAR	$MAG
$LINE_TREASURE_CHAMBER_OUTRO_270_TEXT	私の決めたタイミングとやり方で、あなたを殺しましょう。
$LINE_TREASURE_CHAMBER_OUTRO_280_CHAR	$MAG
$LINE_TREASURE_CHAMBER_OUTRO_280_TEXT	それまでは、ついて来てください。
$SCENE_4_4_INTRO_TITLE	罠
$LINE_4_4_INTRO_00_CHAR	$RAN
$LINE_4_4_INTRO_00_TEXT	ねえ、町にレブナントがいなかった理由がわかったよ。
$LINE_4_4_INTRO_10_CHAR	$RAN
$LINE_4_4_INTRO_10_TEXT	みんな、ここで待ってたんだな。
$LINE_4_4_INTRO_20_CHAR	$MCG
$LINE_4_4_INTRO_20_TEXT	たぶん、数千くらいのレブナントがいるね。
$LINE_4_4_INTRO_30_CHAR	$RAN
$LINE_4_4_INTRO_30_TEXT	ああ。
$LINE_4_4_INTRO_40_CHAR	$BER
$LINE_4_4_INTRO_40_TEXT	こんな死に方をするとは思わなかったが・・・
$LINE_4_4_INTRO_50_CHAR	$BER
$LINE_4_4_INTRO_50_TEXT	こんな死に方を待ってたぜ！
$LINE_4_4_INTRO_60_CHAR	$BER
$LINE_4_4_INTRO_60_TEXT	血祭りだ！
$LINE_4_4_INTRO_70_CHAR	$RAN
$LINE_4_4_INTRO_70_TEXT	さて・・・。
$LINE_4_4_INTRO_80_CHAR	$MCG
$LINE_4_4_INTRO_80_TEXT	もうやれることも、多くはないね。
$LINE_4_4_INTRO_90_CHAR	$RAN
$LINE_4_4_INTRO_90_TEXT	君と知り合えてよかったよ。
$LINE_4_4_INTRO_100_CHAR	$DRA
$LINE_4_4_INTRO_100_TEXT	おい、人間・・・
$LINE_4_4_INTRO_110_CHAR	$MCG
$LINE_4_4_INTRO_110_TEXT	もう、契約も意味をなさないようだね・・・。
$LINE_4_4_INTRO_120_CHAR	$DRA
$LINE_4_4_INTRO_120_TEXT	いいものを教えてやる。
$LINE_4_4_INTRO_130_CHAR	$MCG
$LINE_4_4_INTRO_130_TEXT	何？
$LINE_4_4_INTRO_140_CHAR	$DRA
$LINE_4_4_INTRO_140_TEXT	歴史上・・・これを知る人間は誰もおらん。
$LINE_4_4_INTRO_150_CHAR	$DRA
$LINE_4_4_INTRO_150_TEXT	しかし、今こそ教えるべきだろう。
$SCENE_4_4_OUTRO_TITLE	孤独
$LINE_4_4_OUTRO_00_CHAR	$RAN
$LINE_4_4_OUTRO_00_TEXT	信じられない。
$LINE_4_4_OUTRO_10_CHAR	$MCG
$LINE_4_4_OUTRO_10_TEXT	生きてることが？
$LINE_4_4_OUTRO_20_CHAR	$RAN
$LINE_4_4_OUTRO_20_TEXT	うん、それもだけどね。
$LINE_4_4_OUTRO_30_CHAR	$RAN
$LINE_4_4_OUTRO_30_TEXT	でも、私たちの周りに何もない。
$LINE_4_4_OUTRO_40_CHAR	$RAN
$LINE_4_4_OUTRO_40_TEXT	レブナントが一体もいない。
$LINE_4_4_OUTRO_50_CHAR	$RAN
$LINE_4_4_OUTRO_50_TEXT	誰にも後をつけられていない。
$SCENE_4_5_INTRO_TITLE	エズティル・テノクの右手
$LINE_4_5_INTRO_00_CHAR	$RAN
$LINE_4_5_INTRO_00_TEXT	おぉ、こんな時がくるなんて。
$LINE_4_5_INTRO_10_CHAR	$RAN
$LINE_4_5_INTRO_10_TEXT	もうすぐ、出口だ！
$LINE_4_5_INTRO_20_CHAR	$RAN
$LINE_4_5_INTRO_20_TEXT	奈落の谷から、出られる！
$LINE_4_5_INTRO_30_CHAR	$RAN
$LINE_4_5_INTRO_30_TEXT	*$MCG！まだレブナントがいた！
$LINE_4_5_INTRO_40_CHAR	ブラッドマッド教信者
$LINE_4_5_INTRO_40_TEXT	*ははは、$MCGという者は、なんて運が良いんだ。
$LINE_4_5_INTRO_50_CHAR	ブラッドマッド教信者
$LINE_4_5_INTRO_50_TEXT	こんな光景を見られる者は、そう多くない。エズティル・テノクが、その偉大なる右手を伸ばし・・・
$LINE_4_5_INTRO_60_CHAR	ブラッドマッド教信者
$LINE_4_5_INTRO_60_TEXT	・・・正当なる力をつかみ取るのを！
$LINE_4_5_INTRO_70_CHAR	ブラッドマッド教信者
$LINE_4_5_INTRO_70_TEXT	さあ、「死」の姿を目に焼き付けるがいい！
$SCENE_4_5_OUTRO_TITLE	ゼレミアの提案
$NARR_4_5_OUTRO_00_TEXT	ACT VII
$NARR_4_5_OUTRO_00_SUB_TEXT	*人は死を恐れると信じられている。しかし、私の経験則では、人が真に恐れるのは死の不確実性だ。というのも、それがもたらす拷問のような苦しみの中にいたある日、死が確実になると今まで感じたことのない絶対的な安らかさに満たされたからだ。$N$Nそして、生き延びられる可能性が生まれた時、私は本物の恐怖に囚われた。
$NARR_4_5_OUTRO_00_SUB_SUB_TEXT	*$N$N$N$N$N$N$N$N$N$N-弓術の熟練者ゲデモン・ダラブバルの回想記$Nアッシュ王への奉公における冒険と功績の日々より
$LINE_4_5_OUTRO_00_CHAR	$MCG
$LINE_4_5_OUTRO_00_TEXT	私と戦うつもりなら―
$LINE_4_5_OUTRO_10_CHAR	ゼレミア
$LINE_4_5_OUTRO_10_TEXT	私が来たのは、お前の血をヤツに渡さないため。それだけだ。
$LINE_4_5_OUTRO_20_CHAR	ゼレミア
$LINE_4_5_OUTRO_20_TEXT	もはや、お前は確実に逃げられる。邪魔をする理由はない。
$LINE_4_5_OUTRO_30_CHAR	ゼレミア
$LINE_4_5_OUTRO_30_TEXT	もはやお前に、何の興味もない。
$LINE_4_5_OUTRO_40_CHAR	$DRA
$LINE_4_5_OUTRO_40_TEXT	おい、卑劣な犬。私の子に何をした？
$LINE_4_5_OUTRO_50_CHAR	ゼレミア
$LINE_4_5_OUTRO_50_TEXT	お前のような出来損ないのトカゲよりは使い物になるかと思ってな。
$LINE_4_5_OUTRO_60_CHAR	$DRA
$LINE_4_5_OUTRO_60_TEXT	大事な子を殺しおって！
$LINE_4_5_OUTRO_70_CHAR	ゼレミア
$LINE_4_5_OUTRO_70_TEXT	尊い犠牲が、世界を救うだろう。
$LINE_4_5_OUTRO_80_CHAR	ゼレミア
$LINE_4_5_OUTRO_80_TEXT	今この瞬間も、お前の子どもたちは、奈落の地下の鉱山に散らばっている。私からの指示を待っているのだ。
$LINE_4_5_OUTRO_90_CHAR	ゼレミア
$LINE_4_5_OUTRO_90_TEXT	私が命令すれば、ドラゴンのレブナントが鉱山に火をつけるだろう。
$LINE_4_5_OUTRO_100_CHAR	ゼレミア
$LINE_4_5_OUTRO_100_TEXT	奈落の谷は崩壊し・・・
$LINE_4_5_OUTRO_110_CHAR	ゼレミア
$LINE_4_5_OUTRO_110_TEXT	すべてが死ぬ。
$LINE_4_5_OUTRO_120_CHAR	ゼレミア
$LINE_4_5_OUTRO_120_TEXT	そして、この死を礎に新たな血の封印を行うのだ。
$LINE_4_5_OUTRO_130_CHAR	ゼレミア
$LINE_4_5_OUTRO_130_TEXT	今までの1000倍もの強さを持つ封印をな。
$LINE_4_5_OUTRO_140_CHAR	ゼレミア
$LINE_4_5_OUTRO_140_TEXT	今度は、子孫は残らない。
$LINE_4_5_OUTRO_150_CHAR	ゼレミア
$LINE_4_5_OUTRO_150_TEXT	エズティル・テノクは、囚われの身となるだろう。永遠に。
$LINE_4_5_OUTRO_160_CHAR	$DRA
$LINE_4_5_OUTRO_160_TEXT	貴様、焼き殺してくれる！
$LINE_4_5_OUTRO_170_CHAR	ゼレミア
$LINE_4_5_OUTRO_170_TEXT	無理だな。
$LINE_4_5_OUTRO_180_CHAR	ゼレミア
$LINE_4_5_OUTRO_180_TEXT	ひとつ、忠告しておこう。私の後を追えば、死あるのみだ。
$LINE_4_5_OUTRO_190_CHAR	ゼレミア
$LINE_4_5_OUTRO_190_TEXT	*さようなら、$MCG。
$LINE_4_5_OUTRO_200_CHAR	ゼレミア
$LINE_4_5_OUTRO_200_TEXT	終焉は間もなくだ。
$LINE_4_5_OUTRO_210_CHAR	$DRA
$LINE_4_5_OUTRO_210_TEXT	卑怯者が、はざまへ逃げるぞ！
$LINE_4_5_OUTRO_220_CHAR	$DRA
$LINE_4_5_OUTRO_220_TEXT	急げ！あいつを追うぞ！
$LINE_4_5_OUTRO_230_CHAR	$RAN
$LINE_4_5_OUTRO_230_TEXT	ちょ、ちょっと待ってよ。
$LINE_4_5_OUTRO_240_CHAR	$RAN
$LINE_4_5_OUTRO_240_TEXT	出口のことを覚えてるのは私だけか？
$LINE_4_5_OUTRO_250_CHAR	$RAN
$LINE_4_5_OUTRO_250_TEXT	つまり、ここから脱出できるんだよ。
$LINE_4_5_OUTRO_260_CHAR	$DRA
$LINE_4_5_OUTRO_260_TEXT	恐れている時間などない！
$LINE_4_5_OUTRO_270_CHAR	$RAN
$LINE_4_5_OUTRO_270_TEXT	殺されてる時間もないって！
$LINE_4_5_OUTRO_280_CHAR	$RAN
$LINE_4_5_OUTRO_280_TEXT	*$MCG、どうする？
$SCENE_4_6_INTRO_TITLE	外へと続く道
$LINE_4_6_INTRO_00_CHAR	$MAG
$LINE_4_6_INTRO_00_TEXT	脱出できれば、それでいいのですか？
$LINE_4_6_INTRO_10_CHAR	$MCG
$LINE_4_6_INTRO_10_TEXT	他にどうすれば？
$LINE_4_6_INTRO_20_CHAR	$MAG
$LINE_4_6_INTRO_20_TEXT	座して死を待つわけにはいきません！
$LINE_4_6_INTRO_30_CHAR	$MAG
$LINE_4_6_INTRO_30_TEXT	あなたは友だと思っていたのに・・・
$LINE_4_6_INTRO_40_CHAR	$MAG
$LINE_4_6_INTRO_40_TEXT	・・・ひとり永遠に生きるよりも、部下と共に死ぬ方がいい。<N>いつか、あなたにもわかるでしょう。
$LINE_4_6_INTRO_50_CHAR	$MAG
$LINE_4_6_INTRO_50_TEXT	高すぎる勉強代ですが。
$LINE_4_6_INTRO_60_CHAR	$MCG
$LINE_4_6_INTRO_60_TEXT	・・・
$LINE_4_6_INTRO_70_CHAR	$HEA
$LINE_4_6_INTRO_70_TEXT	*賢明な選択だよ、$MCG。
$LINE_4_6_INTRO_80_CHAR	$MCG
$LINE_4_6_INTRO_80_TEXT	本当に？
$LINE_4_6_INTRO_90_CHAR	$HEA
$LINE_4_6_INTRO_90_TEXT	あなたは、未来のために前に進みなさい。
$LINE_4_6_INTRO_100_CHAR	$HEA
$LINE_4_6_INTRO_100_TEXT	私は、自分が積み上げた過去とともに死のう。
$LINE_4_6_INTRO_110_CHAR	$MCG
$LINE_4_6_INTRO_110_TEXT	さようなら。
$LINE_4_6_INTRO_120_CHAR	$HEA
$LINE_4_6_INTRO_120_TEXT	あなたにセリナドトの導きあらんことを。
$LINE_4_6_INTRO_130_CHAR	$DRA
$LINE_4_6_INTRO_130_TEXT	貴様、火の秘密を教えてやっただろう！
$LINE_4_6_INTRO_140_CHAR	$DRA
$LINE_4_6_INTRO_140_TEXT	裏切るのか？
$LINE_4_6_INTRO_150_CHAR	$DRA
$LINE_4_6_INTRO_150_TEXT	人間には、何も期待できんな・・・。
$LINE_4_6_INTRO_160_CHAR	$MCG
$LINE_4_6_INTRO_160_TEXT	*$DRA、世界が、かかっているんだよ。
$LINE_4_6_INTRO_170_CHAR	$DRA
$LINE_4_6_INTRO_170_TEXT	世界など、どうでもいい。
$LINE_4_6_INTRO_180_CHAR	$DRA
$LINE_4_6_INTRO_180_TEXT	絶対に子どもの仇を討つのだ！
$LINE_4_6_INTRO_190_CHAR	$DRA
$LINE_4_6_INTRO_190_TEXT	臆病で頼りにならん人間どもめ・・・
$LINE_4_6_INTRO_200_CHAR	$BER
$LINE_4_6_INTRO_200_TEXT	*おいっ、$MCG！
$LINE_4_6_INTRO_210_CHAR	$MCG
$LINE_4_6_INTRO_210_TEXT	アンタも？
$LINE_4_6_INTRO_220_CHAR	$BER
$LINE_4_6_INTRO_220_TEXT	アンタといれて、すごく楽しかったよ。けどな、世界最大最強のオカルト野郎と戦うチャンスを逃したくねーんだわ。
$LINE_4_6_INTRO_230_CHAR	$BER
$LINE_4_6_INTRO_230_TEXT	売られたケンカは買ったことしかねえしな。
$LINE_4_6_INTRO_240_CHAR	$MCG
$LINE_4_6_INTRO_240_TEXT	戦いじゃない！ただの自殺行為だよ！
$LINE_4_6_INTRO_250_CHAR	$BER
$LINE_4_6_INTRO_250_TEXT	あ？知らねーな。もう十分にいろんなこと経験してきた。<N>どうせ、とっくの昔に死んでたようなもんさ。
$LINE_4_6_INTRO_260_CHAR	$BER
$LINE_4_6_INTRO_260_TEXT	揚がってなかった揚げ餃子を食った時はヤバかった・・・
$LINE_4_6_INTRO_270_CHAR	$BER
$LINE_4_6_INTRO_270_TEXT	ともかく、相手を八つ裂きにしてやること以外、興味ねえの。
$LINE_4_6_INTRO_280_CHAR	$BER
$LINE_4_6_INTRO_280_TEXT	またな！
$LINE_4_6_INTRO_290_CHAR	$MCG
$LINE_4_6_INTRO_290_TEXT	・・・またね。
$LINE_4_6_INTRO_300_CHAR	$MCG
$LINE_4_6_INTRO_300_TEXT	・・・
$LINE_4_6_INTRO_310_CHAR	$MCG
$LINE_4_6_INTRO_310_TEXT	皆、行ってしまったの？
$LINE_4_6_INTRO_320_CHAR	$KNI
$LINE_4_6_INTRO_320_TEXT	仕方ないですね。あなたには借りがありますから。
$LINE_4_6_INTRO_330_CHAR	$KNI
$LINE_4_6_INTRO_330_TEXT	どんな選択をなさろうとも、ついていきますよ。
$LINE_4_6_INTRO_340_CHAR	$MCG
$LINE_4_6_INTRO_340_TEXT	*ありがとう、$KNI。
$LINE_4_6_INTRO_350_CHAR	$KNI
$LINE_4_6_INTRO_350_TEXT	*$RAN？
$LINE_4_6_INTRO_360_CHAR	$RAN
$LINE_4_6_INTRO_360_TEXT	おい、そんな目で私を見るな。この陰気な場所から抜け出したいだけだ。
$LINE_4_6_INTRO_370_CHAR	$RAN
$LINE_4_6_INTRO_370_TEXT	死ぬために、長旅をしてきたわけじゃないからね。
$LINE_4_6_INTRO_380_CHAR	$MCG
$LINE_4_6_INTRO_380_TEXT	それじゃ、ここから出ましょう。
$LINE_4_6_INTRO_390_CHAR	$RAN
$LINE_4_6_INTRO_390_TEXT	・・・
$LINE_4_6_INTRO_400_CHAR	$RAN
$LINE_4_6_INTRO_400_TEXT	*おいっ、$BER！
$LINE_4_6_INTRO_410_CHAR	$BER
$LINE_4_6_INTRO_410_TEXT	何だ。
$LINE_4_6_INTRO_420_CHAR	$RAN
$LINE_4_6_INTRO_420_TEXT	お前、死ぬんだぞ。わかってるのか？
$LINE_4_6_INTRO_430_CHAR	$BER
$LINE_4_6_INTRO_430_TEXT	もちろん。
$LINE_4_6_INTRO_440_CHAR	$RAN
$LINE_4_6_INTRO_440_TEXT	怖くないのか？迷いはないのか！？
$LINE_4_6_INTRO_450_CHAR	$BER
$LINE_4_6_INTRO_450_TEXT	*よく考えろよ、$RAN。俺たちは、今までずっと勝ち残ってきただろう。
$LINE_4_6_INTRO_460_CHAR	$BER
$LINE_4_6_INTRO_460_TEXT	*でも、ずっと勝てるわけじゃない。いつかは、終わりが来る。
$LINE_4_6_INTRO_470_CHAR	$BER
$LINE_4_6_INTRO_470_TEXT	今が、死に意味を持たせるチャンスなんだ。
$LINE_4_6_INTRO_480_CHAR	$RAN
$LINE_4_6_INTRO_480_TEXT	*$BER・・・
$LINE_4_6_INTRO_490_CHAR	$BER
$LINE_4_6_INTRO_490_TEXT	それに、これでお前への借りも、返さずに済むしな。
$LINE_4_6_INTRO_500_CHAR	$BER
$LINE_4_6_INTRO_500_TEXT	じゃあな！
$LINE_4_6_INTRO_510_CHAR	$RAN
$LINE_4_6_INTRO_510_TEXT	・・・さようなら・・・。
$LINE_4_6_INTRO_520_CHAR	$MCG
$LINE_4_6_INTRO_520_TEXT	*$RAN？
$LINE_4_6_INTRO_530_CHAR	$RAN
$LINE_4_6_INTRO_530_TEXT	ああ、ここから出よう。
$SCENE_ENDING_4_6_OUTRO_TITLE	そして世界は
$LINE_ENDING_4_6_OUTRO_00_CHAR	$MCG
$LINE_ENDING_4_6_OUTRO_00_TEXT	出られたね。
$LINE_ENDING_4_6_OUTRO_10_CHAR	$RAN
$LINE_ENDING_4_6_OUTRO_10_TEXT	本当に、自由だ。
$LINE_ENDING_4_6_OUTRO_20_CHAR	$KNI
$LINE_ENDING_4_6_OUTRO_20_TEXT	お嬢様、どうされました？
$LINE_ENDING_4_6_OUTRO_30_CHAR	$MCG
$LINE_ENDING_4_6_OUTRO_30_TEXT	わからない・・・。
$LINE_ENDING_4_6_OUTRO_40_CHAR	$MCG
$LINE_ENDING_4_6_OUTRO_40_TEXT	奈落の谷は・・・。
$LINE_ENDING_4_6_OUTRO_50_CHAR	$KNI
$LINE_ENDING_4_6_OUTRO_50_TEXT	私たちは、すべきことをしました。
$LINE_ENDING_4_6_OUTRO_60_CHAR	$KNI
$LINE_ENDING_4_6_OUTRO_60_TEXT	ゼレミアを止める方法はなかったのです・・・。
$LINE_ENDING_4_6_OUTRO_70_CHAR	$KNI
$LINE_ENDING_4_6_OUTRO_70_TEXT	あなたが死ねば、エズティル・テノクの封印が解けたかもしれない。
$LINE_ENDING_4_6_OUTRO_80_CHAR	$MCG
$LINE_ENDING_4_6_OUTRO_80_TEXT	でも、それで状況が好転することはなかったでしょう。
$LINE_ENDING_4_6_OUTRO_90_CHAR	$MCG
$LINE_ENDING_4_6_OUTRO_90_TEXT	皆は・・・
$LINE_ENDING_4_6_OUTRO_100_CHAR	$KNI
$LINE_ENDING_4_6_OUTRO_100_TEXT	とてつもない悲劇でした。
$LINE_ENDING_4_6_OUTRO_110_CHAR	$KNI
$LINE_ENDING_4_6_OUTRO_110_TEXT	生き延びたからって、自分を責めてはいけませんよ。
$LINE_ENDING_4_6_OUTRO_120_CHAR	$MCG
$LINE_ENDING_4_6_OUTRO_120_TEXT	・・・
$SCENE_4_7_INTRO_TITLE	ゼレミアを追って
$LINE_4_7_INTRO_00_CHAR	$MCG
$LINE_4_7_INTRO_00_TEXT	たとえ世界が救われるとしても・・・
$LINE_4_7_INTRO_10_CHAR	$MCG
$LINE_4_7_INTRO_10_TEXT	ゼレミアの行動に目をつむるなんてできない。
$LINE_4_7_INTRO_20_CHAR	$MCG
$LINE_4_7_INTRO_20_TEXT	損失が大きすぎるよ。
$LINE_4_7_INTRO_30_CHAR	$HEA
$LINE_4_7_INTRO_30_TEXT	どんな危険が待ち受けているか、わかっていますか？
$LINE_4_7_INTRO_40_CHAR	$HEA
$LINE_4_7_INTRO_40_TEXT	彼の計画は阻止せねば。<N>しかし、あなたが来ると、すべてが危険にさらされます。
$LINE_4_7_INTRO_50_CHAR	$MCG
$LINE_4_7_INTRO_50_TEXT	でも、私がいなければ、勝ち目もない。そうでしょう？
$LINE_4_7_INTRO_60_CHAR	$HEA
$LINE_4_7_INTRO_60_TEXT	いいでしょう。あなたがそう選ぶなら。
$LINE_4_7_INTRO_70_CHAR	$BER
$LINE_4_7_INTRO_70_TEXT	よっしゃ！決起特攻だ！
$LINE_4_7_INTRO_80_CHAR	$BER
$LINE_4_7_INTRO_80_TEXT	暴れるのって、最高だ！
$LINE_4_7_INTRO_90_CHAR	$MAG
$LINE_4_7_INTRO_90_TEXT	あなたと共に行きましょう。<N>生き残った民をこれ以上殺されるわけにはいきませんから。
$LINE_4_7_INTRO_100_CHAR	$DRA
$LINE_4_7_INTRO_100_TEXT	姿のわりに大きな勇気を持ってるんだな、人間よ。上出来だ。
$LINE_4_7_INTRO_110_CHAR	$DRA
$LINE_4_7_INTRO_110_TEXT	絶対に、子の仇を討つ。
$LINE_4_7_INTRO_120_CHAR	$RAN
$LINE_4_7_INTRO_120_TEXT	美徳を保つというのは素晴しいことだよ。<N>でも、私はとっとと脱出する。
$LINE_4_7_INTRO_130_CHAR	$RAN
$LINE_4_7_INTRO_130_TEXT	死ぬために、わざわざ長い旅を続けてきたわけじゃないからね。
$LINE_4_7_INTRO_140_CHAR	$MCG
$LINE_4_7_INTRO_140_TEXT	わかってるよ。
$LINE_4_7_INTRO_150_CHAR	$RAN
$LINE_4_7_INTRO_150_TEXT	うん・・・さよなら。
$LINE_4_7_INTRO_160_CHAR	$MCG
$LINE_4_7_INTRO_160_TEXT	*お別れね、$RAN。
$LINE_4_7_INTRO_170_CHAR	$RAN
$LINE_4_7_INTRO_170_TEXT	・・・
$LINE_4_7_INTRO_180_CHAR	$RAN
$LINE_4_7_INTRO_180_TEXT	*$BER！
$LINE_4_7_INTRO_190_CHAR	$BER
$LINE_4_7_INTRO_190_TEXT	何だ。
$LINE_4_7_INTRO_200_CHAR	$RAN
$LINE_4_7_INTRO_200_TEXT	お前、死ぬんだぞ。わかってるのか？
$LINE_4_7_INTRO_210_CHAR	$BER
$LINE_4_7_INTRO_210_TEXT	もちろん。
$LINE_4_7_INTRO_220_CHAR	$RAN
$LINE_4_7_INTRO_220_TEXT	怖くないのか？迷いはないのか！？
$LINE_4_7_INTRO_230_CHAR	$BER
$LINE_4_7_INTRO_230_TEXT	いいか$RAN、俺もお前も生き延びるタイプだ。何があっても切り抜けてた。
$LINE_4_7_INTRO_240_CHAR	$BER
$LINE_4_7_INTRO_240_TEXT	*でも、ずっと勝てるわけじゃない。いつかは、終わりが来る。
$LINE_4_7_INTRO_250_CHAR	$BER
$LINE_4_7_INTRO_250_TEXT	今が、死に意味を持たせるチャンスなんだ。
$LINE_4_7_INTRO_260_CHAR	$RAN
$LINE_4_7_INTRO_260_TEXT	*$BER・・・
$LINE_4_7_INTRO_270_CHAR	$BER
$LINE_4_7_INTRO_270_TEXT	それに、これでお前に借りたスクラップも、返さずに済むしな。
$LINE_4_7_INTRO_280_CHAR	$BER
$LINE_4_7_INTRO_280_TEXT	じゃあな！
$LINE_4_7_INTRO_290_CHAR	$RAN
$LINE_4_7_INTRO_290_TEXT	・・・さようなら・・・。
$SCENE_4_7_OUTRO_TITLE	多くの敵と
$LINE_4_7_OUTRO_00_CHAR	$KNI
$LINE_4_7_OUTRO_00_TEXT	前衛は倒しましたが、今、敵の中核に隣接しています。
$LINE_4_7_OUTRO_10_CHAR	$KNI
$LINE_4_7_OUTRO_10_TEXT	回り込もうとすれば、ゼレミアの元に辿り着く頃には手遅れになるかもしれません。
$LINE_4_7_OUTRO_20_CHAR	$MCG
$LINE_4_7_OUTRO_20_TEXT	それじゃ、どうすればいい？
$LINE_4_7_OUTRO_30_CHAR	$KNI
$LINE_4_7_OUTRO_30_TEXT	うーむ・・・。
$LINE_4_7_OUTRO_40_CHAR	$KNI
$LINE_4_7_OUTRO_40_TEXT	率直に言って、正面突破がいいと思います。
$LINE_4_7_OUTRO_50_CHAR	$MCG
$LINE_4_7_OUTRO_50_TEXT	いいね。
$LINE_4_7_OUTRO_60_CHAR	$BER
$LINE_4_7_OUTRO_60_TEXT	いいぞ、新入り！
$LINE_4_7_OUTRO_70_CHAR	$BER
$LINE_4_7_OUTRO_70_TEXT	それこそまさに、俺がやりたい作戦だ！
$LINE_4_7_OUTRO_80_CHAR	$KNI
$LINE_4_7_OUTRO_80_TEXT	何ですか、その手は。
$LINE_4_7_OUTRO_90_CHAR	$BER
$LINE_4_7_OUTRO_90_TEXT	お前を立派な男だと認めてやったんだよ。
$LINE_4_7_OUTRO_100_CHAR	$KNI
$LINE_4_7_OUTRO_100_TEXT	いや、そんなつもりで言ったのではない。
$LINE_4_7_OUTRO_110_CHAR	$KNI
$LINE_4_7_OUTRO_110_TEXT	私に触らないでください。
$LINE_4_7_OUTRO_120_CHAR	$KNI
$LINE_4_7_OUTRO_120_TEXT	あと、臭いから、私の風上に立たぬように。
$SCENE_4_8_INTRO_TITLE	ゼレミアの軍
$LINE_4_8_INTRO_00_CHAR	$MAG
$LINE_4_8_INTRO_00_TEXT	お出ましのようだな。
$LINE_4_8_INTRO_10_CHAR	$MAG
$LINE_4_8_INTRO_10_TEXT	敵の大将だ。
$LINE_4_8_INTRO_20_CHAR	$BER
$LINE_4_8_INTRO_20_TEXT	めちゃめちゃたくさんいるぜ。
$LINE_4_8_INTRO_30_CHAR	$MAG
$LINE_4_8_INTRO_30_TEXT	私は、火の娘。立ち向かうものは、たちどころに燃やしてやる。
$LINE_4_8_INTRO_40_CHAR	$BER
$LINE_4_8_INTRO_40_TEXT	くそっ、立派な雄叫びを上げることが出来たら・・・
$LINE_4_8_INTRO_50_CHAR	$BER
$LINE_4_8_INTRO_50_TEXT	ワォオウアアァァン！うーん、まだまだだなぁ。
$LINE_4_8_INTRO_60_CHAR	$RAN
$LINE_4_8_INTRO_60_TEXT	よくわからないけど、今のやつ、よかったと思うよ。
$LINE_4_8_INTRO_70_CHAR	$RAN
$LINE_4_8_INTRO_70_TEXT	その調子でいこう。
$LINE_4_8_INTRO_80_CHAR	$BER
$LINE_4_8_INTRO_80_TEXT	おお、戻ってきたのか。
$LINE_4_8_INTRO_90_CHAR	$RAN
$LINE_4_8_INTRO_90_TEXT	ああ。そうだね。
$LINE_4_8_INTRO_100_CHAR	$BER
$LINE_4_8_INTRO_100_TEXT	でも、俺が借金を返すつもりなんかないってこと、気付いてるだろ？
$LINE_4_8_INTRO_110_CHAR	$RAN
$LINE_4_8_INTRO_110_TEXT	もういいから、特攻にかかろうよ。
$LINE_4_8_INTRO_120_CHAR	$BER
$LINE_4_8_INTRO_120_TEXT	そうしよう。でも、その前にだ。
$LINE_4_8_INTRO_130_CHAR	$RAN
$LINE_4_8_INTRO_130_TEXT	えっ？何だ、それ？
$LINE_4_8_INTRO_140_CHAR	$BER
$LINE_4_8_INTRO_140_TEXT	男らしく、拳をぶつけ合おうぜ！
$LINE_4_8_INTRO_150_CHAR	$RAN
$LINE_4_8_INTRO_150_TEXT	どうしてそんなことしなきゃいけないんだよ？
$LINE_4_8_INTRO_160_CHAR	$BER
$LINE_4_8_INTRO_160_TEXT	俺たちは最高だから、挨拶代わりに拳をぶつけ合うんだよ！
$LINE_4_8_INTRO_170_CHAR	$RAN
$LINE_4_8_INTRO_170_TEXT	いや、いいよ。あんまり調子に乗るなよ。
$LINE_4_8_INTRO_180_CHAR	$BER
$LINE_4_8_INTRO_180_TEXT	シケてんの。
$LINE_4_8_INTRO_190_CHAR	$RAN
$LINE_4_8_INTRO_190_TEXT	もう、とっとと死にに行こうよ 。な？
$LINE_4_8_INTRO_200_CHAR	$BER
$LINE_4_8_INTRO_200_TEXT	ワォオウアアァァン。
$SCENE_4_8_OUTRO_TITLE	立ちはだかる最後の敵
$LINE_4_8_OUTRO_00_CHAR	$MAG
$LINE_4_8_OUTRO_00_TEXT	最後の敵を倒したぞ！
$LINE_4_8_OUTRO_10_CHAR	$DRA
$LINE_4_8_OUTRO_10_TEXT	いや、最後ではない。
$LINE_4_8_OUTRO_20_CHAR	$DRA
$LINE_4_8_OUTRO_20_TEXT	あと1体、残っている。
$LINE_4_8_OUTRO_30_CHAR	$DRA
$LINE_4_8_OUTRO_30_TEXT	私が復讐すべき相手が。
$LINE_4_8_OUTRO_40_CHAR	$MAG
$LINE_4_8_OUTRO_40_TEXT	炎の裁きを受ける者か。
$LINE_4_8_OUTRO_50_CHAR	$MAG
$LINE_4_8_OUTRO_50_TEXT	ゼレミア。
$SCENE_4_9_INTRO_TITLE	狂気の沙汰を目の前に
$LINE_4_9_INTRO_00_CHAR	ゼレミア
$LINE_4_9_INTRO_00_TEXT	流れる血で封印するのだ。封印が血で解けぬよう―
$LINE_4_9_INTRO_10_CHAR	$MCG
$LINE_4_9_INTRO_10_TEXT	やめろ！
$LINE_4_9_INTRO_20_CHAR	ゼレミア
$LINE_4_9_INTRO_20_TEXT	*・・・$MCG。
$LINE_4_9_INTRO_30_CHAR	ゼレミア
$LINE_4_9_INTRO_30_TEXT	敵の正体が見えるだろう。檻に閉じ込められた、哀れな魔法使いだ。
$LINE_4_9_INTRO_40_CHAR	ゼレミア
$LINE_4_9_INTRO_40_TEXT	今なお、闇の知性は我々にあらがい、<N>残された手段を探して触手を伸ばしているぞ。
$LINE_4_9_INTRO_50_CHAR	ゼレミア
$LINE_4_9_INTRO_50_TEXT	彼は知っている。もうじき、自分が永遠に囚われの身となることを。
$LINE_4_9_INTRO_60_CHAR	$MCG
$LINE_4_9_INTRO_60_TEXT	そうはさせない。
$LINE_4_9_INTRO_70_CHAR	ゼレミア
$LINE_4_9_INTRO_70_TEXT	こうならないことを願っていたが。
$LINE_4_9_INTRO_80_CHAR	ゼレミア
$LINE_4_9_INTRO_80_TEXT	しかし、もしお前が死ねば、新しい血で封印は強くなる。
$LINE_4_9_INTRO_90_CHAR	$MCG
$LINE_4_9_INTRO_90_TEXT	もう、誰も殺させはしない。
$LINE_4_9_INTRO_100_CHAR	ゼレミア
$LINE_4_9_INTRO_100_TEXT	*$MCG、もう数え切れぬほど殺してきたのだ。
$LINE_4_9_INTRO_110_CHAR	ゼレミア
$LINE_4_9_INTRO_110_TEXT	たかが数千人のためだけに、もう止められん。
$LINE_4_9_INTRO_120_CHAR	ゼレミア
$LINE_4_9_INTRO_120_TEXT	その命など、大河の一滴の如く、取るに足らないものだ。
$LINE_4_9_INTRO_130_CHAR	$MCG
$LINE_4_9_INTRO_130_TEXT	私はそうは思わないね！
$SCENE_4_9_OUTRO_TITLE	遅すぎた
$LINE_4_9_OUTRO_00_CHAR	ゼレミア
$LINE_4_9_OUTRO_00_TEXT	*ほれぼれする戦いぶりだな、$MCG。
$LINE_4_9_OUTRO_10_CHAR	ゼレミア
$LINE_4_9_OUTRO_10_TEXT	しかし、遅すぎた。
$LINE_4_9_OUTRO_20_CHAR	ゼレミア
$LINE_4_9_OUTRO_20_TEXT	指示はすでに出した・・・。
$LINE_4_9_OUTRO_30_CHAR	ゼレミア
$LINE_4_9_OUTRO_30_TEXT	今・・・
$LINE_4_9_OUTRO_40_CHAR	ゼレミア
$LINE_4_9_OUTRO_40_TEXT	奈落は崩壊しつつある。
$LINE_4_9_OUTRO_50_CHAR	ゼレミア
$LINE_4_9_OUTRO_50_TEXT	・・・我らは、エズティル・テノクを永遠に閉じ込めるために、命を捧げるのだ。
$LINE_4_9_OUTRO_60_CHAR	$MCG
$LINE_4_9_OUTRO_60_TEXT	殺させはしない・・・。
$LINE_4_9_OUTRO_70_CHAR	$MCG
$LINE_4_9_OUTRO_70_TEXT	・・・させない・・・。
$LINE_4_9_OUTRO_80_CHAR	$MCG
$LINE_4_9_OUTRO_80_TEXT	殺させないぞ！
$SCENE_FINAL_INTRO_TITLE	エズティル・テノク
$LINE_FINAL_INTRO_00_CHAR	$KNI
$LINE_FINAL_INTRO_00_TEXT	一体これは？
$LINE_FINAL_INTRO_10_CHAR	$MCG
$LINE_FINAL_INTRO_10_TEXT	私たちは・・・生と死のはざまにいる・・・。
$LINE_FINAL_INTRO_20_CHAR	$KNI
$LINE_FINAL_INTRO_20_TEXT	皆は？
$LINE_FINAL_INTRO_30_CHAR	$MCG
$LINE_FINAL_INTRO_30_TEXT	皆・・・ここにいる。
$LINE_FINAL_INTRO_40_CHAR	$KNI
$LINE_FINAL_INTRO_40_TEXT	えっ？皆？
$LINE_FINAL_INTRO_50_CHAR	$MCG
$LINE_FINAL_INTRO_50_TEXT	奈落の人、皆・・・ここに連れて来た。皆、無事・・・。
$LINE_FINAL_INTRO_60_CHAR	$KNI
$LINE_FINAL_INTRO_60_TEXT	でも、数千人もいますよ！どうやって―
$LINE_FINAL_INTRO_70_CHAR	$KNI
$LINE_FINAL_INTRO_70_TEXT	*$MCG、怪我をしています。
$LINE_FINAL_INTRO_80_CHAR	$KNI
$LINE_FINAL_INTRO_80_TEXT	血が出ている！
$LINE_FINAL_INTRO_90_CHAR	ゼレミア
$LINE_FINAL_INTRO_90_TEXT	・・・いかん！
$LINE_FINAL_INTRO_100_CHAR	ゼレミア
$LINE_FINAL_INTRO_100_TEXT	新たな封印はまだ完成していない！その血を決して―
$LINE_FINAL_INTRO_110_CHAR	エズティル・テノク
$LINE_FINAL_INTRO_110_TEXT	ついに自由を得たぞ。
$SCENE_GAMEOVER_A_TITLE	すべてが終わる
$LINE_GAMEOVER_A_00_CHAR	エズティル・テノク
$LINE_GAMEOVER_A_00_TEXT	ついに。
$LINE_GAMEOVER_A_10_CHAR	エズティル・テノク
$LINE_GAMEOVER_A_10_TEXT	長かったぞ。ついに世界は再び私のものだ！
$SCENE_ENDING_ZELEMIR_DEAD_TITLE	苦痛に満ちた終焉
$NARR_ENDING_ZELEMIR_DEAD_00_TEXT	私たちは、必死に逃げる。
$NARR_ENDING_ZELEMIR_DEAD_10_TEXT	周囲に岩が降り注ぐ。
$NARR_ENDING_ZELEMIR_DEAD_20_TEXT	多くの命が失われた。
$NARR_ENDING_ZELEMIR_DEAD_30_TEXT	何日間にもおよぶ話し合い。
$NARR_ENDING_ZELEMIR_DEAD_40_TEXT	遊牧民のキャラバンは、しぶしぶながら、私たちのスクラップと物々交換に応じる。
$NARR_ENDING_ZELEMIR_DEAD_50_TEXT	私たちは、飢えに苦しむ。
$NARR_ENDING_ZELEMIR_DEAD_60_TEXT	難民のリーダーたちは、食べ物を求めて主張をする。
$NARR_ENDING_ZELEMIR_DEAD_70_TEXT	でも、みんなは、生きていることが嬉し過ぎて、議論どころではない。
$NARR_ENDING_ZELEMIR_DEAD_80_TEXT	外の空気を気がねなく吸えるだなんて、不思議な感じだ。<N>まだ慣れない。
$NARR_ENDING_ZELEMIR_DEAD_90_TEXT	やがて、皆の意見がまとまる。
$NARR_ENDING_ZELEMIR_DEAD_100_TEXT	私の人生は、永遠に変わってしまった。
$NARR_ENDING_ZELEMIR_DEAD_110_TEXT	世界も、永遠に変わってしまった。
$LINE_ENDING_ZELEMIR_DEAD_00_CHAR	$HEA
$LINE_ENDING_ZELEMIR_DEAD_00_TEXT	・・・彼のいるところへは追っていけないが・・・
$LINE_ENDING_ZELEMIR_DEAD_10_CHAR	$HEA
$LINE_ENDING_ZELEMIR_DEAD_10_TEXT	・・・彼を閉じ込めることは出来るかもしれない！
$LINE_ENDING_ZELEMIR_DEAD_20_CHAR	$MCG
$LINE_ENDING_ZELEMIR_DEAD_20_TEXT	ご老師？
$LINE_ENDING_ZELEMIR_DEAD_30_CHAR	$HEA
$LINE_ENDING_ZELEMIR_DEAD_30_TEXT	新たな血の封印です。そこから、出られなくしてやる。
$LINE_ENDING_ZELEMIR_DEAD_40_CHAR	$MCG
$LINE_ENDING_ZELEMIR_DEAD_40_TEXT	ダメよ！
$LINE_ENDING_ZELEMIR_DEAD_50_CHAR	$HEA
$LINE_ENDING_ZELEMIR_DEAD_50_TEXT	そうすべきなんだ。
$LINE_ENDING_ZELEMIR_DEAD_60_CHAR	$HEA
$LINE_ENDING_ZELEMIR_DEAD_60_TEXT	ゼレミアのかけた呪文は、まだ力を持っている。
$LINE_ENDING_ZELEMIR_DEAD_70_CHAR	$HEA
$LINE_ENDING_ZELEMIR_DEAD_70_TEXT	ゼレミアは、もう死んだ・・・。
$LINE_ENDING_ZELEMIR_DEAD_80_CHAR	$HEA
$LINE_ENDING_ZELEMIR_DEAD_80_TEXT	彼の血と、私の血。この二つがあれば、もう一度あの惨めな魔法使いを封印できるかもしれない！
$LINE_ENDING_ZELEMIR_DEAD_90_CHAR	エズティル・テノク
$LINE_ENDING_ZELEMIR_DEAD_90_TEXT	馬鹿め！絶対に逃げてみせるぞ。時代が移り変わっても・・・いつの日か、お前の血は私の元に辿り着く。
$LINE_ENDING_ZELEMIR_DEAD_100_CHAR	エズティル・テノク
$LINE_ENDING_ZELEMIR_DEAD_100_TEXT	お前の息子か、はたまた孫か。私は待つぞ。千年など、大した時ではない。
$LINE_ENDING_ZELEMIR_DEAD_110_CHAR	$HEA
$LINE_ENDING_ZELEMIR_DEAD_110_TEXT	しかし、お前は閉じ込められる。<N>その間に、人間は学ぶだろう。<N>お前を捕まえるための準備をするのだ。
$LINE_ENDING_ZELEMIR_DEAD_120_CHAR	エズティル・テノク
$LINE_ENDING_ZELEMIR_DEAD_120_TEXT	それで気が楽になるなら、そう信じるがいい。
$LINE_ENDING_ZELEMIR_DEAD_130_CHAR	$HEA
$LINE_ENDING_ZELEMIR_DEAD_130_TEXT	この世界を甘く見るな！
$LINE_ENDING_ZELEMIR_DEAD_140_CHAR	エズティル・テノク
$LINE_ENDING_ZELEMIR_DEAD_140_TEXT	小僧、お前の世界は私を必要としているんだよ。<N>必ず人間たちが、自らの意思で私を開放する日が来る。<N>そして、私たちを救ってくださいと言いながらな。
$LINE_ENDING_ZELEMIR_DEAD_150_CHAR	エズティル・テノク
$LINE_ENDING_ZELEMIR_DEAD_150_TEXT	そして、お前たちの子孫たちは再び血を流すのだ。<N>そう、ちょうど、お前たちがしたように。
$LINE_ENDING_ZELEMIR_DEAD_160_CHAR	$KNI
$LINE_ENDING_ZELEMIR_DEAD_160_TEXT	私には、妻もなければ子もいません。
$LINE_ENDING_ZELEMIR_DEAD_170_CHAR	$KNI
$LINE_ENDING_ZELEMIR_DEAD_170_TEXT	それに、私は命をささげると約束しました。
$LINE_ENDING_ZELEMIR_DEAD_180_CHAR	$MCG
$LINE_ENDING_ZELEMIR_DEAD_180_TEXT	*$KNI？
$LINE_ENDING_ZELEMIR_DEAD_190_CHAR	$KNI
$LINE_ENDING_ZELEMIR_DEAD_190_TEXT	この怪物を封印するには、一人の血では足りないのでしょう。
$LINE_ENDING_ZELEMIR_DEAD_200_CHAR	$KNI
$LINE_ENDING_ZELEMIR_DEAD_200_TEXT	本来、封印は三人の力によるもの・・・。<N>それが、一人分まで弱まった時に何が起こるかご覧になったでしょう。
$LINE_ENDING_ZELEMIR_DEAD_210_CHAR	$KNI
$LINE_ENDING_ZELEMIR_DEAD_210_TEXT	*さようなら、$MCG。我らの民を安全へ導いてください。
$LINE_ENDING_ZELEMIR_DEAD_220_CHAR	$MCG
$LINE_ENDING_ZELEMIR_DEAD_220_TEXT	だめ！
$LINE_ENDING_ZELEMIR_DEAD_230_CHAR	$HEA
$LINE_ENDING_ZELEMIR_DEAD_230_TEXT	さあ、血を流すぞ。そして、お前を封印してやる。永遠にな。
$LINE_ENDING_ZELEMIR_DEAD_240_CHAR	$MCG
$LINE_ENDING_ZELEMIR_DEAD_240_TEXT	やめて！
$LINE_ENDING_ZELEMIR_DEAD_250_CHAR	$HEA
$LINE_ENDING_ZELEMIR_DEAD_250_TEXT	拘束し、封印し、そして隠す。完璧だ。
$LINE_ENDING_ZELEMIR_DEAD_260_CHAR	$MCG
$LINE_ENDING_ZELEMIR_DEAD_260_TEXT	・・・
$LINE_ENDING_ZELEMIR_DEAD_270_CHAR	エズティル・テノク
$LINE_ENDING_ZELEMIR_DEAD_270_TEXT	1000年経ったところでどうなる？
$LINE_ENDING_ZELEMIR_DEAD_280_CHAR	エズティル・テノク
$LINE_ENDING_ZELEMIR_DEAD_280_TEXT	10万年経とうとも、人間の心は変わらんぞ！私は―
$LINE_ENDING_ZELEMIR_DEAD_290_CHAR	$MCG
$LINE_ENDING_ZELEMIR_DEAD_290_TEXT	・・・
$LINE_ENDING_ZELEMIR_DEAD_300_CHAR	$RAN
$LINE_ENDING_ZELEMIR_DEAD_300_TEXT	*$MCG、奈落が崩壊してる！
$LINE_ENDING_ZELEMIR_DEAD_310_CHAR	$RAN
$LINE_ENDING_ZELEMIR_DEAD_310_TEXT	早くここから出なきゃ！
$LINE_ENDING_ZELEMIR_DEAD_320_CHAR	$MCG
$LINE_ENDING_ZELEMIR_DEAD_320_TEXT	みんな、私の後に続いて！
$LINE_ENDING_ZELEMIR_DEAD_330_CHAR	$MCG
$LINE_ENDING_ZELEMIR_DEAD_330_TEXT	出口へ！
$LINE_ENDING_ZELEMIR_DEAD_340_CHAR	$MCG
$LINE_ENDING_ZELEMIR_DEAD_340_TEXT	一緒に逃げのびた人が、こんなに少ないなんて・・・。
$LINE_ENDING_ZELEMIR_DEAD_350_CHAR	$RAN
$LINE_ENDING_ZELEMIR_DEAD_350_TEXT	もし、ゼレミアが目的を果たしていたら、もっと少なかっただろうね。
$LINE_ENDING_ZELEMIR_DEAD_360_CHAR	$MCG
$LINE_ENDING_ZELEMIR_DEAD_360_TEXT	*多くの人が死んだ・・・$HEAと$KNIも道連れに・・・。
$LINE_ENDING_ZELEMIR_DEAD_370_CHAR	$RAN
$LINE_ENDING_ZELEMIR_DEAD_370_TEXT	*君は、とても勇敢だったよ、$MCG。
$LINE_ENDING_ZELEMIR_DEAD_380_CHAR	$RAN
$LINE_ENDING_ZELEMIR_DEAD_380_TEXT	君がああしなかったら、今ごろ、みんな死んでいた。
$LINE_ENDING_ZELEMIR_DEAD_390_CHAR	$RAN
$LINE_ENDING_ZELEMIR_DEAD_390_TEXT	目の前のことに集中しよう。
$LINE_ENDING_ZELEMIR_DEAD_400_CHAR	$RAN
$LINE_ENDING_ZELEMIR_DEAD_400_TEXT	今は、心配すべき人が、もっとたくさんいるんだ。
$LINE_ENDING_ZELEMIR_DEAD_410_CHAR	$RAN
$LINE_ENDING_ZELEMIR_DEAD_410_TEXT	さあ、彼ら皆をどうする？
$LINE_ENDING_ZELEMIR_DEAD_420_CHAR	$MAG
$LINE_ENDING_ZELEMIR_DEAD_420_TEXT	長い旅でしたね、友よ。
$LINE_ENDING_ZELEMIR_DEAD_430_CHAR	$MCG
$LINE_ENDING_ZELEMIR_DEAD_430_TEXT	ホント。もう旅立つの？
$LINE_ENDING_ZELEMIR_DEAD_440_CHAR	$MCG
$LINE_ENDING_ZELEMIR_DEAD_440_TEXT	残された人は少ないね・・・。
$LINE_ENDING_ZELEMIR_DEAD_450_CHAR	$MAG
$LINE_ENDING_ZELEMIR_DEAD_450_TEXT	我々はクウェイド帝国の最後の生き残り。
$LINE_ENDING_ZELEMIR_DEAD_460_CHAR	$MAG
$LINE_ENDING_ZELEMIR_DEAD_460_TEXT	いつの日か栄光を取り戻します。<N>でなければ、民の遺跡の中で死にましょう。
$LINE_ENDING_ZELEMIR_DEAD_470_CHAR	$MAG
$LINE_ENDING_ZELEMIR_DEAD_470_TEXT	他に、進むべき道はありません。
$LINE_ENDING_ZELEMIR_DEAD_480_CHAR	$MCG
$LINE_ENDING_ZELEMIR_DEAD_480_TEXT	でも、もう力は・・・
$LINE_ENDING_ZELEMIR_DEAD_490_CHAR	$MAG
$LINE_ENDING_ZELEMIR_DEAD_490_TEXT	能力が消えたのは妙な心持ですが・・・、<N>心の中から寒さが消えて、すごく嬉しいのです。
$LINE_ENDING_ZELEMIR_DEAD_500_CHAR	$MCG
$LINE_ENDING_ZELEMIR_DEAD_500_TEXT	そうね。私は能力がなくなって・・・<N>ぽっかり穴が空いたようだわ。
$LINE_ENDING_ZELEMIR_DEAD_510_CHAR	$MCG
$LINE_ENDING_ZELEMIR_DEAD_510_TEXT	きっと、エズティル・テノクと共に、魔法も死んだんだろうね。
$LINE_ENDING_ZELEMIR_DEAD_520_CHAR	$MCG
$LINE_ENDING_ZELEMIR_DEAD_520_TEXT	私たちの中に残っていた魔法の欠片も、一緒に。
$LINE_ENDING_ZELEMIR_DEAD_530_CHAR	$MCG
$LINE_ENDING_ZELEMIR_DEAD_530_TEXT	*$HEAがいたら、きっとこうなる理由も説明してくれたでしょうね。
$LINE_ENDING_ZELEMIR_DEAD_540_CHAR	$MAG
$LINE_ENDING_ZELEMIR_DEAD_540_TEXT	*彼はとても立派な人でしたね、$MCG。
$LINE_ENDING_ZELEMIR_DEAD_550_CHAR	$MAG
$LINE_ENDING_ZELEMIR_DEAD_550_TEXT	彼の名は、炎の名誉として刻まれるでしょう。
$LINE_ENDING_ZELEMIR_DEAD_560_CHAR	$MCG
$LINE_ENDING_ZELEMIR_DEAD_560_TEXT	それじゃ、良い旅をね。
$LINE_ENDING_ZELEMIR_DEAD_570_CHAR	$MAG
$LINE_ENDING_ZELEMIR_DEAD_570_TEXT	あなたも。
$LINE_ENDING_ZELEMIR_DEAD_580_CHAR	$MCG
$LINE_ENDING_ZELEMIR_DEAD_580_TEXT	もっと良い状況で、また会えるといいね。
$LINE_ENDING_ZELEMIR_DEAD_590_CHAR	$RAN
$LINE_ENDING_ZELEMIR_DEAD_590_TEXT	やあ。
$LINE_ENDING_ZELEMIR_DEAD_600_CHAR	$MCG
$LINE_ENDING_ZELEMIR_DEAD_600_TEXT	遊牧民と一緒に行くんじゃなかったの？
$LINE_ENDING_ZELEMIR_DEAD_610_CHAR	$RAN
$LINE_ENDING_ZELEMIR_DEAD_610_TEXT	いや、一人で行くつもりだ。
$LINE_ENDING_ZELEMIR_DEAD_620_CHAR	$RAN
$LINE_ENDING_ZELEMIR_DEAD_620_TEXT	こんなになるなんて、思いもよらなかったよ。
$LINE_ENDING_ZELEMIR_DEAD_630_CHAR	$RAN
$LINE_ENDING_ZELEMIR_DEAD_630_TEXT	北に行こうと思ってる・・・<N>まだ、ゲカ民族の生き残りがいるかもしれないからな。
$LINE_ENDING_ZELEMIR_DEAD_640_CHAR	$MCG
$LINE_ENDING_ZELEMIR_DEAD_640_TEXT	旅の無事を祈るわ。
$LINE_ENDING_ZELEMIR_DEAD_650_CHAR	$RAN
$LINE_ENDING_ZELEMIR_DEAD_650_TEXT	ありがとう。君もな。
$LINE_ENDING_ZELEMIR_DEAD_660_CHAR	$DRA
$LINE_ENDING_ZELEMIR_DEAD_660_TEXT	*$MCG。
$LINE_ENDING_ZELEMIR_DEAD_670_CHAR	$MCG
$LINE_ENDING_ZELEMIR_DEAD_670_TEXT	*$DRA。
$LINE_ENDING_ZELEMIR_DEAD_680_CHAR	$DRA
$LINE_ENDING_ZELEMIR_DEAD_680_TEXT	お互いに義務は果たした。私たちの協力関係は、これでおしまいだ。
$LINE_ENDING_ZELEMIR_DEAD_690_CHAR	$DRA
$LINE_ENDING_ZELEMIR_DEAD_690_TEXT	長年蓄えた宝は、奈落が崩壊する時に失ってしまった。<N>しかし、まだ私と他の子どもたちは生きている・・・。
$LINE_ENDING_ZELEMIR_DEAD_700_CHAR	$DRA
$LINE_ENDING_ZELEMIR_DEAD_700_TEXT	・・・決して悪い取り引きではなかった。
$LINE_ENDING_ZELEMIR_DEAD_710_CHAR	$MCG
$LINE_ENDING_ZELEMIR_DEAD_710_TEXT	これから、どこに行くの？
$LINE_ENDING_ZELEMIR_DEAD_720_CHAR	$DRA
$LINE_ENDING_ZELEMIR_DEAD_720_TEXT	もう十分に人間とは遊んだからな。<N>向こう30年は、人間は遠慮したい。
$LINE_ENDING_ZELEMIR_DEAD_730_CHAR	$DRA
$LINE_ENDING_ZELEMIR_DEAD_730_TEXT	ドラゴンの友を探すことにするよ。
$LINE_ENDING_ZELEMIR_DEAD_740_CHAR	$MCG
$LINE_ENDING_ZELEMIR_DEAD_740_TEXT	それじゃ、あなたもいい旅を。
$LINE_ENDING_ZELEMIR_DEAD_750_CHAR	$DRA
$LINE_ENDING_ZELEMIR_DEAD_750_TEXT	火を吹く種族と共に暮らしたければ、我らを探せ。
$LINE_ENDING_ZELEMIR_DEAD_760_CHAR	$MCG
$LINE_ENDING_ZELEMIR_DEAD_760_TEXT	うん、そうするよ。
$LINE_ENDING_ZELEMIR_DEAD_770_CHAR	$BER
$LINE_ENDING_ZELEMIR_DEAD_770_TEXT	よぉ。
$LINE_ENDING_ZELEMIR_DEAD_780_CHAR	$MCG
$LINE_ENDING_ZELEMIR_DEAD_780_TEXT	*$BER、アンタはこれからどうするつもり？
$LINE_ENDING_ZELEMIR_DEAD_790_CHAR	$MCG
$LINE_ENDING_ZELEMIR_DEAD_790_TEXT	新しい冒険を始めるよ。当然だろ！？
$LINE_ENDING_ZELEMIR_DEAD_800_CHAR	$BER
$LINE_ENDING_ZELEMIR_DEAD_800_TEXT	この旅のクソな思い出を忘れるために、新しいことをしようと思うんだ・・・。
$LINE_ENDING_ZELEMIR_DEAD_810_CHAR	$BER
$LINE_ENDING_ZELEMIR_DEAD_810_TEXT	あまりにも多くの悲劇を見すぎたからな・・・。
$LINE_ENDING_ZELEMIR_DEAD_820_CHAR	$BER
$LINE_ENDING_ZELEMIR_DEAD_820_TEXT	こういうのは俺の好みじゃねえ。
$LINE_ENDING_ZELEMIR_DEAD_830_CHAR	$BER
$LINE_ENDING_ZELEMIR_DEAD_830_TEXT	だから、自分のルーツに戻ろうと思うんだ・・・。
$LINE_ENDING_ZELEMIR_DEAD_840_CHAR	$BER
$LINE_ENDING_ZELEMIR_DEAD_840_TEXT	宝探しさ！
$LINE_ENDING_ZELEMIR_DEAD_850_CHAR	$BER
$LINE_ENDING_ZELEMIR_DEAD_850_TEXT	でも、信頼できるパートナーがほしいな・・・。
$LINE_ENDING_ZELEMIR_DEAD_860_CHAR	$MCG
$LINE_ENDING_ZELEMIR_DEAD_860_TEXT	*・・・$RANは、北に行くみたいよ。<N>今出れば、追いつけるかも。
$LINE_ENDING_ZELEMIR_DEAD_870_CHAR	$BER
$LINE_ENDING_ZELEMIR_DEAD_870_TEXT	そりゃいい！
$LINE_ENDING_ZELEMIR_DEAD_880_CHAR	$BER
$LINE_ENDING_ZELEMIR_DEAD_880_TEXT	たくさん宝を持っているだろうからな。<N>盗んでやろう！
$LINE_ENDING_ZELEMIR_DEAD_890_CHAR	$MCG
$LINE_ENDING_ZELEMIR_DEAD_890_TEXT	そういうつもりで言ったんじゃ―
$LINE_ENDING_ZELEMIR_DEAD_900_CHAR	$BER
$LINE_ENDING_ZELEMIR_DEAD_900_TEXT	もう遅いぜ！計画は進行中さ！
$LINE_ENDING_ZELEMIR_DEAD_910_CHAR	$MCG
$LINE_ENDING_ZELEMIR_DEAD_910_TEXT	*・・・またね、$BER。
$LINE_ENDING_ZELEMIR_DEAD_920_CHAR	アッシュ王国の難民
$LINE_ENDING_ZELEMIR_DEAD_920_TEXT	お嬢さん、今日という日を無駄にしないため、そろそろ出発しましょう。
$LINE_ENDING_ZELEMIR_DEAD_930_CHAR	$MCG
$LINE_ENDING_ZELEMIR_DEAD_930_TEXT	わかってる・・・
$LINE_ENDING_ZELEMIR_DEAD_940_CHAR	$MCG
$LINE_ENDING_ZELEMIR_DEAD_940_TEXT	少し時間をちょうだい。
$LINE_ENDING_ZELEMIR_DEAD_950_CHAR	$MCG
$LINE_ENDING_ZELEMIR_DEAD_950_TEXT	・・・
$SCENE_ENDING_ZELEMIR_WOUNDED_TITLE	ほろ苦い結末
$NARR_ENDING_ZELEMIR_WOUNDED_00_TEXT	何日間にもおよぶ話し合い。
$NARR_ENDING_ZELEMIR_WOUNDED_10_TEXT	遊牧民のキャラバンは、金を支払うと、喜んで、食べ物を与えてくれた。
$NARR_ENDING_ZELEMIR_WOUNDED_20_TEXT	難民のリーダーたちは、順番に話す機会を与えられる。
$NARR_ENDING_ZELEMIR_WOUNDED_30_TEXT	でも、みんなは、生きていることが嬉し過ぎて、議論どころではない。
$NARR_ENDING_ZELEMIR_WOUNDED_40_TEXT	外の空気を気がねなく吸えるだなんて、不思議な感じだ。<N>まだ慣れない。
$NARR_ENDING_ZELEMIR_WOUNDED_50_TEXT	やがて、皆の意見がまとまる。
$LINE_ENDING_ZELEMIR_WOUNDED_00_CHAR	$RAN
$LINE_ENDING_ZELEMIR_WOUNDED_00_TEXT	*$MCG、奈落が崩壊してる！
$LINE_ENDING_ZELEMIR_WOUNDED_10_CHAR	$RAN
$LINE_ENDING_ZELEMIR_WOUNDED_10_TEXT	この生と死のはざまで、いつまで安全でいられるの？
$LINE_ENDING_ZELEMIR_WOUNDED_20_CHAR	$MCG
$LINE_ENDING_ZELEMIR_WOUNDED_20_TEXT	そう長くはないよ。石に押しつぶされれば、命はない！
$LINE_ENDING_ZELEMIR_WOUNDED_30_CHAR	$MCG
$LINE_ENDING_ZELEMIR_WOUNDED_30_TEXT	*待って！ゼレミアと$HEAを別の世界に送り込めたんだから・・・
$LINE_ENDING_ZELEMIR_WOUNDED_40_CHAR	$MCG
$LINE_ENDING_ZELEMIR_WOUNDED_40_TEXT	多分、私たち全員を・・・送り込めるかもしれない・・・。
$LINE_ENDING_ZELEMIR_WOUNDED_50_CHAR	$RAN
$LINE_ENDING_ZELEMIR_WOUNDED_50_TEXT	えっ、向こう側の世界に？
$LINE_ENDING_ZELEMIR_WOUNDED_60_CHAR	$RAN
$LINE_ENDING_ZELEMIR_WOUNDED_60_TEXT	ありがたいけど、それなら崩壊に巻き込まれて、押し潰された方がマシだよ。
$LINE_ENDING_ZELEMIR_WOUNDED_70_CHAR	$MCG
$LINE_ENDING_ZELEMIR_WOUNDED_70_TEXT	そうじゃなくて！元の場所に送れるかも・・・。この奈落の外へ・・・。私たちが元いた場所へ・・・。
$LINE_ENDING_ZELEMIR_WOUNDED_80_CHAR	$RAN
$LINE_ENDING_ZELEMIR_WOUNDED_80_TEXT	じゃあ、なるべく急いで――
$LINE_ENDING_ZELEMIR_WOUNDED_90_CHAR	$RAN
$LINE_ENDING_ZELEMIR_WOUNDED_90_TEXT	――やっちゃって。状況はもう・・・って早っ。
$LINE_ENDING_ZELEMIR_WOUNDED_100_CHAR	$RAN
$LINE_ENDING_ZELEMIR_WOUNDED_100_TEXT	*やったよ、$MCG！
$LINE_ENDING_ZELEMIR_WOUNDED_110_CHAR	$MCG
$LINE_ENDING_ZELEMIR_WOUNDED_110_TEXT	*$MAG、この傷、診てくれる？とても痛むの。
$LINE_ENDING_ZELEMIR_WOUNDED_120_CHAR	$MAG
$LINE_ENDING_ZELEMIR_WOUNDED_120_TEXT	これはひどい傷ですね。骨折してるかも・・・。
$LINE_ENDING_ZELEMIR_WOUNDED_130_CHAR	$MAG
$LINE_ENDING_ZELEMIR_WOUNDED_130_TEXT	ひとまず、添え木を当てて、包帯を巻きましょう。
$LINE_ENDING_ZELEMIR_WOUNDED_140_CHAR	$MAG
$LINE_ENDING_ZELEMIR_WOUNDED_140_TEXT	ともかく・・・
$LINE_ENDING_ZELEMIR_WOUNDED_150_CHAR	$MAG
$LINE_ENDING_ZELEMIR_WOUNDED_150_TEXT	・・・
$LINE_ENDING_ZELEMIR_WOUNDED_160_CHAR	$MCG
$LINE_ENDING_ZELEMIR_WOUNDED_160_TEXT	*$MAG？
$LINE_ENDING_ZELEMIR_WOUNDED_170_CHAR	$MAG
$LINE_ENDING_ZELEMIR_WOUNDED_170_TEXT	彼は行ってしまった・・・。
$LINE_ENDING_ZELEMIR_WOUNDED_180_CHAR	$MCG
$LINE_ENDING_ZELEMIR_WOUNDED_180_TEXT	二人とも、ね。
$LINE_ENDING_ZELEMIR_WOUNDED_190_CHAR	$MAG
$LINE_ENDING_ZELEMIR_WOUNDED_190_TEXT	裁きが下ったのでしょう・・・。それでも、やっぱり、何だか・・・
$LINE_ENDING_ZELEMIR_WOUNDED_200_CHAR	$MCG
$LINE_ENDING_ZELEMIR_WOUNDED_200_TEXT	厳しい正義より、温かい慈悲の方が、大切なんじゃないかな。
$LINE_ENDING_ZELEMIR_WOUNDED_210_CHAR	$MAG
$LINE_ENDING_ZELEMIR_WOUNDED_210_TEXT	・・・。
$LINE_ENDING_ZELEMIR_WOUNDED_220_CHAR	$MAG
$LINE_ENDING_ZELEMIR_WOUNDED_220_TEXT	*$MCG、この人たちは、どうしましょう？
$LINE_ENDING_ZELEMIR_WOUNDED_230_CHAR	$MAG
$LINE_ENDING_ZELEMIR_WOUNDED_230_TEXT	何千人もいますよ。
$LINE_ENDING_ZELEMIR_WOUNDED_240_CHAR	$MAG
$LINE_ENDING_ZELEMIR_WOUNDED_240_TEXT	この人たちをどうやって食べさせてやれば・・・。
$LINE_ENDING_ZELEMIR_WOUNDED_250_CHAR	$MAG
$LINE_ENDING_ZELEMIR_WOUNDED_250_TEXT	ここら辺の遊牧民は、ガラクタなんかと物々交換はしたがらないでしょうしね。
$LINE_ENDING_ZELEMIR_WOUNDED_260_CHAR	$DRA
$LINE_ENDING_ZELEMIR_WOUNDED_260_TEXT	おい！人間ども！
$LINE_ENDING_ZELEMIR_WOUNDED_270_CHAR	$MAG
$LINE_ENDING_ZELEMIR_WOUNDED_270_TEXT	・・・
$LINE_ENDING_ZELEMIR_WOUNDED_280_CHAR	$DRA
$LINE_ENDING_ZELEMIR_WOUNDED_280_TEXT	この忌々しいガラクタをどこかに持って行け！
$LINE_ENDING_ZELEMIR_WOUNDED_290_CHAR	$DRA
$LINE_ENDING_ZELEMIR_WOUNDED_290_TEXT	お前らと同じ、変な臭いがするんだ。
$LINE_ENDING_ZELEMIR_WOUNDED_300_CHAR	$DRA
$LINE_ENDING_ZELEMIR_WOUNDED_300_TEXT	神々には必要ないものだ。
$LINE_ENDING_ZELEMIR_WOUNDED_310_CHAR	$MAG
$LINE_ENDING_ZELEMIR_WOUNDED_310_TEXT	・・・ありがとう・・・。
$LINE_ENDING_ZELEMIR_WOUNDED_320_CHAR	$DRA
$LINE_ENDING_ZELEMIR_WOUNDED_320_TEXT	うん？人間よ、勘違いするな！これは命令だ！
$LINE_ENDING_ZELEMIR_WOUNDED_330_CHAR	$DRA
$LINE_ENDING_ZELEMIR_WOUNDED_330_TEXT	この目ざわりな物品を持ちされ！ただちにだ！
$LINE_ENDING_ZELEMIR_WOUNDED_340_CHAR	$MCG
$LINE_ENDING_ZELEMIR_WOUNDED_340_TEXT	もちろんそうしますよ、ドラゴン様。
$LINE_ENDING_ZELEMIR_WOUNDED_350_CHAR	$MCG
$LINE_ENDING_ZELEMIR_WOUNDED_350_TEXT	・・・で、あなたはこれからどうするおつもり？
$LINE_ENDING_ZELEMIR_WOUNDED_360_CHAR	$DRA
$LINE_ENDING_ZELEMIR_WOUNDED_360_TEXT	しばらくは、人間どもとの付き合いは遠慮するさ。
$LINE_ENDING_ZELEMIR_WOUNDED_370_CHAR	$DRA
$LINE_ENDING_ZELEMIR_WOUNDED_370_TEXT	仲間の元に戻るよ・・・。
$LINE_ENDING_ZELEMIR_WOUNDED_380_CHAR	$DRA
$LINE_ENDING_ZELEMIR_WOUNDED_380_TEXT	子を育てるには、伴侶が必要だしな。
$LINE_ENDING_ZELEMIR_WOUNDED_390_CHAR	$DRA
$LINE_ENDING_ZELEMIR_WOUNDED_390_TEXT	私の傷んだ翼では、大空を舞うことの素晴らしさを子に伝えてやれん。
$LINE_ENDING_ZELEMIR_WOUNDED_400_CHAR	$MAG
$LINE_ENDING_ZELEMIR_WOUNDED_400_TEXT	さよなら、友よ。あなたのそばにいつも炎の温かさがあらんことを。
$LINE_ENDING_ZELEMIR_WOUNDED_410_CHAR	$DRA
$LINE_ENDING_ZELEMIR_WOUNDED_410_TEXT	貴様もな・・・。
$LINE_ENDING_ZELEMIR_WOUNDED_420_CHAR	$MAG
$LINE_ENDING_ZELEMIR_WOUNDED_420_TEXT	・・・お前のことを、見誤っていたよ、炎の子よ。
$LINE_ENDING_ZELEMIR_WOUNDED_430_CHAR	$MCG
$LINE_ENDING_ZELEMIR_WOUNDED_430_TEXT	今のって、つまり・・・？
$LINE_ENDING_ZELEMIR_WOUNDED_440_CHAR	$MAG
$LINE_ENDING_ZELEMIR_WOUNDED_440_TEXT	ふふ。まあ、これで間違いなく飢え死にすることはなくなりましたよ。
$LINE_ENDING_ZELEMIR_WOUNDED_450_CHAR	$MCG
$LINE_ENDING_ZELEMIR_WOUNDED_450_TEXT	*$MAG。
$LINE_ENDING_ZELEMIR_WOUNDED_460_CHAR	$MAG
$LINE_ENDING_ZELEMIR_WOUNDED_460_TEXT	*$MCG。
$LINE_ENDING_ZELEMIR_WOUNDED_470_CHAR	$MAG
$LINE_ENDING_ZELEMIR_WOUNDED_470_TEXT	彼を置いて去るのは、妙な気分です・・・。
$LINE_ENDING_ZELEMIR_WOUNDED_480_CHAR	$MAG
$LINE_ENDING_ZELEMIR_WOUNDED_480_TEXT	命を助けてもらいました。
$LINE_ENDING_ZELEMIR_WOUNDED_490_CHAR	$MAG
$LINE_ENDING_ZELEMIR_WOUNDED_490_TEXT	恩返ししようと思ってたのに、どこかへ消えてしまった。
$LINE_ENDING_ZELEMIR_WOUNDED_500_CHAR	$MCG
$LINE_ENDING_ZELEMIR_WOUNDED_500_TEXT	傷を癒すことが、きっと一番の恩返しだよ・・・。
$LINE_ENDING_ZELEMIR_WOUNDED_510_CHAR	$MCG
$LINE_ENDING_ZELEMIR_WOUNDED_510_TEXT	・・・彼も、きっとそれを願ってる。
$LINE_ENDING_ZELEMIR_WOUNDED_520_CHAR	$MAG
$LINE_ENDING_ZELEMIR_WOUNDED_520_TEXT	ええ、あなたもね。
$LINE_ENDING_ZELEMIR_WOUNDED_530_CHAR	$MAG
$LINE_ENDING_ZELEMIR_WOUNDED_530_TEXT	生き残った民を率いて国に戻り、クウェイド帝国に栄光を取り戻します。
$LINE_ENDING_ZELEMIR_WOUNDED_540_CHAR	$MAG
$LINE_ENDING_ZELEMIR_WOUNDED_540_TEXT	炎の神は、それ以下のものは望んでいません。
$LINE_ENDING_ZELEMIR_WOUNDED_550_CHAR	$MCG
$LINE_ENDING_ZELEMIR_WOUNDED_550_TEXT	大丈夫なの？・・・その・・・力は？
$LINE_ENDING_ZELEMIR_WOUNDED_560_CHAR	$MAG
$LINE_ENDING_ZELEMIR_WOUNDED_560_TEXT	*$MCG、私は炎の子なのです！<N>生まれた時から、弓矢と剣術の修練を積んできたのですよ。
$LINE_ENDING_ZELEMIR_WOUNDED_570_CHAR	$MAG
$LINE_ENDING_ZELEMIR_WOUNDED_570_TEXT	能力が消えたのは妙な心持ですが、・・・心の中から寒さが消えて、すごく嬉しいのです。
$LINE_ENDING_ZELEMIR_WOUNDED_580_CHAR	$MAG
$LINE_ENDING_ZELEMIR_WOUNDED_580_TEXT	あなたの力は？
$LINE_ENDING_ZELEMIR_WOUNDED_590_CHAR	$MCG
$LINE_ENDING_ZELEMIR_WOUNDED_590_TEXT	能力がなくなって・・・不完全なように感じるけれど。
$LINE_ENDING_ZELEMIR_WOUNDED_600_CHAR	$MCG
$LINE_ENDING_ZELEMIR_WOUNDED_600_TEXT	・・・再び自分らしくなれたのは、とても嬉しい。
$LINE_ENDING_ZELEMIR_WOUNDED_610_CHAR	$MCG
$LINE_ENDING_ZELEMIR_WOUNDED_610_TEXT	きっと、エズティル・テノクと共に、魔法も死んだんだろうね。
$LINE_ENDING_ZELEMIR_WOUNDED_620_CHAR	$MCG
$LINE_ENDING_ZELEMIR_WOUNDED_620_TEXT	私たちの中に残っていた能力も一緒に。
$LINE_ENDING_ZELEMIR_WOUNDED_630_CHAR	$MCG
$LINE_ENDING_ZELEMIR_WOUNDED_630_TEXT	*きっと、$HEAさんは、こうなる理由がわかってたんじゃないかな。
$LINE_ENDING_ZELEMIR_WOUNDED_640_CHAR	$MAG
$LINE_ENDING_ZELEMIR_WOUNDED_640_TEXT	*彼はとても立派な人でしたね、$MCG。
$LINE_ENDING_ZELEMIR_WOUNDED_650_CHAR	$MAG
$LINE_ENDING_ZELEMIR_WOUNDED_650_TEXT	彼の名は、炎の名誉として刻まれるでしょう。
$LINE_ENDING_ZELEMIR_WOUNDED_660_CHAR	$MCG
$LINE_ENDING_ZELEMIR_WOUNDED_660_TEXT	あなたの道に幸運があらんことを祈ってるわ。
$LINE_ENDING_ZELEMIR_WOUNDED_670_CHAR	$MAG
$LINE_ENDING_ZELEMIR_WOUNDED_670_TEXT	あなたも。炎の友よ。
$LINE_ENDING_ZELEMIR_WOUNDED_680_CHAR	$MAG
$LINE_ENDING_ZELEMIR_WOUNDED_680_TEXT	恩人のことは、絶対に忘れません・・・。
$LINE_ENDING_ZELEMIR_WOUNDED_690_CHAR	$MAG
$LINE_ENDING_ZELEMIR_WOUNDED_690_TEXT	では、またどこかで。
$LINE_ENDING_ZELEMIR_WOUNDED_700_CHAR	$MCG
$LINE_ENDING_ZELEMIR_WOUNDED_700_TEXT	じゃあね！
$LINE_ENDING_ZELEMIR_WOUNDED_710_CHAR	$BER
$LINE_ENDING_ZELEMIR_WOUNDED_710_TEXT	よぉ。
$LINE_ENDING_ZELEMIR_WOUNDED_720_CHAR	$MCG
$LINE_ENDING_ZELEMIR_WOUNDED_720_TEXT	*$BER、アンタはこれからどうするつもり？
$LINE_ENDING_ZELEMIR_WOUNDED_730_CHAR	$MCG
$LINE_ENDING_ZELEMIR_WOUNDED_730_TEXT	一緒に、アッシュ王国に戻る？
$LINE_ENDING_ZELEMIR_WOUNDED_740_CHAR	$BER
$LINE_ENDING_ZELEMIR_WOUNDED_740_TEXT	いや、それより先に、しなきゃいけないことがあるんだ・・・。
$LINE_ENDING_ZELEMIR_WOUNDED_750_CHAR	$BER
$LINE_ENDING_ZELEMIR_WOUNDED_750_TEXT	*$HEAは、とても立派だったな・・・。
$LINE_ENDING_ZELEMIR_WOUNDED_760_CHAR	$MCG
$LINE_ENDING_ZELEMIR_WOUNDED_760_TEXT	うん、立派だった。
$LINE_ENDING_ZELEMIR_WOUNDED_770_CHAR	$BER
$LINE_ENDING_ZELEMIR_WOUNDED_770_TEXT	だから、彼の旅立ちを祝ってやろう・・・伝統的なやり方で。
$LINE_ENDING_ZELEMIR_WOUNDED_780_CHAR	$MCG
$LINE_ENDING_ZELEMIR_WOUNDED_780_TEXT	伝統的な？
$LINE_ENDING_ZELEMIR_WOUNDED_790_CHAR	$BER
$LINE_ENDING_ZELEMIR_WOUNDED_790_TEXT	たくさん殺して、たくさん飲んで、さらにたくさん殺す。
$LINE_ENDING_ZELEMIR_WOUNDED_800_CHAR	$BER
$LINE_ENDING_ZELEMIR_WOUNDED_800_TEXT	裸で踊って、体を真っ青に色付けして、たくさん殺す。
$LINE_ENDING_ZELEMIR_WOUNDED_810_CHAR	$MCG
$LINE_ENDING_ZELEMIR_WOUNDED_810_TEXT	うーん・・・何となくだけど、彼はそんなことは望んでいないんじゃない？
$LINE_ENDING_ZELEMIR_WOUNDED_820_CHAR	$BER
$LINE_ENDING_ZELEMIR_WOUNDED_820_TEXT	俺は、彼が立派なやつだったと言っただけだ。正しいやつだとは言ってないぜ！
$LINE_ENDING_ZELEMIR_WOUNDED_830_CHAR	$BER
$LINE_ENDING_ZELEMIR_WOUNDED_830_TEXT	さあ、暴れまくるぜ！
$LINE_ENDING_ZELEMIR_WOUNDED_840_CHAR	$MCG
$LINE_ENDING_ZELEMIR_WOUNDED_840_TEXT	彼がいないと寂しくなるな。
$LINE_ENDING_ZELEMIR_WOUNDED_850_CHAR	$RAN
$LINE_ENDING_ZELEMIR_WOUNDED_850_TEXT	やあ。
$LINE_ENDING_ZELEMIR_WOUNDED_860_CHAR	$MCG
$LINE_ENDING_ZELEMIR_WOUNDED_860_TEXT	あれ、遊牧民と一緒に旅を続けるんじゃなかったの？
$LINE_ENDING_ZELEMIR_WOUNDED_870_CHAR	$RAN
$LINE_ENDING_ZELEMIR_WOUNDED_870_TEXT	いや、やっぱり、やめたんだ。
$LINE_ENDING_ZELEMIR_WOUNDED_880_CHAR	$RAN
$LINE_ENDING_ZELEMIR_WOUNDED_880_TEXT	なんていうかさ・・・
$LINE_ENDING_ZELEMIR_WOUNDED_890_CHAR	$RAN
$LINE_ENDING_ZELEMIR_WOUNDED_890_TEXT	目の前にでっかい世界が広がっているんだな、って。
$LINE_ENDING_ZELEMIR_WOUNDED_900_CHAR	$RAN
$LINE_ENDING_ZELEMIR_WOUNDED_900_TEXT	ゲカ民族の生き残りだっているかもしれない。
$LINE_ENDING_ZELEMIR_WOUNDED_910_CHAR	$RAN
$LINE_ENDING_ZELEMIR_WOUNDED_910_TEXT	もしそうだとしたら、助けを必要としているかもしれない。
$LINE_ENDING_ZELEMIR_WOUNDED_920_CHAR	$RAN
$LINE_ENDING_ZELEMIR_WOUNDED_920_TEXT	あとは、ほら、放浪してみようかなって。
$LINE_ENDING_ZELEMIR_WOUNDED_930_CHAR	$MCG
$LINE_ENDING_ZELEMIR_WOUNDED_930_TEXT	*・・・$BERは、冒険を求めてるみたいよ。
$LINE_ENDING_ZELEMIR_WOUNDED_940_CHAR	$RAN
$LINE_ENDING_ZELEMIR_WOUNDED_940_TEXT	本当？アイツか・・・うーん・・・。
$LINE_ENDING_ZELEMIR_WOUNDED_950_CHAR	$RAN
$LINE_ENDING_ZELEMIR_WOUNDED_950_TEXT	まあ、いい戦友になるだろうな。
$LINE_ENDING_ZELEMIR_WOUNDED_960_CHAR	$RAN
$LINE_ENDING_ZELEMIR_WOUNDED_960_TEXT	それに、あいつから金を返してもらっていないしなあ・・・。
$LINE_ENDING_ZELEMIR_WOUNDED_970_CHAR	$MCG
$LINE_ENDING_ZELEMIR_WOUNDED_970_TEXT	彼はその道を行ったよ。
$LINE_ENDING_ZELEMIR_WOUNDED_980_CHAR	$RAN
$LINE_ENDING_ZELEMIR_WOUNDED_980_TEXT	*ありがとう、$MCG。
$LINE_ENDING_ZELEMIR_WOUNDED_990_CHAR	$MCG
$LINE_ENDING_ZELEMIR_WOUNDED_990_TEXT	どういたしまして。
$LINE_ENDING_ZELEMIR_WOUNDED_1000_CHAR	$KNI
$LINE_ENDING_ZELEMIR_WOUNDED_1000_TEXT	お嬢様。
$LINE_ENDING_ZELEMIR_WOUNDED_1010_CHAR	$MCG
$LINE_ENDING_ZELEMIR_WOUNDED_1010_TEXT	*$KNI。
$LINE_ENDING_ZELEMIR_WOUNDED_1020_CHAR	$KNI
$LINE_ENDING_ZELEMIR_WOUNDED_1020_TEXT	あなたが準備でき次第、アッシュ王国の難民たちはすぐに出発できるそうですよ。
$LINE_ENDING_ZELEMIR_WOUNDED_1030_CHAR	$MCG
$LINE_ENDING_ZELEMIR_WOUNDED_1030_TEXT	*$KNI、あなたはどうするの？都に戻りたいんでしょう？
$LINE_ENDING_ZELEMIR_WOUNDED_1040_CHAR	$KNI
$LINE_ENDING_ZELEMIR_WOUNDED_1040_TEXT	彼らは、私の王国の民ですから。<N>それに、まだお嬢様への借りを返していませんよ。
$LINE_ENDING_ZELEMIR_WOUNDED_1050_CHAR	$KNI
$LINE_ENDING_ZELEMIR_WOUNDED_1050_TEXT	それまでは、あなたについていきます。
$LINE_ENDING_ZELEMIR_WOUNDED_1060_CHAR	$MCG
$LINE_ENDING_ZELEMIR_WOUNDED_1060_TEXT	もう、借りは返してもらったよ。あなたは約束を守ったわ。
$LINE_ENDING_ZELEMIR_WOUNDED_1070_CHAR	$KNI
$LINE_ENDING_ZELEMIR_WOUNDED_1070_TEXT	では、友人として、旅の供をしても？
$LINE_ENDING_ZELEMIR_WOUNDED_1080_CHAR	$MCG
$LINE_ENDING_ZELEMIR_WOUNDED_1080_TEXT	もちろん。長くて危険な旅になるかもしれないけれど・・・<N>私―いえ、皆もあなたについて来てほしいと思うわ。
$LINE_ENDING_ZELEMIR_WOUNDED_1090_CHAR	$KNI
$LINE_ENDING_ZELEMIR_WOUNDED_1090_TEXT	彼らと一緒に旅ができて、嬉しいですよ、お嬢様。
$LINE_ENDING_ZELEMIR_WOUNDED_1100_CHAR	$MCG
$LINE_ENDING_ZELEMIR_WOUNDED_1100_TEXT	*私のことは、$MCGって呼んで。ね？
$LINE_ENDING_ZELEMIR_WOUNDED_1110_CHAR	$KNI
$LINE_ENDING_ZELEMIR_WOUNDED_1110_TEXT	*わかりました、$MCGお嬢様。
$LINE_ENDING_ZELEMIR_WOUNDED_1120_CHAR	$MCG
$LINE_ENDING_ZELEMIR_WOUNDED_1120_TEXT	オッケー、もう一回やってみて。<N>今度は、お嬢様なしで。
$LINE_ENDING_ZELEMIR_WOUNDED_1130_CHAR	$KNI
$LINE_ENDING_ZELEMIR_WOUNDED_1130_TEXT	あまり意地悪しないでください。
$SCENE_ENDING_ZELEMIR_UNSCATHED_TITLE	栄光の結末
$NARR_ENDING_ZELEMIR_UNSCATHED_00_TEXT	何日間にもおよぶ話し合い。
$NARR_ENDING_ZELEMIR_UNSCATHED_10_TEXT	遊牧民のキャラバンは、金を支払うと、喜んで、食べ物を与えてくれた。
$NARR_ENDING_ZELEMIR_UNSCATHED_20_TEXT
$NARR_ENDING_ZELEMIR_UNSCATHED_30_TEXT	でも、みんなは、生きていることが嬉し過ぎて、議論どころではない。
$NARR_ENDING_ZELEMIR_UNSCATHED_40_TEXT	外の空気を気がねなく吸えるだなんて、不思議な感じだ。<N>まだ慣れない。
$NARR_ENDING_ZELEMIR_UNSCATHED_50_TEXT	やがて、皆の意見がまとまる。
$LINE_ENDING_ZELEMIR_UNSCATHED_00_CHAR	$RAN
$LINE_ENDING_ZELEMIR_UNSCATHED_00_TEXT	*$MCG、奈落が崩壊してる！
$LINE_ENDING_ZELEMIR_UNSCATHED_10_CHAR	$RAN
$LINE_ENDING_ZELEMIR_UNSCATHED_10_TEXT	この生と死のはざまで、いつまで安全でいられるの？
$LINE_ENDING_ZELEMIR_UNSCATHED_20_CHAR	$MCG
$LINE_ENDING_ZELEMIR_UNSCATHED_20_TEXT	そう長くはないよ。石に押しつぶされれば、命はない！
$LINE_ENDING_ZELEMIR_UNSCATHED_30_CHAR	$MCG
$LINE_ENDING_ZELEMIR_UNSCATHED_30_TEXT	*待って！ゼレミアと$HEAを別の世界に送り込めたんだから・・・
$LINE_ENDING_ZELEMIR_UNSCATHED_40_CHAR	$MCG
$LINE_ENDING_ZELEMIR_UNSCATHED_40_TEXT	多分、私たち全員を・・・送り込めるかもしれない・・・。
$LINE_ENDING_ZELEMIR_UNSCATHED_50_CHAR	$RAN
$LINE_ENDING_ZELEMIR_UNSCATHED_50_TEXT	えっ、向こう側の世界に？
$LINE_ENDING_ZELEMIR_UNSCATHED_60_CHAR	$RAN
$LINE_ENDING_ZELEMIR_UNSCATHED_60_TEXT	ありがたいけど、それなら崩壊に巻き込まれて、押し潰された方がマシだよ。
$LINE_ENDING_ZELEMIR_UNSCATHED_70_CHAR	$MCG
$LINE_ENDING_ZELEMIR_UNSCATHED_70_TEXT	そうじゃなくて！元の場所に送れるかも・・・。この奈落の外へ・・・。私たちが元いた場所へ・・・。
$LINE_ENDING_ZELEMIR_UNSCATHED_80_CHAR	$RAN
$LINE_ENDING_ZELEMIR_UNSCATHED_80_TEXT	じゃあ、なるべく急いで――
$LINE_ENDING_ZELEMIR_UNSCATHED_90_CHAR	$RAN
$LINE_ENDING_ZELEMIR_UNSCATHED_90_TEXT	――やっちゃって。状況はもう・・・って早っ。
$LINE_ENDING_ZELEMIR_UNSCATHED_100_CHAR	$RAN
$LINE_ENDING_ZELEMIR_UNSCATHED_100_TEXT	*やったよ、$MCG！
$LINE_ENDING_ZELEMIR_UNSCATHED_110_CHAR	$MCG
$LINE_ENDING_ZELEMIR_UNSCATHED_110_TEXT	*$MAG、この傷、診てくれる？とても痛むの。
$LINE_ENDING_ZELEMIR_UNSCATHED_120_CHAR	$MAG
$LINE_ENDING_ZELEMIR_UNSCATHED_120_TEXT	これはひどい傷ですね。骨折してるかも・・・。
$LINE_ENDING_ZELEMIR_UNSCATHED_130_CHAR	$MAG
$LINE_ENDING_ZELEMIR_UNSCATHED_130_TEXT	ひとまず、添え木を当てて、包帯を巻きましょう。ともかく・・・
$LINE_ENDING_ZELEMIR_UNSCATHED_140_CHAR	$MAG
$LINE_ENDING_ZELEMIR_UNSCATHED_140_TEXT	この人たちは、どうしましょう？
$LINE_ENDING_ZELEMIR_UNSCATHED_150_CHAR	$MAG
$LINE_ENDING_ZELEMIR_UNSCATHED_150_TEXT	何千人もいますよ。
$LINE_ENDING_ZELEMIR_UNSCATHED_160_CHAR	$MAG
$LINE_ENDING_ZELEMIR_UNSCATHED_160_TEXT	この人たちをどうやって食べさせてやれば・・・。
$LINE_ENDING_ZELEMIR_UNSCATHED_170_CHAR	$MAG
$LINE_ENDING_ZELEMIR_UNSCATHED_170_TEXT	ここら辺の遊牧民は、ガラクタなんかと物々交換はしたがらないでしょうしね。
$LINE_ENDING_ZELEMIR_UNSCATHED_180_CHAR	$DRA
$LINE_ENDING_ZELEMIR_UNSCATHED_180_TEXT	おい！人間ども！
$LINE_ENDING_ZELEMIR_UNSCATHED_190_CHAR	$MAG
$LINE_ENDING_ZELEMIR_UNSCATHED_190_TEXT	・・・
$LINE_ENDING_ZELEMIR_UNSCATHED_200_CHAR	$DRA
$LINE_ENDING_ZELEMIR_UNSCATHED_200_TEXT	この忌々しいガラクタをどこかに持って行け！
$LINE_ENDING_ZELEMIR_UNSCATHED_210_CHAR	$DRA
$LINE_ENDING_ZELEMIR_UNSCATHED_210_TEXT	お前らと同じ、変な臭いがするんだ。
$LINE_ENDING_ZELEMIR_UNSCATHED_220_CHAR	$DRA
$LINE_ENDING_ZELEMIR_UNSCATHED_220_TEXT	神々には必要ないものだ。
$LINE_ENDING_ZELEMIR_UNSCATHED_230_CHAR	$MAG
$LINE_ENDING_ZELEMIR_UNSCATHED_230_TEXT	・・・ありがとう・・・。
$LINE_ENDING_ZELEMIR_UNSCATHED_240_CHAR	$DRA
$LINE_ENDING_ZELEMIR_UNSCATHED_240_TEXT	うん？人間よ、勘違いするな！これは命令だ！
$LINE_ENDING_ZELEMIR_UNSCATHED_250_CHAR	$DRA
$LINE_ENDING_ZELEMIR_UNSCATHED_250_TEXT	この目ざわりな物品を持ちされ！ただちにだ！
$LINE_ENDING_ZELEMIR_UNSCATHED_260_CHAR	$MCG
$LINE_ENDING_ZELEMIR_UNSCATHED_260_TEXT	もちろんそうしますよ、ドラゴン様。
$LINE_ENDING_ZELEMIR_UNSCATHED_270_CHAR	$MCG
$LINE_ENDING_ZELEMIR_UNSCATHED_270_TEXT	・・・で、あなたはこれからどうするおつもり？
$LINE_ENDING_ZELEMIR_UNSCATHED_280_CHAR	$DRA
$LINE_ENDING_ZELEMIR_UNSCATHED_280_TEXT	しばらくは、人間どもとの付き合いは遠慮するさ。
$LINE_ENDING_ZELEMIR_UNSCATHED_290_CHAR	$DRA
$LINE_ENDING_ZELEMIR_UNSCATHED_290_TEXT	仲間の元に戻るよ・・・。
$LINE_ENDING_ZELEMIR_UNSCATHED_300_CHAR	$DRA
$LINE_ENDING_ZELEMIR_UNSCATHED_300_TEXT	子を育てるには、伴侶が必要だしな。
$LINE_ENDING_ZELEMIR_UNSCATHED_310_CHAR	$DRA
$LINE_ENDING_ZELEMIR_UNSCATHED_310_TEXT	私の傷んだ翼では、大空を舞うことの素晴らしさを子に伝えてやれん。
$LINE_ENDING_ZELEMIR_UNSCATHED_320_CHAR	$MAG
$LINE_ENDING_ZELEMIR_UNSCATHED_320_TEXT	さよなら、友よ。あなたのそばにいつも炎の温かさがあらんことを。
$LINE_ENDING_ZELEMIR_UNSCATHED_330_CHAR	$DRA
$LINE_ENDING_ZELEMIR_UNSCATHED_330_TEXT	貴様もな・・・。
$LINE_ENDING_ZELEMIR_UNSCATHED_340_CHAR	$MAG
$LINE_ENDING_ZELEMIR_UNSCATHED_340_TEXT	・・・お前のことを、見誤っていたよ、炎の子よ。
$LINE_ENDING_ZELEMIR_UNSCATHED_350_CHAR	$MCG
$LINE_ENDING_ZELEMIR_UNSCATHED_350_TEXT	今のって、つまり・・・？
$LINE_ENDING_ZELEMIR_UNSCATHED_360_CHAR	$MAG
$LINE_ENDING_ZELEMIR_UNSCATHED_360_TEXT	ふふ。まあ、これで間違いなく飢え死にすることはなくなりましたよ。
$LINE_ENDING_ZELEMIR_UNSCATHED_370_CHAR	$MCG
$LINE_ENDING_ZELEMIR_UNSCATHED_370_TEXT	ご老師、私たちと一緒に戻りますか？
$LINE_ENDING_ZELEMIR_UNSCATHED_380_CHAR	$HEA
$LINE_ENDING_ZELEMIR_UNSCATHED_380_TEXT	わからない・・・。
$LINE_ENDING_ZELEMIR_UNSCATHED_390_CHAR	$HEA
$LINE_ENDING_ZELEMIR_UNSCATHED_390_TEXT	こんな日を迎えるだなんて、奇妙な心地だ。
$LINE_ENDING_ZELEMIR_UNSCATHED_400_CHAR	$HEA
$LINE_ENDING_ZELEMIR_UNSCATHED_400_TEXT	まさか・・・こんなに長く生きるとは、思わなかったよ。
$LINE_ENDING_ZELEMIR_UNSCATHED_410_CHAR	$MCG
$LINE_ENDING_ZELEMIR_UNSCATHED_410_TEXT	きっと、一瞬ではなく一生かけて罪をつぐなわなければいけないのでしょう。
$LINE_ENDING_ZELEMIR_UNSCATHED_420_CHAR	$HEA
$LINE_ENDING_ZELEMIR_UNSCATHED_420_TEXT	*・・・$MCG、あなたは若いのに聡明ですね・・・。
$LINE_ENDING_ZELEMIR_UNSCATHED_430_CHAR	$HEA
$LINE_ENDING_ZELEMIR_UNSCATHED_430_TEXT	この世界は、まだ苦痛と混沌で満ちています・・・。
$LINE_ENDING_ZELEMIR_UNSCATHED_440_CHAR	$HEA
$LINE_ENDING_ZELEMIR_UNSCATHED_440_TEXT	だからこそ、セリーニにとっては、豊富な機会がある。
$LINE_ENDING_ZELEMIR_UNSCATHED_450_CHAR	$HEA
$LINE_ENDING_ZELEMIR_UNSCATHED_450_TEXT	*あなたはどうしますか、$MCG。図書館へ戻れるのですか？
$LINE_ENDING_ZELEMIR_UNSCATHED_460_CHAR	$MCG
$LINE_ENDING_ZELEMIR_UNSCATHED_460_TEXT	こんな冒険の後は、以前の図書館での生活はほっとできていいなと思うの。
$LINE_ENDING_ZELEMIR_UNSCATHED_470_CHAR	$MCG
$LINE_ENDING_ZELEMIR_UNSCATHED_470_TEXT	・・・たしかにあの能力のない生活って、変な感じだけど・・・。
$LINE_ENDING_ZELEMIR_UNSCATHED_480_CHAR	$MCG
$LINE_ENDING_ZELEMIR_UNSCATHED_480_TEXT	でも、もう一度、本当の自分に戻れてうれしいわ。
$LINE_ENDING_ZELEMIR_UNSCATHED_490_CHAR	$HEA
$LINE_ENDING_ZELEMIR_UNSCATHED_490_TEXT	うむ・・・私もあなたの能力がどこから来たのか、不思議に思っていました。
$LINE_ENDING_ZELEMIR_UNSCATHED_500_CHAR	$HEA
$LINE_ENDING_ZELEMIR_UNSCATHED_500_TEXT	エズティル・テノクは、あなたを取り込もうしようとした時、<N>少しだけ自分の魂を注ぎ込んだんじゃないでしょうか。
$LINE_ENDING_ZELEMIR_UNSCATHED_510_CHAR	$HEA
$LINE_ENDING_ZELEMIR_UNSCATHED_510_TEXT	取り込まれぬよう、あなたはその能力を使って、彼に立ち向かった。
$LINE_ENDING_ZELEMIR_UNSCATHED_520_CHAR	$HEA
$LINE_ENDING_ZELEMIR_UNSCATHED_520_TEXT	彼がいなくなり、その魔法も一緒に死んだのでしょう。
$LINE_ENDING_ZELEMIR_UNSCATHED_530_CHAR	$MCG
$LINE_ENDING_ZELEMIR_UNSCATHED_530_TEXT	不思議な感覚だけど、能力が消えても悲しくないんです。
$LINE_ENDING_ZELEMIR_UNSCATHED_540_CHAR	$MCG
$LINE_ENDING_ZELEMIR_UNSCATHED_540_TEXT	今は、当たり前の生活が想像できなかったほど贅沢なの。
$LINE_ENDING_ZELEMIR_UNSCATHED_550_CHAR	$HEA
$LINE_ENDING_ZELEMIR_UNSCATHED_550_TEXT	皆がその贅沢を感じられるといいですね。
$LINE_ENDING_ZELEMIR_UNSCATHED_560_CHAR	$HEA
$LINE_ENDING_ZELEMIR_UNSCATHED_560_TEXT	長く引きとめてすまない。<N>あなたの旅はまだ続くというのに。
$LINE_ENDING_ZELEMIR_UNSCATHED_570_CHAR	$HEA
$LINE_ENDING_ZELEMIR_UNSCATHED_570_TEXT	*さようなら、$MCG。また会う日まで。
$LINE_ENDING_ZELEMIR_UNSCATHED_580_CHAR	$MCG
$LINE_ENDING_ZELEMIR_UNSCATHED_580_TEXT	また、すぐに会えたらいいですね。
$LINE_ENDING_ZELEMIR_UNSCATHED_590_CHAR	$MAG
$LINE_ENDING_ZELEMIR_UNSCATHED_590_TEXT	ありがとう。大変感謝いたします。
$LINE_ENDING_ZELEMIR_UNSCATHED_600_CHAR	$MAG
$LINE_ENDING_ZELEMIR_UNSCATHED_600_TEXT	感謝のしるしをお納めください――
$LINE_ENDING_ZELEMIR_UNSCATHED_610_CHAR	$HEA
$LINE_ENDING_ZELEMIR_UNSCATHED_610_TEXT	*$MAG、その宝を必要としてるのは、君の王国の民の方だ。
$LINE_ENDING_ZELEMIR_UNSCATHED_620_CHAR	$MAG
$LINE_ENDING_ZELEMIR_UNSCATHED_620_TEXT	では、せめて招待させてください。<N>炎の社に再び火が灯る時、必ずお越しください。
$LINE_ENDING_ZELEMIR_UNSCATHED_630_CHAR	$MAG
$LINE_ENDING_ZELEMIR_UNSCATHED_630_TEXT	きっと、あなたのセリナドトの知恵が、天なる火を喜ばせるでしょう。
$LINE_ENDING_ZELEMIR_UNSCATHED_640_CHAR	$HEA
$LINE_ENDING_ZELEMIR_UNSCATHED_640_TEXT	炎の子に招いてもらえるなんて、誇らしい気分だよ。
$LINE_ENDING_ZELEMIR_UNSCATHED_650_CHAR	$HEA
$LINE_ENDING_ZELEMIR_UNSCATHED_650_TEXT	そろそろ行かねば。セリナドトの道が、私を苦難の旅へと誘っている。
$LINE_ENDING_ZELEMIR_UNSCATHED_660_CHAR	$HEA
$LINE_ENDING_ZELEMIR_UNSCATHED_660_TEXT	いつか、また会おう。
$LINE_ENDING_ZELEMIR_UNSCATHED_670_CHAR	$MAG
$LINE_ENDING_ZELEMIR_UNSCATHED_670_TEXT	さようなら、尊敬するご老師。<N>あなたのそばにいつでも炎の温かさがあらんことを。
$LINE_ENDING_ZELEMIR_UNSCATHED_680_CHAR	$MAG
$LINE_ENDING_ZELEMIR_UNSCATHED_680_TEXT	*$MCG。
$LINE_ENDING_ZELEMIR_UNSCATHED_690_CHAR	$MCG
$LINE_ENDING_ZELEMIR_UNSCATHED_690_TEXT	*$MAG。
$LINE_ENDING_ZELEMIR_UNSCATHED_700_CHAR	$MAG
$LINE_ENDING_ZELEMIR_UNSCATHED_700_TEXT	私たちがいなくても平気ですか？
$LINE_ENDING_ZELEMIR_UNSCATHED_710_CHAR	$MAG
$LINE_ENDING_ZELEMIR_UNSCATHED_710_TEXT	クウェイドの力なしで、あなた方が無事に旅できるか心配ですよ。
$LINE_ENDING_ZELEMIR_UNSCATHED_720_CHAR	$MAG
$LINE_ENDING_ZELEMIR_UNSCATHED_720_TEXT	アッシュ王国までは遠いですよ。
$LINE_ENDING_ZELEMIR_UNSCATHED_730_CHAR	$MAG
$LINE_ENDING_ZELEMIR_UNSCATHED_730_TEXT	盗賊もオオカミもいます。ちょっとしたそよ風で、気分が悪くなるのでは？
$LINE_ENDING_ZELEMIR_UNSCATHED_740_CHAR	$MCG
$LINE_ENDING_ZELEMIR_UNSCATHED_740_TEXT	あなたはどうなの？あなただって、もう、特別な能力を持ってないじゃない。
$LINE_ENDING_ZELEMIR_UNSCATHED_750_CHAR	$MAG
$LINE_ENDING_ZELEMIR_UNSCATHED_750_TEXT	私は、クウェイド帝国の王女ですよ。剣を持って生まれてきた！
$LINE_ENDING_ZELEMIR_UNSCATHED_760_CHAR	$MAG
$LINE_ENDING_ZELEMIR_UNSCATHED_760_TEXT	生まれた時から、兵法を学んできたのですよ。
$LINE_ENDING_ZELEMIR_UNSCATHED_770_CHAR	$MAG
$LINE_ENDING_ZELEMIR_UNSCATHED_770_TEXT	それに氷の魔法は便利でしたが・・・<N>心から寒さが消えてうれしいのです。
$LINE_ENDING_ZELEMIR_UNSCATHED_780_CHAR	$MAG
$LINE_ENDING_ZELEMIR_UNSCATHED_780_TEXT	これまでと同様、炎の神に栄光をもたらしますよ。剣術と弓術と軍力で！
$LINE_ENDING_ZELEMIR_UNSCATHED_790_CHAR	$MAG
$LINE_ENDING_ZELEMIR_UNSCATHED_790_TEXT	私は皆と故郷に戻ります。
$LINE_ENDING_ZELEMIR_UNSCATHED_800_CHAR	$MAG
$LINE_ENDING_ZELEMIR_UNSCATHED_800_TEXT	まだ世界に残されているものを見つけて・・・。
$LINE_ENDING_ZELEMIR_UNSCATHED_810_CHAR	$MAG
$LINE_ENDING_ZELEMIR_UNSCATHED_810_TEXT	世界の頂点に偉大な帝国を築くのです。
$LINE_ENDING_ZELEMIR_UNSCATHED_820_CHAR	$MCG
$LINE_ENDING_ZELEMIR_UNSCATHED_820_TEXT	全然変わってないね。嬉しいよ。
$LINE_ENDING_ZELEMIR_UNSCATHED_830_CHAR	$MCG
$LINE_ENDING_ZELEMIR_UNSCATHED_830_TEXT	これから頑張ってね。応援してる。
$LINE_ENDING_ZELEMIR_UNSCATHED_840_CHAR	$MAG
$LINE_ENDING_ZELEMIR_UNSCATHED_840_TEXT	あなたも。炎の神の友よ。
$LINE_ENDING_ZELEMIR_UNSCATHED_850_CHAR	$MAG
$LINE_ENDING_ZELEMIR_UNSCATHED_850_TEXT	また、どこかでお会いしましょう。
$LINE_ENDING_ZELEMIR_UNSCATHED_860_CHAR	$MCG
$LINE_ENDING_ZELEMIR_UNSCATHED_860_TEXT	じゃあね！！
$LINE_ENDING_ZELEMIR_UNSCATHED_870_CHAR	$BER
$LINE_ENDING_ZELEMIR_UNSCATHED_870_TEXT	よぉ。
$LINE_ENDING_ZELEMIR_UNSCATHED_880_CHAR	$MCG
$LINE_ENDING_ZELEMIR_UNSCATHED_880_TEXT	*アンタはどうするつもりなの、$BER？
$LINE_ENDING_ZELEMIR_UNSCATHED_890_CHAR	$MCG
$LINE_ENDING_ZELEMIR_UNSCATHED_890_TEXT	私たちと一緒に、アッシュ王国に戻る？
$LINE_ENDING_ZELEMIR_UNSCATHED_900_CHAR	$BER
$LINE_ENDING_ZELEMIR_UNSCATHED_900_TEXT	冗談言うなよ。富と贅沢の人生なんかいらねえ。
$LINE_ENDING_ZELEMIR_UNSCATHED_910_CHAR	$BER
$LINE_ENDING_ZELEMIR_UNSCATHED_910_TEXT	この世に殺すべきものが転がっている間はな！
$LINE_ENDING_ZELEMIR_UNSCATHED_920_CHAR	$BER
$LINE_ENDING_ZELEMIR_UNSCATHED_920_TEXT	さっきまで、遊牧難民と話してたんだけどな、そいつらが、北の国に「岩の目」って呼ばれるモンスターがいるって言うんだ。
$LINE_ENDING_ZELEMIR_UNSCATHED_930_CHAR	$BER
$LINE_ENDING_ZELEMIR_UNSCATHED_930_TEXT	7つの頭があって、1つの頭につき７つの目があるんだってよ！
$LINE_ENDING_ZELEMIR_UNSCATHED_940_CHAR	$BER
$LINE_ENDING_ZELEMIR_UNSCATHED_940_TEXT	7つも頭がある怪物なんて、捕まえたことがないぜ！
$LINE_ENDING_ZELEMIR_UNSCATHED_950_CHAR	$BER
$LINE_ENDING_ZELEMIR_UNSCATHED_950_TEXT	それにな、そこから少し東に行けば、ブラッドマッド教の気違い野郎たちをぶちのめすこともできるんだぜ！
$LINE_ENDING_ZELEMIR_UNSCATHED_960_CHAR	$BER
$LINE_ENDING_ZELEMIR_UNSCATHED_960_TEXT	あいつらが身に着けている血染めのマントを、あと3つ手に入れたいんだ。
$LINE_ENDING_ZELEMIR_UNSCATHED_970_CHAR	$BER
$LINE_ENDING_ZELEMIR_UNSCATHED_970_TEXT	そうすれば、暴力のターバンを完成させられる！
$LINE_ENDING_ZELEMIR_UNSCATHED_980_CHAR	$MCG
$LINE_ENDING_ZELEMIR_UNSCATHED_980_TEXT	アンタにも計画性があるってわかって、うれしいよ。
$LINE_ENDING_ZELEMIR_UNSCATHED_990_CHAR	$BER
$LINE_ENDING_ZELEMIR_UNSCATHED_990_TEXT	でも、よく考えてみろよ、これから奮う暴力の話をしているんだぜ！
$LINE_ENDING_ZELEMIR_UNSCATHED_1000_CHAR	$MCG
$LINE_ENDING_ZELEMIR_UNSCATHED_1000_TEXT	連絡ちょうだいね。
$LINE_ENDING_ZELEMIR_UNSCATHED_1010_CHAR	$MCG
$LINE_ENDING_ZELEMIR_UNSCATHED_1010_TEXT	彼がいないと寂しくなるな。
$LINE_ENDING_ZELEMIR_UNSCATHED_1020_CHAR	$RAN
$LINE_ENDING_ZELEMIR_UNSCATHED_1020_TEXT	おい。
$LINE_ENDING_ZELEMIR_UNSCATHED_1030_CHAR	$MCG
$LINE_ENDING_ZELEMIR_UNSCATHED_1030_TEXT	あれ、遊牧民と一緒に旅を続けるんじゃなかったの？
$LINE_ENDING_ZELEMIR_UNSCATHED_1040_CHAR	$RAN
$LINE_ENDING_ZELEMIR_UNSCATHED_1040_TEXT	いや、やっぱり、やめたんだ。
$LINE_ENDING_ZELEMIR_UNSCATHED_1050_CHAR	$RAN
$LINE_ENDING_ZELEMIR_UNSCATHED_1050_TEXT	なんていうかさ・・・
$LINE_ENDING_ZELEMIR_UNSCATHED_1060_CHAR	$RAN
$LINE_ENDING_ZELEMIR_UNSCATHED_1060_TEXT	目の前にでっかい世界が広がっているんだな、って。
$LINE_ENDING_ZELEMIR_UNSCATHED_1070_CHAR	$RAN
$LINE_ENDING_ZELEMIR_UNSCATHED_1070_TEXT	ゲカ民族の生き残りだっているかもしれない。
$LINE_ENDING_ZELEMIR_UNSCATHED_1080_CHAR	$RAN
$LINE_ENDING_ZELEMIR_UNSCATHED_1080_TEXT	もしそうだとしたら、助けを必要としているかもしれない。
$LINE_ENDING_ZELEMIR_UNSCATHED_1090_CHAR	$RAN
$LINE_ENDING_ZELEMIR_UNSCATHED_1090_TEXT	あとは、ほら、放浪してみようかなって。
$LINE_ENDING_ZELEMIR_UNSCATHED_1100_CHAR	$MCG
$LINE_ENDING_ZELEMIR_UNSCATHED_1100_TEXT	*・・・$BERは、冒険を求めてるみたいよ。
$LINE_ENDING_ZELEMIR_UNSCATHED_1110_CHAR	$RAN
$LINE_ENDING_ZELEMIR_UNSCATHED_1110_TEXT	えっ、本当？アイツって・・・えっとその・・・。
$LINE_ENDING_ZELEMIR_UNSCATHED_1120_CHAR	$RAN
$LINE_ENDING_ZELEMIR_UNSCATHED_1120_TEXT	まあ、いい戦友になるだろうな。
$LINE_ENDING_ZELEMIR_UNSCATHED_1130_CHAR	$RAN
$LINE_ENDING_ZELEMIR_UNSCATHED_1130_TEXT	それに、あいつから金を返してもらっていないしなあ・・・。
$LINE_ENDING_ZELEMIR_UNSCATHED_1140_CHAR	$MCG
$LINE_ENDING_ZELEMIR_UNSCATHED_1140_TEXT	彼はその道を行ったよ。
$LINE_ENDING_ZELEMIR_UNSCATHED_1150_CHAR	$RAN
$LINE_ENDING_ZELEMIR_UNSCATHED_1150_TEXT	*ありがとう、$MCG。
$LINE_ENDING_ZELEMIR_UNSCATHED_1160_CHAR	$MCG
$LINE_ENDING_ZELEMIR_UNSCATHED_1160_TEXT	どういたしまして。
$LINE_ENDING_ZELEMIR_UNSCATHED_1170_CHAR	$KNI
$LINE_ENDING_ZELEMIR_UNSCATHED_1170_TEXT	お嬢様。
$LINE_ENDING_ZELEMIR_UNSCATHED_1180_CHAR	$MCG
$LINE_ENDING_ZELEMIR_UNSCATHED_1180_TEXT	*$KNI。
$LINE_ENDING_ZELEMIR_UNSCATHED_1190_CHAR	$KNI
$LINE_ENDING_ZELEMIR_UNSCATHED_1190_TEXT	あなたの準備ができ次第、アッシュ王国の難民たちはすぐに出発できるそうです。
$LINE_ENDING_ZELEMIR_UNSCATHED_1200_CHAR	$MCG
$LINE_ENDING_ZELEMIR_UNSCATHED_1200_TEXT	*あなたはどうするの、$KNI？都に戻りたいんでしょう？
$LINE_ENDING_ZELEMIR_UNSCATHED_1210_CHAR	$KNI
$LINE_ENDING_ZELEMIR_UNSCATHED_1210_TEXT	彼らは、私の王国の民です。それに、まだお嬢様への借りを返していませんから。
$LINE_ENDING_ZELEMIR_UNSCATHED_1220_CHAR	$KNI
$LINE_ENDING_ZELEMIR_UNSCATHED_1220_TEXT	借りを返しきるまで、あなたについていきます。
$LINE_ENDING_ZELEMIR_UNSCATHED_1230_CHAR	$MCG
$LINE_ENDING_ZELEMIR_UNSCATHED_1230_TEXT	もう、借りは返してもらったよ。あなたは約束を守ったわ。
$LINE_ENDING_ZELEMIR_UNSCATHED_1240_CHAR	$KNI
$LINE_ENDING_ZELEMIR_UNSCATHED_1240_TEXT	では、友として、旅にお供しても？
$LINE_ENDING_ZELEMIR_UNSCATHED_1250_CHAR	$MCG
$LINE_ENDING_ZELEMIR_UNSCATHED_1250_TEXT	もちろん。長くて危険な旅になるかもしれないけれど・・・<N>私―みんなも、一緒に来てほしいときっと思うわ。
$LINE_ENDING_ZELEMIR_UNSCATHED_1260_CHAR	$KNI
$LINE_ENDING_ZELEMIR_UNSCATHED_1260_TEXT	彼らと一緒に旅ができて、嬉しいですよ、お嬢様。
$LINE_ENDING_ZELEMIR_UNSCATHED_1270_CHAR	$KNI
$LINE_ENDING_ZELEMIR_UNSCATHED_1270_TEXT	だって、ほら・・・
$LINE_ENDING_ZELEMIR_UNSCATHED_1280_CHAR	$KNI
$LINE_ENDING_ZELEMIR_UNSCATHED_1280_TEXT	・・・歩くたびに、殺しにかかってくる怪物がいないと、妙に退屈ですからね。
$LINE_ENDING_ZELEMIR_UNSCATHED_1290_CHAR	$MCG
$LINE_ENDING_ZELEMIR_UNSCATHED_1290_TEXT	そうだ、あの「ティプシー・タイガー」って歌は、暇つぶしにちょうどいいんじゃない？
$LINE_ENDING_ZELEMIR_UNSCATHED_1300_CHAR	$KNI
$LINE_ENDING_ZELEMIR_UNSCATHED_1300_TEXT	まさか。もう貸しもないですし、そのご要望は聞きませんよ。そんな馬鹿馬鹿しい提案なんてね。
$LINE_ENDING_ZELEMIR_UNSCATHED_1310_CHAR	$MCG
$LINE_ENDING_ZELEMIR_UNSCATHED_1310_TEXT	本当？でも、馬鹿馬鹿しい提案が、もっともっとあるんだよ。
$LINE_ENDING_ZELEMIR_UNSCATHED_1320_CHAR	$MCG
$LINE_ENDING_ZELEMIR_UNSCATHED_1320_TEXT	全員が「ティプシー・タイガー」を好きなわけじゃないんだし。<N>だから、私の馬鹿馬鹿しい提案を最後まで言ってみるね。
$LINE_ENDING_ZELEMIR_UNSCATHED_1330_CHAR	$MCG
$LINE_ENDING_ZELEMIR_UNSCATHED_1330_TEXT	まずひとつ。その紫のスカートっぽいものを履くのをやめて。紫のスカートは私が先に履いていたし、私の方が似合ってる。
$LINE_ENDING_ZELEMIR_UNSCATHED_1340_CHAR	$KNI
$LINE_ENDING_ZELEMIR_UNSCATHED_1340_TEXT	ちょっと！
$LINE_ENDING_ZELEMIR_UNSCATHED_1350_CHAR	$MCG
$LINE_ENDING_ZELEMIR_UNSCATHED_1350_TEXT	二つ目。あなたのヒゲの中でモモンガを飼いましょう。だって、モモンガって、いい奴でしょう？ムカつく野郎を攻撃してくれるんだよ。
$LINE_ENDING_ZELEMIR_UNSCATHED_1360_CHAR	$MCG
$LINE_ENDING_ZELEMIR_UNSCATHED_1360_TEXT	三つ目。モモンガには、ミギと、ヒダリって名付けること。でも、ミギは左のヒゲで飼って、ヒダリは右のヒゲで飼うの。敵を混乱させるためにね。
$LINE_ENDING_ZELEMIR_UNSCATHED_1370_CHAR	$KNI
$LINE_ENDING_ZELEMIR_UNSCATHED_1370_TEXT	*$BERの影響を色濃く受けたようですね。
$LINE_ENDING_ZELEMIR_UNSCATHED_1380_CHAR	$MCG
$LINE_ENDING_ZELEMIR_UNSCATHED_1380_TEXT	こんなバカみたいな提案が200個くらいあるの。アッシュ王国まで長い長い旅になるわ。
$LINE_ENDING_ZELEMIR_UNSCATHED_1390_CHAR	$KNI
$LINE_ENDING_ZELEMIR_UNSCATHED_1390_TEXT	・・・
$LINE_ENDING_ZELEMIR_UNSCATHED_1400_CHAR	$KNI
$LINE_ENDING_ZELEMIR_UNSCATHED_1400_TEXT	ああ、私はティプシー・タイガー♪
$LINE_ENDING_ZELEMIR_UNSCATHED_1410_CHAR	$MCG
$LINE_ENDING_ZELEMIR_UNSCATHED_1410_TEXT	よし、次は、片足立ちで、裏声で歌ってみて！
$SCENE_EPILOGUE_TITLE	秘密のエピローグ
$LINE_EPILOGUE_00_CHAR	$KNI
$LINE_EPILOGUE_00_TEXT	・・・これが、正しい「ティプシー・タイガー」の歌い方です。
$LINE_EPILOGUE_10_CHAR	$MCG
$LINE_EPILOGUE_10_TEXT	それは面白いね・・・知らなかったよ。<N>あなた、そんな高い声が出せるのね。
$LINE_EPILOGUE_20_CHAR	$MCG
$LINE_EPILOGUE_20_TEXT	たぶん、私だってそんな高音出せないわ。
$LINE_EPILOGUE_30_CHAR	$KNI
$LINE_EPILOGUE_30_TEXT	去勢した特権のひとつですな。
$LINE_EPILOGUE_40_CHAR	$MCG
$LINE_EPILOGUE_40_TEXT	えっ？
$LINE_EPILOGUE_50_CHAR	$KNI
$LINE_EPILOGUE_50_TEXT	冗談です。
$LINE_EPILOGUE_60_CHAR	$MCG
$LINE_EPILOGUE_60_TEXT	何だ、びっくりした・・・。<N>これはいろいろと考え直さないといけないな、って思っていたところだったの。
$LINE_EPILOGUE_70_CHAR	$KNI
$LINE_EPILOGUE_70_TEXT	考え直すって――
$LINE_EPILOGUE_80_CHAR	$BER
$LINE_EPILOGUE_80_TEXT	よっ！
$LINE_EPILOGUE_90_CHAR	$MCG
$LINE_EPILOGUE_90_TEXT	*$BER？ $RAN？ こんな所で、何してるの？
$LINE_EPILOGUE_100_CHAR	$BER
$LINE_EPILOGUE_100_TEXT	いやぁ、「岩の目」を教えてくれた遊牧民のやつが大嘘吐きだってわかってよ。<N>ぶん殴って殺してやったぜ！
$LINE_EPILOGUE_110_CHAR	$RAN
$LINE_EPILOGUE_110_TEXT	「岩の目」には、頭が5つしかなかったんだよ！
$LINE_EPILOGUE_120_CHAR	$BER
$LINE_EPILOGUE_120_TEXT	そうそう！すっかりダマされたぜ！
$LINE_EPILOGUE_130_CHAR	$RAN
$LINE_EPILOGUE_130_TEXT	だから、あのカルト信者たちにお灸を据えてやったのさ―
$LINE_EPILOGUE_140_CHAR	$BER
$LINE_EPILOGUE_140_TEXT	ははは、あいつら、今頃メソメソ泣いてるだろうよ！
$LINE_EPILOGUE_150_CHAR	$RAN
$LINE_EPILOGUE_150_TEXT	―でも、「ドラゴン・アイ」っていう宝石について聞き出せた。<N>その宝石は高い塔に鬼が隠していて、巨大な蛇に守らせてるんだってよ。
$LINE_EPILOGUE_160_CHAR	$BER
$LINE_EPILOGUE_160_TEXT	それでな、その鬼は7つのキン―
$LINE_EPILOGUE_170_CHAR	$RAN
$LINE_EPILOGUE_170_TEXT	それ以上言うなって！
$LINE_EPILOGUE_180_CHAR	$BER
$LINE_EPILOGUE_180_TEXT	まあ、倒した証として持ち帰ったけど、シブい飾りになるぜ・・・。
$LINE_EPILOGUE_190_CHAR	$RAN
$LINE_EPILOGUE_190_TEXT	ともかく、通りかかったんだから、挨拶くらいしようと思って。
$LINE_EPILOGUE_200_CHAR	$MCG
$LINE_EPILOGUE_200_TEXT	・・・まだ4日しか経ってないのに・・・
$LINE_EPILOGUE_210_CHAR	$BER
$LINE_EPILOGUE_210_TEXT	あ、そうだ。<N>アッシュ王国に着いたら、この手紙をうちの親父に渡してくれないか？
$LINE_EPILOGUE_220_CHAR	$BER
$LINE_EPILOGUE_220_TEXT	親父は、俺がどこか北の町で勉強してると思ってる。<N>だから、奈落でのことは、秘密にしてくれ。
$LINE_EPILOGUE_230_CHAR	$BER
$LINE_EPILOGUE_230_TEXT	もし知ったら、カンカンに怒って俺を勘当するだろうな。
$LINE_EPILOGUE_240_CHAR	$KNI
$LINE_EPILOGUE_240_TEXT	勘当？
$LINE_EPILOGUE_250_CHAR	$MCG
$LINE_EPILOGUE_250_TEXT	アンタのお父さんって、偉い人なの？
$LINE_EPILOGUE_260_CHAR	$BER
$LINE_EPILOGUE_260_TEXT	ああ、摂政だよ。
$LINE_EPILOGUE_270_CHAR	$RAN
$LINE_EPILOGUE_270_TEXT	みんな、知らなかったの？
$LINE_EPILOGUE_280_CHAR	$BER
$LINE_EPILOGUE_280_TEXT	国の統治なんて、女に任せときゃいいのさ！妹がいて、ほんと助かったぜ。
$LINE_EPILOGUE_290_CHAR	$RAN
$LINE_EPILOGUE_290_TEXT	どこを旅していたか家族には言わないでやってくれよ。な？
$LINE_EPILOGUE_300_CHAR	$BER
$LINE_EPILOGUE_300_TEXT	さあ、ご歓談中に悪いが、俺たちは鬼を倒してキン―
$LINE_EPILOGUE_310_CHAR	$RAN
$LINE_EPILOGUE_310_TEXT	それ以上言うなって！
$LINE_EPILOGUE_320_CHAR	$BER
$LINE_EPILOGUE_320_TEXT	さあ、行こう！<N>いざ、暴力をふるえる場所へ！
$LINE_EPILOGUE_330_CHAR	$KNI
$LINE_EPILOGUE_330_TEXT	・・・。
$LINE_EPILOGUE_340_CHAR	$MCG
$LINE_EPILOGUE_340_TEXT	あきれるわ。
$SCENE_SIDEQUEST_1_GET_TITLE	本気なの？
$LINE_SIDEQUEST_1_GET_00_CHAR	$RAN
$LINE_SIDEQUEST_1_GET_00_TEXT	*おい、$MCG！このクレスカ族のクソ野郎が、何も売ってくれないんだ。
$LINE_SIDEQUEST_1_GET_10_CHAR	$RAN
$LINE_SIDEQUEST_1_GET_10_TEXT	きっと、我々ゲカ民族が生まれつき優秀だから、嫉妬してるんだ。
$LINE_SIDEQUEST_1_GET_20_CHAR	$MCG
$LINE_SIDEQUEST_1_GET_20_TEXT	うーん・・・あなた以外はゲカ民族じゃないんだけどな・・・。
$LINE_SIDEQUEST_1_GET_30_CHAR	$RAN
$LINE_SIDEQUEST_1_GET_30_TEXT	君をゲカ民族の名誉会員にしてやったよ。5分前くらいに。
$LINE_SIDEQUEST_1_GET_40_CHAR	$RAN
$LINE_SIDEQUEST_1_GET_40_TEXT	だからな、我がゲカの妹よ。<N>君の魔法で、あいつの顔を溶かせるかい？
$LINE_SIDEQUEST_1_GET_50_CHAR	$MCG
$LINE_SIDEQUEST_1_GET_50_TEXT	誰の顔も、溶かすつもりはないよ。
$LINE_SIDEQUEST_1_GET_60_CHAR	$MCG
$LINE_SIDEQUEST_1_GET_60_TEXT	第一、そんな魔法の使い方を知らないし。<N>あと、一体何があなたの気にさわったの？
$LINE_SIDEQUEST_1_GET_70_CHAR	$RAN
$LINE_SIDEQUEST_1_GET_70_TEXT	あいつはクレスカ族なんだ。懲らしめてやらないと、<N>400年にも渡る民族紛争が激化する。
$LINE_SIDEQUEST_1_GET_80_CHAR	$BER
$LINE_SIDEQUEST_1_GET_80_TEXT	お、顔を溶かすだって？
$LINE_SIDEQUEST_1_GET_90_CHAR	$BER
$LINE_SIDEQUEST_1_GET_90_TEXT	獲物を見せな！俺の腹筋光線を食らわせてやるぜ！
$LINE_SIDEQUEST_1_GET_100_CHAR	$BER
$LINE_SIDEQUEST_1_GET_100_TEXT	ほれ、見ろ・・・あいつ、だいぶ弱ってきたぜ。
$LINE_SIDEQUEST_1_GET_110_CHAR	$RAN
$LINE_SIDEQUEST_1_GET_110_TEXT	・・・そうか、じゃ、プランBだ。君が、彼を誘惑しろ。<N>油断しているうちに、私がこっそり忍び込んで、盗めるだけ盗む。
$LINE_SIDEQUEST_1_GET_120_CHAR	$MCG
$LINE_SIDEQUEST_1_GET_120_TEXT	えっー！？イヤだよ。
$LINE_SIDEQUEST_1_GET_130_CHAR	$RAN
$LINE_SIDEQUEST_1_GET_130_TEXT	うん、そうだな。<N>誘惑するにはひどい格好だしな。
$LINE_SIDEQUEST_1_GET_140_CHAR	$RAN
$LINE_SIDEQUEST_1_GET_140_TEXT	それじゃ、プランCだ。誰も見ていない隙に、殺す。
$LINE_SIDEQUEST_1_GET_150_CHAR	$MCG
$LINE_SIDEQUEST_1_GET_150_TEXT	皆を解放したのは私たちだって言うのは？
$LINE_SIDEQUEST_1_GET_160_CHAR	$RAN
$LINE_SIDEQUEST_1_GET_160_TEXT	ああ、もうやったよ。でも、アイツときたら、<N>牢屋の地下に閉じ込められた子どもについて喋り続けるだけだった。
$LINE_SIDEQUEST_1_GET_170_CHAR	$RAN
$LINE_SIDEQUEST_1_GET_170_TEXT	よし、理由は出揃った。<N>あのクレスカ族の馬鹿をメッタメタにしてやろう。
$LINE_SIDEQUEST_1_GET_180_CHAR	$MCG
$LINE_SIDEQUEST_1_GET_180_TEXT	牢屋の下に閉じ込められている子がいるの？
$LINE_SIDEQUEST_1_GET_190_CHAR	$RAN
$LINE_SIDEQUEST_1_GET_190_TEXT	ああ、ひどい話さ。<N>しかしだ。今重要なのは、あの害虫どもを殺して宝物にありつくことだ。
$LINE_SIDEQUEST_1_GET_200_CHAR	$MCG
$LINE_SIDEQUEST_1_GET_200_TEXT	・・・。
$LINE_SIDEQUEST_1_GET_210_CHAR	$RAN
$LINE_SIDEQUEST_1_GET_210_TEXT	おい、待て！この民族紛争を無視するつもりか！？
$LINE_SIDEQUEST_1_GET_220_CHAR	$MCG
$LINE_SIDEQUEST_1_GET_220_TEXT	こそ泥になりたいなら、お好きにどうぞ。<N>子どもたちを助けに行くわ。
$LINE_SIDEQUEST_1_GET_230_CHAR	$RAN
$LINE_SIDEQUEST_1_GET_230_TEXT	正気か？オジマルのレブナントが私たちを追ってるんだぞ！
$LINE_SIDEQUEST_1_GET_240_CHAR	$MCG
$LINE_SIDEQUEST_1_GET_240_TEXT	でも、私たちが牢屋に戻るだなんて、最も予想外の行動じゃない。
$LINE_SIDEQUEST_1_GET_250_CHAR	$RAN
$LINE_SIDEQUEST_1_GET_250_TEXT	ああ！それが愚行だからだよ！
$LINE_SIDEQUEST_1_GET_260_CHAR	$MCG
$LINE_SIDEQUEST_1_GET_260_TEXT	それじゃ、ずっとここに残る？
$LINE_SIDEQUEST_1_GET_270_CHAR	$RAN
$LINE_SIDEQUEST_1_GET_270_TEXT	何言ってるんだ？<N>君は、脱出計画の要なんだ、いなくなっては困る！
$LINE_SIDEQUEST_1_GET_280_CHAR	$RAN
$LINE_SIDEQUEST_1_GET_280_TEXT	・・・クソ、ずっと恨んでやるからな。
$SCENE_SIDEQUEST_1_INTRO_TITLE	火中の栗
$LINE_SIDEQUEST_1_INTRO_00_CHAR	$RAN
$LINE_SIDEQUEST_1_INTRO_00_TEXT	やった！せっかく脱出したレブナントの巣窟にノコノコ戻って来られたぞ！
$LINE_SIDEQUEST_1_INTRO_10_CHAR	$RAN
$LINE_SIDEQUEST_1_INTRO_10_TEXT	例えて言えば、やけどしそうなカマドから手を引き出したあとに、
$LINE_SIDEQUEST_1_INTRO_20_CHAR	$RAN
$LINE_SIDEQUEST_1_INTRO_20_TEXT	「あっ、光り物がある！取ってみよう！」って手をもう一度カマドに突っ込むみたいなことさ。
$LINE_SIDEQUEST_1_INTRO_30_CHAR	$RAN
$LINE_SIDEQUEST_1_INTRO_30_TEXT	キミたちはバカすぎてわからないかもしれないけど――
$LINE_SIDEQUEST_1_INTRO_40_CHAR	$MCG
$LINE_SIDEQUEST_1_INTRO_40_TEXT	つまり、あなた、本気で子どもを助けたくないってことね？
$LINE_SIDEQUEST_1_INTRO_50_CHAR	$MCG
$LINE_SIDEQUEST_1_INTRO_50_TEXT	あなたの不満はわかるけど、本気なの？<N>子どもが閉じ込められてるのよ？
$LINE_SIDEQUEST_1_INTRO_60_CHAR	$RAN
$LINE_SIDEQUEST_1_INTRO_60_TEXT	そういうことじゃない。私が言いたいのは――
$LINE_SIDEQUEST_1_INTRO_70_CHAR	$MCG
$LINE_SIDEQUEST_1_INTRO_70_TEXT	子どもが嫌い、とか？
$LINE_SIDEQUEST_1_INTRO_80_CHAR	$RAN
$LINE_SIDEQUEST_1_INTRO_80_TEXT	あのさ、言おうとしたことを勝手に予想しないで。
$LINE_SIDEQUEST_1_INTRO_90_CHAR	$MCG
$LINE_SIDEQUEST_1_INTRO_90_TEXT	あなたの言うことを当てるなんて、お茶の子さいさいよ。
$LINE_SIDEQUEST_1_INTRO_100_CHAR	$BER
$LINE_SIDEQUEST_1_INTRO_100_TEXT	女のケンカだ！キャットファイトだ！！
$LINE_SIDEQUEST_1_INTRO_110_CHAR	$BER
$LINE_SIDEQUEST_1_INTRO_110_TEXT	オレ、可愛い子の方に、ブーツと錆びたナイフを賭けるぜ！
$LINE_SIDEQUEST_1_INTRO_120_CHAR	$MCG
$LINE_SIDEQUEST_1_INTRO_120_TEXT	・・・。
$LINE_SIDEQUEST_1_INTRO_130_CHAR	$BER
$LINE_SIDEQUEST_1_INTRO_130_TEXT	あー、あとよ、スゲー数のレブナントが襲ってきたぜ。
$LINE_SIDEQUEST_1_INTRO_140_CHAR	$MCG
$LINE_SIDEQUEST_1_INTRO_140_TEXT	まあ、ステキ。
$SCENE_SIDEQUEST_1_OUTRO_TITLE	実益のための民族紛争
$LINE_SIDEQUEST_1_OUTRO_00_CHAR	$BER
$LINE_SIDEQUEST_1_OUTRO_00_TEXT	俺とガチンコ勝負したい奴は、もういねーか？
$LINE_SIDEQUEST_1_OUTRO_10_CHAR	$BER
$LINE_SIDEQUEST_1_OUTRO_10_TEXT	なんだよ、ケンカはもう売り切れってか。
$LINE_SIDEQUEST_1_OUTRO_20_CHAR	$BER
$LINE_SIDEQUEST_1_OUTRO_20_TEXT	そうなのか？そうなのか？
$LINE_SIDEQUEST_1_OUTRO_30_CHAR	$BER
$LINE_SIDEQUEST_1_OUTRO_30_TEXT	ああ、そうなのか。そうだって言いたいんだろ。
$LINE_SIDEQUEST_1_OUTRO_40_CHAR	囚人
$LINE_SIDEQUEST_1_OUTRO_40_TEXT	すみません、そこの変な人。<N>何があったんですか？
$LINE_SIDEQUEST_1_OUTRO_50_CHAR	$BER
$LINE_SIDEQUEST_1_OUTRO_50_TEXT	ゾンビをぶっ倒したんだ！<N>あいつら・・・もうメチャクチャしてやる！って感じでさ・・・。
$LINE_SIDEQUEST_1_OUTRO_60_CHAR	$BER
$LINE_SIDEQUEST_1_OUTRO_60_TEXT	・・・で、俺は、そうはいかんぜ！って感じで・・・
$LINE_SIDEQUEST_1_OUTRO_70_CHAR	$BER
$LINE_SIDEQUEST_1_OUTRO_70_TEXT	で、俺の二の腕がムキムキ！ってなってだな――
$LINE_SIDEQUEST_1_OUTRO_80_CHAR	$BER
$LINE_SIDEQUEST_1_OUTRO_80_TEXT	ヘイ！俺たち、お前らを助けに来たんだぜ！
$LINE_SIDEQUEST_1_OUTRO_90_CHAR	囚人
$LINE_SIDEQUEST_1_OUTRO_90_TEXT	助ける？オジマルの部下ではないのですか？
$LINE_SIDEQUEST_1_OUTRO_100_CHAR	$BER
$LINE_SIDEQUEST_1_OUTRO_100_TEXT	何、寝ぼけたこと言ってんだ？<N>あんな奴の下で働くわけないだろ！
$LINE_SIDEQUEST_1_OUTRO_110_CHAR	$BER
$LINE_SIDEQUEST_1_OUTRO_110_TEXT	あいつ、体臭がきついんだ。
$LINE_SIDEQUEST_1_OUTRO_120_CHAR	$BER
$LINE_SIDEQUEST_1_OUTRO_120_TEXT	俺は、くさい奴とは、付き合わねーことにしてんだ。
$LINE_SIDEQUEST_1_OUTRO_130_CHAR	囚人
$LINE_SIDEQUEST_1_OUTRO_130_TEXT	じゃあ、この牢屋を出てもいいってこと？<N>一体何が起こったの？
$LINE_SIDEQUEST_1_OUTRO_140_CHAR	$BER
$LINE_SIDEQUEST_1_OUTRO_140_TEXT	事の成行きは、俺以外のやつに聞きな。
$LINE_SIDEQUEST_1_OUTRO_150_CHAR	$MCG
$LINE_SIDEQUEST_1_OUTRO_150_TEXT	敵に気づかれる前に、早くここを出た方がいいわ。
$LINE_SIDEQUEST_1_OUTRO_160_CHAR	$MCG
$LINE_SIDEQUEST_1_OUTRO_160_TEXT	他の囚人たちが、この近くで暮らしてる。<N>そこまで案内するよ。
$LINE_SIDEQUEST_1_OUTRO_170_CHAR	$MCG
$LINE_SIDEQUEST_1_OUTRO_170_TEXT	知らないけど、あのクレスカ族の奴に一発喰らわさないの？
$LINE_SIDEQUEST_1_OUTRO_180_CHAR	$RAN
$LINE_SIDEQUEST_1_OUTRO_180_TEXT	ああ、我がゲカ族の妹よ、君は何もわかってないね。
$LINE_SIDEQUEST_1_OUTRO_190_CHAR	$RAN
$LINE_SIDEQUEST_1_OUTRO_190_TEXT	私たちが今ぶん取った戦利品は、<N>あのクレスカ人のしょぼい品物とは比べ物にならないほどいいものなんだ。
$LINE_SIDEQUEST_1_OUTRO_200_CHAR	$RAN
$LINE_SIDEQUEST_1_OUTRO_200_TEXT	もはや、わざわざ一発喰らわす理由なんてない。
$LINE_SIDEQUEST_1_OUTRO_210_CHAR	$MCG
$LINE_SIDEQUEST_1_OUTRO_210_TEXT	え、民族紛争の話は・・・？
$LINE_SIDEQUEST_1_OUTRO_220_CHAR	$RAN
$LINE_SIDEQUEST_1_OUTRO_220_TEXT	*$MCG、私たちのために伝統があるんだ。<N>伝統のために私たちがいるんじゃない。<N>いつだって、最優先事項は生き延びることさ。よく肝に銘じておけ。
$LINE_SIDEQUEST_1_OUTRO_230_CHAR	$MCG
$LINE_SIDEQUEST_1_OUTRO_230_TEXT	じゃ、民族紛争はやりたいことをやるための口実だったってわけ？
$LINE_SIDEQUEST_1_OUTRO_240_CHAR	$RAN
$LINE_SIDEQUEST_1_OUTRO_240_TEXT	よくおわかりで！
$LINE_SIDEQUEST_1_OUTRO_250_CHAR	$RAN
$LINE_SIDEQUEST_1_OUTRO_250_TEXT	よく覚えとくんだ。<N>金持ちは皆、軽蔑されるようなことをしてるってな。
$SCENE_SIDEQUEST_2_GET_TITLE	驚きの連続
$LINE_SIDEQUEST_2_GET_00_CHAR	$BER
$LINE_SIDEQUEST_2_GET_00_TEXT	おい、そこの坊さんよ！
$LINE_SIDEQUEST_2_GET_10_CHAR	$HEA
$LINE_SIDEQUEST_2_GET_10_TEXT	奇妙な友よ、どうされましたか。
$LINE_SIDEQUEST_2_GET_20_CHAR	$BER
$LINE_SIDEQUEST_2_GET_20_TEXT	僧侶ってのは、もっと慈悲深い人間だと思ってたぜ！
$LINE_SIDEQUEST_2_GET_30_CHAR	$HEA
$LINE_SIDEQUEST_2_GET_30_TEXT	ええ、そうでしょう。
$LINE_SIDEQUEST_2_GET_40_CHAR	$BER
$LINE_SIDEQUEST_2_GET_40_TEXT	じゃ、どうして俺を毒殺しようとしてるんだ？
$LINE_SIDEQUEST_2_GET_50_CHAR	$HEA
$LINE_SIDEQUEST_2_GET_50_TEXT	毒殺？
$LINE_SIDEQUEST_2_GET_60_CHAR	$BER
$LINE_SIDEQUEST_2_GET_60_TEXT	何だ、このクサい飯は？
$LINE_SIDEQUEST_2_GET_70_CHAR	$HEA
$LINE_SIDEQUEST_2_GET_70_TEXT	口に合わなかったのですか？
$LINE_SIDEQUEST_2_GET_80_CHAR	$BER
$LINE_SIDEQUEST_2_GET_80_TEXT	口に合わないだと？これ・・・土に生えてるものを混ぜただけだぜ！
$LINE_SIDEQUEST_2_GET_90_CHAR	$HEA
$LINE_SIDEQUEST_2_GET_90_TEXT	野菜のことですか？
$LINE_SIDEQUEST_2_GET_100_CHAR	$BER
$LINE_SIDEQUEST_2_GET_100_TEXT	ああ、そうだよ！
$LINE_SIDEQUEST_2_GET_110_CHAR	$BER
$LINE_SIDEQUEST_2_GET_110_TEXT	*この体を維持するには、野菜なんかじゃダメなんだよ！<N>$MCGみたいな、ひょろひょろの弱虫にはなりたくねーんだ。
$LINE_SIDEQUEST_2_GET_120_CHAR	$MCG
$LINE_SIDEQUEST_2_GET_120_TEXT	ちょっと！
$LINE_SIDEQUEST_2_GET_130_CHAR	$BER
$LINE_SIDEQUEST_2_GET_130_TEXT	あー、何かもうガリガリになってきたような気が・・・。
$LINE_SIDEQUEST_2_GET_140_CHAR	$HEA
$LINE_SIDEQUEST_2_GET_140_TEXT	昔はいつでも魚を食べられたのですが。<N>川をレブナントに汚されてしまったのです。
$LINE_SIDEQUEST_2_GET_150_CHAR	$BER
$LINE_SIDEQUEST_2_GET_150_TEXT	ウォーターゾンビ野郎か？
$LINE_SIDEQUEST_2_GET_160_CHAR	$BER
$LINE_SIDEQUEST_2_GET_160_TEXT	俺の出番だな・・・。
$LINE_SIDEQUEST_2_GET_170_CHAR	$BER
$LINE_SIDEQUEST_2_GET_170_TEXT	*$BERって言やぁ、川殺しの調達屋よ！
$LINE_SIDEQUEST_2_GET_180_CHAR	$BER
$LINE_SIDEQUEST_2_GET_180_TEXT	切り刻み海軍！流血の船乗り！八つ裂きの海兵！
$LINE_SIDEQUEST_2_GET_190_CHAR	$MCG
$LINE_SIDEQUEST_2_GET_190_TEXT	・・・うぬぼれ漁師。
$LINE_SIDEQUEST_2_GET_200_CHAR	$BER
$LINE_SIDEQUEST_2_GET_200_TEXT	俺は大海を行く男よ。<N>お前のしょうもない皮肉なんて、海の藻屑も同然。
$LINE_SIDEQUEST_2_GET_210_CHAR	$MCG
$LINE_SIDEQUEST_2_GET_210_TEXT	アンタが自画自賛の海で泳ぐのに飽きたら、<N>レブナントを倒しに行きたいんだけど。
$SCENE_SIDEQUEST_2_INTRO_TITLE	ナイスなパンツ野郎
$LINE_SIDEQUEST_2_INTRO_00_CHAR	$RAN
$LINE_SIDEQUEST_2_INTRO_00_TEXT	何でまたこんなことを？<N>あのパンツ野郎が野菜を食べられないだけだろ？
$LINE_SIDEQUEST_2_INTRO_10_CHAR	$BER
$LINE_SIDEQUEST_2_INTRO_10_TEXT	ああ、かわいそうに。こんな体になってしまって。
$LINE_SIDEQUEST_2_INTRO_20_CHAR	$RAN
$LINE_SIDEQUEST_2_INTRO_20_TEXT	えっ？
$LINE_SIDEQUEST_2_INTRO_30_CHAR	$BER
$LINE_SIDEQUEST_2_INTRO_30_TEXT	野菜の食べすぎで、イモみたいな体型に・・・。
$LINE_SIDEQUEST_2_INTRO_40_CHAR	$RAN
$LINE_SIDEQUEST_2_INTRO_40_TEXT	おい！
$LINE_SIDEQUEST_2_INTRO_50_CHAR	$MCG
$LINE_SIDEQUEST_2_INTRO_50_TEXT	ふふ。
$LINE_SIDEQUEST_2_INTRO_60_CHAR	$RAN
$LINE_SIDEQUEST_2_INTRO_60_TEXT	馬鹿馬鹿しい。
$LINE_SIDEQUEST_2_INTRO_70_CHAR	$BER
$LINE_SIDEQUEST_2_INTRO_70_TEXT	そうだな。戦うには馬鹿馬鹿しいな。
$LINE_SIDEQUEST_2_INTRO_80_CHAR	$MCG
$LINE_SIDEQUEST_2_INTRO_80_TEXT	えっ？アンタが言い出したんでしょ！？
$LINE_SIDEQUEST_2_INTRO_90_CHAR	$BER
$LINE_SIDEQUEST_2_INTRO_90_TEXT	別に、自分のしてることが賢いとは思ってないぜ。
$LINE_SIDEQUEST_2_INTRO_100_CHAR	$BER
$LINE_SIDEQUEST_2_INTRO_100_TEXT	俺は、俺なんだ！でも、お前はもっと判断力があると思っていたのにな。
$LINE_SIDEQUEST_2_INTRO_110_CHAR	$MCG
$LINE_SIDEQUEST_2_INTRO_110_TEXT	・・・。
$LINE_SIDEQUEST_2_INTRO_120_CHAR	$BER
$LINE_SIDEQUEST_2_INTRO_120_TEXT	ところで、お迎えが来たようだぜ。
$LINE_SIDEQUEST_2_INTRO_130_CHAR	$MCG
$LINE_SIDEQUEST_2_INTRO_130_TEXT	黙ってて。
$SCENE_SIDEQUEST_2_OUTRO_TITLE	フィッシュスティック
$LINE_SIDEQUEST_2_OUTRO_00_CHAR	$RAN
$LINE_SIDEQUEST_2_OUTRO_00_TEXT	今のが最後の敵だな。
$LINE_SIDEQUEST_2_OUTRO_10_CHAR	$BER
$LINE_SIDEQUEST_2_OUTRO_10_TEXT	・・・だが、殺りくは始まったばかりだ。
$LINE_SIDEQUEST_2_OUTRO_20_CHAR	$BER
$LINE_SIDEQUEST_2_OUTRO_20_TEXT	魚ども！自分の呪われた運命を悲しめ！
$LINE_SIDEQUEST_2_OUTRO_30_CHAR	$BER
$LINE_SIDEQUEST_2_OUTRO_30_TEXT	俺は、皆殺しの皇帝だ！
$LINE_SIDEQUEST_2_OUTRO_40_CHAR	$RAN
$LINE_SIDEQUEST_2_OUTRO_40_TEXT	川に再び平和が戻った、と言いたいけど・・・。
$LINE_SIDEQUEST_2_OUTRO_50_CHAR	$RAN
$LINE_SIDEQUEST_2_OUTRO_50_TEXT	・・・剣を振りかざした半裸の変人が魚をぶった切ってるな。
$LINE_SIDEQUEST_2_OUTRO_60_CHAR	$MCG
$LINE_SIDEQUEST_2_OUTRO_60_TEXT	ま、いいんじゃない。
$SCENE_SIDEQUEST_3_GET_TITLE	民族の絆
$LINE_SIDEQUEST_3_GET_00_CHAR	シスター
$LINE_SIDEQUEST_3_GET_00_TEXT	すみません、お仲間の中に、ゲカ族の人間はいませんか？
$LINE_SIDEQUEST_3_GET_10_CHAR	$MCG
$LINE_SIDEQUEST_3_GET_10_TEXT	ほんの数人ね。名誉会員も含めるなら。
$LINE_SIDEQUEST_3_GET_20_CHAR	シスター
$LINE_SIDEQUEST_3_GET_20_TEXT	ゲカ民族の仲間で、病に伏せっている者がおり、今、修道院で看病してもらっています。
$LINE_SIDEQUEST_3_GET_30_CHAR	シスター
$LINE_SIDEQUEST_3_GET_30_TEXT	他にもゲカ民族がいると聞き、彼女が会いたがっているのです。
$LINE_SIDEQUEST_3_GET_40_CHAR	シスター
$LINE_SIDEQUEST_3_GET_40_TEXT	どうかご面会を・・・。<N>これ以上興奮したら、容態が悪化するかもしれません。
$LINE_SIDEQUEST_3_GET_50_CHAR	$BER
$LINE_SIDEQUEST_3_GET_50_TEXT	心配するな！俺は人をリラックスさせる天才だって、よく言われるぜ。
$LINE_SIDEQUEST_3_GET_60_CHAR	シスター
$LINE_SIDEQUEST_3_GET_60_TEXT	ごめんなさい・・・修道院に入れるのは、女性だけなんです。
$LINE_SIDEQUEST_3_GET_70_CHAR	$BER
$LINE_SIDEQUEST_3_GET_70_TEXT	ええっ？何だよ――
$LINE_SIDEQUEST_3_GET_80_CHAR	$RAN
$LINE_SIDEQUEST_3_GET_80_TEXT	ざーんねん。
$LINE_SIDEQUEST_3_GET_90_CHAR	患者
$LINE_SIDEQUEST_3_GET_90_TEXT	彼女は・・・どこに？
$LINE_SIDEQUEST_3_GET_100_CHAR	$RAN
$LINE_SIDEQUEST_3_GET_100_TEXT	*$RAN・タキリ・エン・ゲカです、はじめまして。
$LINE_SIDEQUEST_3_GET_110_CHAR	患者
$LINE_SIDEQUEST_3_GET_110_TEXT	アティア・・・クリクティ・エン・ゲカです。
$LINE_SIDEQUEST_3_GET_120_CHAR	アティア
$LINE_SIDEQUEST_3_GET_120_TEXT	私の命は・・・あといくらももたないでしょう・・・。
$LINE_SIDEQUEST_3_GET_130_CHAR	アティア
$LINE_SIDEQUEST_3_GET_130_TEXT	この壁の外で・・・ゲカ民族の者を・・・見かけました。
$LINE_SIDEQUEST_3_GET_140_CHAR	アティア
$LINE_SIDEQUEST_3_GET_140_TEXT	その者たちは・・・歩く屍の一員となっていました。
$LINE_SIDEQUEST_3_GET_150_CHAR	アティア
$LINE_SIDEQUEST_3_GET_150_TEXT	あんな目にあうなんて・・・彼らは安らぎを得るべきです。
$LINE_SIDEQUEST_3_GET_160_CHAR	$RAN
$LINE_SIDEQUEST_3_GET_160_TEXT	彼らは死人だよ。十分安らいでいるよ。
$LINE_SIDEQUEST_3_GET_170_CHAR	アティア
$LINE_SIDEQUEST_3_GET_170_TEXT	大地をさまよい、肉を求め、うわごとのようにわめく者が？
$LINE_SIDEQUEST_3_GET_180_CHAR	アティア
$LINE_SIDEQUEST_3_GET_180_TEXT	あなたなら・・・彼らを解き放つことができましょう。
$LINE_SIDEQUEST_3_GET_190_CHAR	$RAN
$LINE_SIDEQUEST_3_GET_190_TEXT	うーん、でも、レブナントは殺せないよ。<N>知ってるでしょう？
$LINE_SIDEQUEST_3_GET_200_CHAR	アティア
$LINE_SIDEQUEST_3_GET_200_TEXT	*あなたの友達の・・・$MCGの能力を知っています。<N>あなたの一行だけにできるのですよ！
$LINE_SIDEQUEST_3_GET_210_CHAR	$RAN
$LINE_SIDEQUEST_3_GET_210_TEXT	悪いけど、私には無理。<N>無駄な危険は冒したくない。
$LINE_SIDEQUEST_3_GET_220_CHAR	アティア
$LINE_SIDEQUEST_3_GET_220_TEXT	では、放っておくと？
$LINE_SIDEQUEST_3_GET_230_CHAR	$RAN
$LINE_SIDEQUEST_3_GET_230_TEXT	ミイラ取りがミイラになってもしかたないでしょ。<N>彼らもわかってくれるよ。
$LINE_SIDEQUEST_3_GET_240_CHAR	アティア
$LINE_SIDEQUEST_3_GET_240_TEXT	タキルの娘よ・・・お前は一族の絆につばを吐くのか。
$LINE_SIDEQUEST_3_GET_250_CHAR	アティア
$LINE_SIDEQUEST_3_GET_250_TEXT	こんな日を見るくらいなら、長生きするんじゃなかった。
$LINE_SIDEQUEST_3_GET_260_CHAR	$RAN
$LINE_SIDEQUEST_3_GET_260_TEXT	すでに死んでるやつのために、なんで私の命をかけないといけないんだ。
$LINE_SIDEQUEST_3_GET_270_CHAR	アティア
$LINE_SIDEQUEST_3_GET_270_TEXT	ここから・・・出て・・・行け。
$LINE_SIDEQUEST_3_GET_280_CHAR	$RAN
$LINE_SIDEQUEST_3_GET_280_TEXT	わかった、そうする。
$LINE_SIDEQUEST_3_GET_290_CHAR	アティア
$LINE_SIDEQUEST_3_GET_290_TEXT	一族を捨てし者よ・・・知っておけ・・・あれはケレブとその兄カゲットだったんだ・・・。
$LINE_SIDEQUEST_3_GET_300_CHAR	アティア
$LINE_SIDEQUEST_3_GET_300_TEXT	・・・クラストの息子のな。
$LINE_SIDEQUEST_3_GET_310_CHAR	$RAN
$LINE_SIDEQUEST_3_GET_310_TEXT	・・・
$LINE_SIDEQUEST_3_GET_320_CHAR	$RAN
$LINE_SIDEQUEST_3_GET_320_TEXT	・・・ちきしょう。
$SCENE_SIDEQUEST_3_INTRO_TITLE	借りを返す
$LINE_SIDEQUEST_3_INTRO_00_CHAR	$MCG
$LINE_SIDEQUEST_3_INTRO_00_TEXT	ねえ、ちょっと待ってよ！
$LINE_SIDEQUEST_3_INTRO_10_CHAR	$MCG
$LINE_SIDEQUEST_3_INTRO_10_TEXT	死人を探しに、一人で砂漠に向かうっていうの？
$LINE_SIDEQUEST_3_INTRO_20_CHAR	$RAN
$LINE_SIDEQUEST_3_INTRO_20_TEXT	死人というか、不死のやつらをな。本当の死を与えてやるぜ。
$LINE_SIDEQUEST_3_INTRO_30_CHAR	$MCG
$LINE_SIDEQUEST_3_INTRO_30_TEXT	助けはいらないの？
$LINE_SIDEQUEST_3_INTRO_40_CHAR	$RAN
$LINE_SIDEQUEST_3_INTRO_40_TEXT	これはちょっと・・・個人的なことなんでね。
$LINE_SIDEQUEST_3_INTRO_50_CHAR	$MCG
$LINE_SIDEQUEST_3_INTRO_50_TEXT	それがちょっと不思議でさ。<N>だって・・・あなたのキャラとは違うじゃない。
$LINE_SIDEQUEST_3_INTRO_60_CHAR	$RAN
$LINE_SIDEQUEST_3_INTRO_60_TEXT	あいつらには、借りがあるんだ。
$LINE_SIDEQUEST_3_INTRO_70_CHAR	$MCG
$LINE_SIDEQUEST_3_INTRO_70_TEXT	だからって、一人で無謀なことを？
$LINE_SIDEQUEST_3_INTRO_80_CHAR	$MCG
$LINE_SIDEQUEST_3_INTRO_80_TEXT	お忘れかもしれないけど、レブナントは、生と死のはざま以外では無敵なのよ。
$LINE_SIDEQUEST_3_INTRO_90_CHAR	$RAN
$LINE_SIDEQUEST_3_INTRO_90_TEXT	・・・キミも来てくれるんだろ。
$LINE_SIDEQUEST_3_INTRO_100_CHAR	$MCG
$LINE_SIDEQUEST_3_INTRO_100_TEXT	・・・うん。でも凶暴そうなレブナントも来ちゃったみたい。
$SCENE_SIDEQUEST_3_OUTRO_TITLE	クラスト家の息子
$LINE_SIDEQUEST_3_OUTRO_00_CHAR	$RAN
$LINE_SIDEQUEST_3_OUTRO_00_TEXT	クラスト家の息子たちよ、どうか安らかに。
$LINE_SIDEQUEST_3_OUTRO_10_CHAR	$MCG
$LINE_SIDEQUEST_3_OUTRO_10_TEXT	・・・誰だったの？あの人たち。
$LINE_SIDEQUEST_3_OUTRO_20_CHAR	$RAN
$LINE_SIDEQUEST_3_OUTRO_20_TEXT	そんなこと、どうでもいいだろう？
$LINE_SIDEQUEST_3_OUTRO_30_CHAR	$MCG
$LINE_SIDEQUEST_3_OUTRO_30_TEXT	*冷酷無比で自分のことしか考えないあなたが、<N>どうしてこんな危険を犯してまでこだわるのよ。
$LINE_SIDEQUEST_3_OUTRO_40_CHAR	$RAN
$LINE_SIDEQUEST_3_OUTRO_40_TEXT	昔、私の命を救ってくれたんだ。
$LINE_SIDEQUEST_3_OUTRO_50_CHAR	$RAN
$LINE_SIDEQUEST_3_OUTRO_50_TEXT	私たち全員の命を、ね。
$LINE_SIDEQUEST_3_OUTRO_60_CHAR	$RAN
$LINE_SIDEQUEST_3_OUTRO_60_TEXT	少なくとも逃げのびた人たちにとっては、恩人だ。
$LINE_SIDEQUEST_3_OUTRO_70_CHAR	$MCG
$LINE_SIDEQUEST_3_OUTRO_70_TEXT	逃げのびた？何から？
$LINE_SIDEQUEST_3_OUTRO_80_CHAR	$RAN
$LINE_SIDEQUEST_3_OUTRO_80_TEXT	敵にふいに襲われたんだ。<N>でも、彼らが踏みとどまって、他の者を逃がしてくれたんだ。<N>それだけの話さ。
$LINE_SIDEQUEST_3_OUTRO_90_CHAR	$RAN
$LINE_SIDEQUEST_3_OUTRO_90_TEXT	さあ、もどってあの婆さんに伝えるか。<N>心残りなく逝けるぞ、ってな。
$LINE_SIDEQUEST_3_OUTRO_100_CHAR	$MCG
$LINE_SIDEQUEST_3_OUTRO_100_TEXT	私が考えてた「元カレ説」は外れだったのね・・・。
$LINE_SIDEQUEST_3_OUTRO_110_CHAR	$RAN
$LINE_SIDEQUEST_3_OUTRO_110_TEXT	一族の絆を忘れた私は、惨めなありさまだ。豊穣の時代に、私は欲に走り他者のことは考えもしなかった。
$LINE_SIDEQUEST_3_OUTRO_120_CHAR	$RAN
$LINE_SIDEQUEST_3_OUTRO_120_TEXT	豊穣の時代は終わった。今では私は狼にとり囲まれ、身を守る剣も盾も持ってない。
$LINE_SIDEQUEST_3_OUTRO_130_CHAR	$RAN
$LINE_SIDEQUEST_3_OUTRO_130_TEXT	木枯らしが吹き付けてもテントがない。暗い海がせり上がってもボートがない。救いの手は見えず、癒しの声も聞こえない。
$LINE_SIDEQUEST_3_OUTRO_140_CHAR	$RAN
$LINE_SIDEQUEST_3_OUTRO_140_TEXT	自分で破滅を導いた。強欲と憎悪で、私の心は引き裂かれている。私のような人間に救いはない。
$LINE_SIDEQUEST_3_OUTRO_150_CHAR	$MCG
$LINE_SIDEQUEST_3_OUTRO_150_TEXT	彼女は、いつ亡くなったのかしらね。
$LINE_SIDEQUEST_3_OUTRO_160_CHAR	$RAN
$LINE_SIDEQUEST_3_OUTRO_160_TEXT	良くて、私たちがあの場所を離れて5分ってとこかな。
$LINE_SIDEQUEST_3_OUTRO_170_CHAR	$RAN
$LINE_SIDEQUEST_3_OUTRO_170_TEXT	問題なんて、見ないふりをしていれば自然に解決するってことさ。
$LINE_SIDEQUEST_3_OUTRO_180_CHAR	$MCG
$LINE_SIDEQUEST_3_OUTRO_180_TEXT	そんな悲しい冗談はやめて。
$LINE_SIDEQUEST_3_OUTRO_190_CHAR	$RAN
$LINE_SIDEQUEST_3_OUTRO_190_TEXT	いや、本当に悲しいのは、すべてが無駄だったことだよ。
$LINE_SIDEQUEST_3_OUTRO_200_CHAR	$MCG
$LINE_SIDEQUEST_3_OUTRO_200_TEXT	命の恩人を助けたじゃない。＜N>それは、無駄じゃない。
$LINE_SIDEQUEST_3_OUTRO_210_CHAR	$RAN
$LINE_SIDEQUEST_3_OUTRO_210_TEXT	助けた、か・・・。
$LINE_SIDEQUEST_3_OUTRO_220_CHAR	$MCG
$LINE_SIDEQUEST_3_OUTRO_220_TEXT	・・・話したら、楽になるかもよ。
$LINE_SIDEQUEST_3_OUTRO_230_CHAR	$RAN
$LINE_SIDEQUEST_3_OUTRO_230_TEXT	そうだね！激動の人生を語って、傷をなめ合おうぜ。
$LINE_SIDEQUEST_3_OUTRO_240_CHAR	$MCG
$LINE_SIDEQUEST_3_OUTRO_240_TEXT	そう、話し合うのって――
$LINE_SIDEQUEST_3_OUTRO_250_CHAR	$MCG
$LINE_SIDEQUEST_3_OUTRO_250_TEXT	――いや、今のはいつもの皮肉ね？
$LINE_SIDEQUEST_3_OUTRO_260_CHAR	$RAN
$LINE_SIDEQUEST_3_OUTRO_260_TEXT	今日の分はまだ、言っていなかったよね。「キミってけっこう、私と比べて不細工かつ不器用だよね。」
$LINE_SIDEQUEST_3_OUTRO_270_CHAR	$MCG
$LINE_SIDEQUEST_3_OUTRO_270_TEXT	あんた、いい性格しているよ。
$LINE_SIDEQUEST_3_OUTRO_280_CHAR	$RAN
$LINE_SIDEQUEST_3_OUTRO_280_TEXT	ああ、なんだか心が軽くなってきたな。
$LINE_SIDEQUEST_3_OUTRO_290_CHAR	$MCG
$LINE_SIDEQUEST_3_OUTRO_290_TEXT	よかったね！じゃ、レーズンプリン事件のこと、教えてあげない！
$LINE_SIDEQUEST_3_OUTRO_300_CHAR	$RAN
$LINE_SIDEQUEST_3_OUTRO_300_TEXT	<LQ>レーズンプリン事件？<RQ>
$LINE_SIDEQUEST_3_OUTRO_310_CHAR	$MCG
$LINE_SIDEQUEST_3_OUTRO_310_TEXT	教えないわよ。
$LINE_SIDEQUEST_3_OUTRO_320_CHAR	$RAN
$LINE_SIDEQUEST_3_OUTRO_320_TEXT	知りたくてうずうずする・・・。
$LINE_SIDEQUEST_3_OUTRO_330_CHAR	$RAN
$LINE_SIDEQUEST_3_OUTRO_330_TEXT	くそっ！
$LINE_SIDEQUEST_3_OUTRO_340_CHAR	$MAG
$LINE_SIDEQUEST_3_OUTRO_340_TEXT	私、レーズンプリンで人を殺したことがあります。
$LINE_SIDEQUEST_3_OUTRO_350_CHAR	$MAG
$LINE_SIDEQUEST_3_OUTRO_350_TEXT	コツは、確実に窒息死するように、相手がぐったりしても１分ぐらいは相手の顔をプリンに押し当て続けることです。
$LINE_SIDEQUEST_3_OUTRO_360_CHAR	$MAG
$LINE_SIDEQUEST_3_OUTRO_360_TEXT	そうでないと、プリンまみれの形相で頭をぴょこっとあげてきます。となれば、ローストターキーなんかでたたき殺さねばなりませんね。
$LINE_SIDEQUEST_3_OUTRO_370_CHAR	$MAG
$LINE_SIDEQUEST_3_OUTRO_370_TEXT	しかしそうすると、ターキーが台無しだと父親が怒り出す。「だってお父さん、暗殺者が襲ってきたから」と訴えてもダメ・・・
$LINE_SIDEQUEST_3_OUTRO_380_CHAR	$MAG
$LINE_SIDEQUEST_3_OUTRO_380_TEXT	・・・「お前に与えた剣を、なんで常に身につけていないんだ」と怒られてしまうのがオチです。
$LINE_SIDEQUEST_3_OUTRO_390_CHAR	$MAG
$LINE_SIDEQUEST_3_OUTRO_390_TEXT	「他の女の子に笑われるもん」と言うと、「ならば笑う子の首を切り落としなさい」と言われる。「部屋で短剣投げの練習でもしてろ！」とね。
$LINE_SIDEQUEST_3_OUTRO_400_CHAR	$RAN
$LINE_SIDEQUEST_3_OUTRO_400_TEXT	・・・。
$LINE_SIDEQUEST_3_OUTRO_410_CHAR	$MAG
$LINE_SIDEQUEST_3_OUTRO_410_TEXT	こういうガールズトークができるって、サイコーですね。
$SCENE_SIDEQUEST_4_GET_TITLE	平和な荒野
$NARR_SIDEQUEST_4_GET_00_TEXT	さかのぼること数時間・・・
$LINE_SIDEQUEST_4_GET_00_CHAR	$BER
$LINE_SIDEQUEST_4_GET_00_TEXT	前の殺しから、丸2日か・・・
$LINE_SIDEQUEST_4_GET_10_CHAR	$BER
$LINE_SIDEQUEST_4_GET_10_TEXT	退屈すぎて、どうかなりそうだ。
$LINE_SIDEQUEST_4_GET_20_CHAR	$BER
$LINE_SIDEQUEST_4_GET_20_TEXT	助けてくれ！
$LINE_SIDEQUEST_4_GET_30_CHAR	$HEA
$LINE_SIDEQUEST_4_GET_30_TEXT	どうされましたか？
$LINE_SIDEQUEST_4_GET_40_CHAR	$BER
$LINE_SIDEQUEST_4_GET_40_TEXT	ここは荒野だ！耐えがたき平和の荒野にいる！
$LINE_SIDEQUEST_4_GET_50_CHAR	$BER
$LINE_SIDEQUEST_4_GET_50_TEXT	ああ、こんな終わり方をするだなんて！
$LINE_SIDEQUEST_4_GET_60_CHAR	$BER
$LINE_SIDEQUEST_4_GET_60_TEXT	*$BER、ここに眠る。残酷にも、仲間に見捨てられた上、殺しが足りず死亡。
$LINE_SIDEQUEST_4_GET_70_CHAR	$HEA
$LINE_SIDEQUEST_4_GET_70_TEXT	・・・。
$LINE_SIDEQUEST_4_GET_80_CHAR	$BER
$LINE_SIDEQUEST_4_GET_80_TEXT	やめてくれ、助けようとしないでくれ。<N>運命には逆らえないんだ。ただ、退屈に悩まされながら、座して死を待つだけなんだ。
$LINE_SIDEQUEST_4_GET_90_CHAR	$BER
$LINE_SIDEQUEST_4_GET_90_TEXT	あああっ、あの眩い光は何だ？
$LINE_SIDEQUEST_4_GET_100_CHAR	$HEA
$LINE_SIDEQUEST_4_GET_100_TEXT	えっ？
$LINE_SIDEQUEST_4_GET_110_CHAR	$BER
$LINE_SIDEQUEST_4_GET_110_TEXT	来たれ、眩い光よ！
$LINE_SIDEQUEST_4_GET_120_CHAR	$BER
$LINE_SIDEQUEST_4_GET_120_TEXT	お前を殺してやる！
$SCENE_SIDEQUEST_4_INTRO_TITLE	謎の女
$LINE_SIDEQUEST_4_INTRO_00_CHAR	$HEA
$LINE_SIDEQUEST_4_INTRO_00_TEXT	何が起きたのでしょう？
$LINE_SIDEQUEST_4_INTRO_10_CHAR	$BER
$LINE_SIDEQUEST_4_INTRO_10_TEXT	*きっと、$MCGだ。
$LINE_SIDEQUEST_4_INTRO_20_CHAR	$BER
$LINE_SIDEQUEST_4_INTRO_20_TEXT	殺しが始まるのか？お呼びがかかるって、信じていたぜ！
$LINE_SIDEQUEST_4_INTRO_30_CHAR	$HEA
$LINE_SIDEQUEST_4_INTRO_30_TEXT	でも、彼女は近くにいないと召喚できない・・・<N>彼女のはずは――
$LINE_SIDEQUEST_4_INTRO_40_CHAR	謎の女
$LINE_SIDEQUEST_4_INTRO_40_TEXT	うーん・・・期待していた人ではなかったかしら。
$LINE_SIDEQUEST_4_INTRO_50_CHAR	$BER
$LINE_SIDEQUEST_4_INTRO_50_TEXT	よう、ミステリアスな美人のねーちゃん！喧嘩屋を雇わないか？颯爽として強く、なおかつ繊細な精神を持ち合わせたやつがいるんだ。
$LINE_SIDEQUEST_4_INTRO_60_CHAR	謎の女
$LINE_SIDEQUEST_4_INTRO_60_TEXT	ふっ、お前を呼び寄せたのはなぜだと思う？
$LINE_SIDEQUEST_4_INTRO_70_CHAR	謎の女
$LINE_SIDEQUEST_4_INTRO_70_TEXT	この神殿に用があるのだが、中のやつらに拒まれてな。<N>私と一緒に中の亡者を駆逐してくれないか？
$LINE_SIDEQUEST_4_INTRO_80_CHAR	$BER
$LINE_SIDEQUEST_4_INTRO_80_TEXT	結婚しようよぅ！
$LINE_SIDEQUEST_4_INTRO_90_CHAR	謎の女
$LINE_SIDEQUEST_4_INTRO_90_TEXT	神殿はこちらだ。
$LINE_SIDEQUEST_4_INTRO_100_CHAR	$HEA
$LINE_SIDEQUEST_4_INTRO_100_TEXT	いい予感がしないな。
$LINE_SIDEQUEST_4_INTRO_110_CHAR	$BER
$LINE_SIDEQUEST_4_INTRO_110_TEXT	アンタは僧侶だから見落とすのもわかるけどさ、彼女、チョー美人じゃね？
$LINE_SIDEQUEST_4_INTRO_120_CHAR	$HEA
$LINE_SIDEQUEST_4_INTRO_120_TEXT	では、彼女の言いなりになると？
$LINE_SIDEQUEST_4_INTRO_130_CHAR	$BER
$LINE_SIDEQUEST_4_INTRO_130_TEXT	えっと・・・それは・・・
$LINE_SIDEQUEST_4_INTRO_140_CHAR	$BER
$LINE_SIDEQUEST_4_INTRO_140_TEXT	その通りさ。
$SCENE_SIDEQUEST_4_OUTRO_TITLE	何の話だったのか
$LINE_SIDEQUEST_4_OUTRO_00_CHAR	$HEA
$LINE_SIDEQUEST_4_OUTRO_00_TEXT	待て。私はこの廃墟を知ってるぞ。
$LINE_SIDEQUEST_4_OUTRO_10_CHAR	$HEA
$LINE_SIDEQUEST_4_OUTRO_10_TEXT	お前は誰だ？どうして私たちを連れて来た？
$LINE_SIDEQUEST_4_OUTRO_20_CHAR	$HEA
$LINE_SIDEQUEST_4_OUTRO_20_TEXT	似た能力を持つ女性を他にも知っているが・・・<N>お主の能力とは少し違うようだな。
$LINE_SIDEQUEST_4_OUTRO_30_CHAR	謎の女
$LINE_SIDEQUEST_4_OUTRO_30_TEXT	*$MCG・ライブラーを知っているのか？
$LINE_SIDEQUEST_4_OUTRO_40_CHAR	謎の女
$LINE_SIDEQUEST_4_OUTRO_40_TEXT	もちろん・・・もっと早く気付くべきだった。
$LINE_SIDEQUEST_4_OUTRO_50_CHAR	謎の女
$LINE_SIDEQUEST_4_OUTRO_50_TEXT	もしそうなら・・・いえ、駄目。危険すぎる。
$LINE_SIDEQUEST_4_OUTRO_60_CHAR	$HEA
$LINE_SIDEQUEST_4_OUTRO_60_TEXT	*どうして$MCGを知っている？
$LINE_SIDEQUEST_4_OUTRO_70_CHAR	謎の女
$LINE_SIDEQUEST_4_OUTRO_70_TEXT	・・・
$LINE_SIDEQUEST_4_OUTRO_80_CHAR	謎の女
$LINE_SIDEQUEST_4_OUTRO_80_TEXT	この線一本でお前はすべてを忘れる。
$LINE_SIDEQUEST_4_OUTRO_90_CHAR	$HEA
$LINE_SIDEQUEST_4_OUTRO_90_TEXT	むっ？
$LINE_SIDEQUEST_4_OUTRO_100_CHAR	$HEA
$LINE_SIDEQUEST_4_OUTRO_100_TEXT	・・・何の話をしていたかな？
$LINE_SIDEQUEST_4_OUTRO_110_CHAR	$BER
$LINE_SIDEQUEST_4_OUTRO_110_TEXT	だから、まったく暴力を振るわずに2日間も経ったって話よ。
$LINE_SIDEQUEST_4_OUTRO_120_CHAR	$BER
$LINE_SIDEQUEST_4_OUTRO_120_TEXT	殺人筋が衰えるぜ・・・。
$LINE_SIDEQUEST_4_OUTRO_130_CHAR	$HEA
$LINE_SIDEQUEST_4_OUTRO_130_TEXT	これを機に、瞑想でもしてみたらいかがです。
$LINE_SIDEQUEST_4_OUTRO_140_CHAR	$BER
$LINE_SIDEQUEST_4_OUTRO_140_TEXT	そんなの退屈で死んじゃうよぉ！
$LINE_SIDEQUEST_4_OUTRO_150_CHAR	$MCG
$LINE_SIDEQUEST_4_OUTRO_150_TEXT	ごめんなさい、修道院から戻ったわ。
$LINE_SIDEQUEST_4_OUTRO_160_CHAR	$BER
$LINE_SIDEQUEST_4_OUTRO_160_TEXT	もう、俺を置いてくんじゃねえ！
$SCENE_SIDEQUEST_7_GET_TITLE	秘密の隠し場所
$LINE_SIDEQUEST_7_GET_00_CHAR	$MCG
$LINE_SIDEQUEST_7_GET_00_TEXT	で・・・、ここにあるものは全部あなたのものなの？<N>最初に見つけたっていうだけで？
$LINE_SIDEQUEST_7_GET_10_CHAR	$DRA
$LINE_SIDEQUEST_7_GET_10_TEXT	文句あるか、人間め？
$LINE_SIDEQUEST_7_GET_20_CHAR	$MCG
$LINE_SIDEQUEST_7_GET_20_TEXT	いや、全然！ただ、どういうルールなのか知りたかっただけ。
$LINE_SIDEQUEST_7_GET_30_CHAR	$DRA
$LINE_SIDEQUEST_7_GET_30_TEXT	ふむ。
$LINE_SIDEQUEST_7_GET_40_CHAR	$MCG
$LINE_SIDEQUEST_7_GET_40_TEXT	じゃあ、例えば、私が宝がぎっしり詰まった部屋を見つけたとしたら、その部屋は私のもの？
$LINE_SIDEQUEST_7_GET_50_CHAR	$DRA
$LINE_SIDEQUEST_7_GET_50_TEXT	ふん、人間に黄金が嗅ぎ分けられるか？お前の傲慢さには笑うよ。
$LINE_SIDEQUEST_7_GET_60_CHAR	$MCG
$LINE_SIDEQUEST_7_GET_60_TEXT	でも、もし私がそういう部屋を見つけたら、私が正当な持ち主。<N>そうだよね？
$LINE_SIDEQUEST_7_GET_70_CHAR	$DRA
$LINE_SIDEQUEST_7_GET_70_TEXT	その通り。
$LINE_SIDEQUEST_7_GET_80_CHAR	$MCG
$LINE_SIDEQUEST_7_GET_80_TEXT	じゃ、ここの地下にある秘密の部屋にある物は、私の物ね？
$LINE_SIDEQUEST_7_GET_90_CHAR	$DRA
$LINE_SIDEQUEST_7_GET_90_TEXT	何だと？
$LINE_SIDEQUEST_7_GET_100_CHAR	$MCG
$LINE_SIDEQUEST_7_GET_100_TEXT	この床の隠し扉の下の部屋のことよ。
$LINE_SIDEQUEST_7_GET_110_CHAR	$MCG
$LINE_SIDEQUEST_7_GET_110_TEXT	昔ながらの要塞のやり方ね。<N>宝の部屋をつくっておいて、そこには2番目に大切な物をしまっておく。
$LINE_SIDEQUEST_7_GET_120_CHAR	$MCG
$LINE_SIDEQUEST_7_GET_120_TEXT	で、その下にも宝の部屋をつくって、そこに本当に大切な物をしまうのよ。
$LINE_SIDEQUEST_7_GET_130_CHAR	$MCG
$LINE_SIDEQUEST_7_GET_130_TEXT	侵入者は、最初の部屋を見つけて満足して帰っていく。<N>本当の宝を手に入れてないことに気付きもせずにね。
$LINE_SIDEQUEST_7_GET_140_CHAR	$MCG
$LINE_SIDEQUEST_7_GET_140_TEXT	コルレディアン・コレディオスは、こうやって首都略奪から宝を守ったの。<N>南部統一戦記に書いてあったわ。
$LINE_SIDEQUEST_7_GET_150_CHAR	$MCG
$LINE_SIDEQUEST_7_GET_150_TEXT	そんなことも知らないなんてね。
$LINE_SIDEQUEST_7_GET_160_CHAR	$MCG
$LINE_SIDEQUEST_7_GET_160_TEXT	・・・ここの地下には、どんなお宝が眠ってるんだろ。
$LINE_SIDEQUEST_7_GET_170_CHAR	$DRA
$LINE_SIDEQUEST_7_GET_170_TEXT	・・・ぐむむ。
$SCENE_SIDEQUEST_7_INTRO_TITLE	燃える月
$LINE_SIDEQUEST_7_INTRO_00_CHAR	$KNI
$LINE_SIDEQUEST_7_INTRO_00_TEXT	お嬢様、私が先頭を。お守りさせてください。
$LINE_SIDEQUEST_7_INTRO_10_CHAR	$MCG
$LINE_SIDEQUEST_7_INTRO_10_TEXT	もう。やりすぎよ。
$LINE_SIDEQUEST_7_INTRO_20_CHAR	$KNI
$LINE_SIDEQUEST_7_INTRO_20_TEXT	自分の身くらい守れますって言いたそうですね。でも私はむしろ、自分勝手な理由でお願いしているんです。
$LINE_SIDEQUEST_7_INTRO_30_CHAR	$MCG
$LINE_SIDEQUEST_7_INTRO_30_TEXT	命をかけて忠誠を誓うって、どう考えても自分勝手じゃないでしょう。
$LINE_SIDEQUEST_7_INTRO_40_CHAR	$KNI
$LINE_SIDEQUEST_7_INTRO_40_TEXT	そうですか？もしあなたを死なせたら、どうなるでしょう？
$LINE_SIDEQUEST_7_INTRO_50_CHAR	$MCG
$LINE_SIDEQUEST_7_INTRO_50_TEXT	他の騎士がアイツは最低な仕事ぶりだって噂するでしょうね。
$LINE_SIDEQUEST_7_INTRO_60_CHAR	$KNI
$LINE_SIDEQUEST_7_INTRO_60_TEXT	まあ、それもあります。それから、自決しなければなりません。
$LINE_SIDEQUEST_7_INTRO_70_CHAR	$MCG
$LINE_SIDEQUEST_7_INTRO_70_TEXT	本当？うわぁ、そうなんだ・・・思ってたより、女々しくなかったのね。
$LINE_SIDEQUEST_7_INTRO_80_CHAR	$KNI
$LINE_SIDEQUEST_7_INTRO_80_TEXT	何ですと？
$LINE_SIDEQUEST_7_INTRO_90_CHAR	$MCG
$LINE_SIDEQUEST_7_INTRO_90_TEXT	その鎧がちょっとね。<N>まあ、いずれにせよ心配はないね。ただの宝の部屋みたいだね。
$LINE_SIDEQUEST_7_INTRO_100_CHAR	$MCG
$LINE_SIDEQUEST_7_INTRO_100_TEXT	でも、大量の死体があるね。<N>幸い、動いていないけど・・・
$LINE_SIDEQUEST_7_INTRO_110_CHAR	謎の女
$LINE_SIDEQUEST_7_INTRO_110_TEXT	*$MCG・ライブラー。きっと来るだろうと思っていたぞ。
$LINE_SIDEQUEST_7_INTRO_120_CHAR	$MCG
$LINE_SIDEQUEST_7_INTRO_120_TEXT	えっ？
$LINE_SIDEQUEST_7_INTRO_130_CHAR	$KNI
$LINE_SIDEQUEST_7_INTRO_130_TEXT	魔女だ！
$LINE_SIDEQUEST_7_INTRO_140_CHAR	$KNI
$LINE_SIDEQUEST_7_INTRO_140_TEXT	みんな、ここから出るんだ！
$LINE_SIDEQUEST_7_INTRO_150_CHAR	謎の女
$LINE_SIDEQUEST_7_INTRO_150_TEXT	扉は閉ざされている。あなた方にはここにいてもらわないと。
$LINE_SIDEQUEST_7_INTRO_160_CHAR	$MCG
$LINE_SIDEQUEST_7_INTRO_160_TEXT	こんな死体だらけのところで何を？
$LINE_SIDEQUEST_7_INTRO_170_CHAR	謎の女
$LINE_SIDEQUEST_7_INTRO_170_TEXT	ある人と話がしたいのだ。
$LINE_SIDEQUEST_7_INTRO_180_CHAR	謎の女
$LINE_SIDEQUEST_7_INTRO_180_TEXT	エズティル・テノクを召喚します。<N>さあ、出でよ、この線の力で！
$LINE_SIDEQUEST_7_INTRO_190_CHAR	エズティル・テノク
$LINE_SIDEQUEST_7_INTRO_190_TEXT	誰だ？我が・・・トレトル・メズトリ・・・か。
$LINE_SIDEQUEST_7_INTRO_200_CHAR	エズティル・テノク
$LINE_SIDEQUEST_7_INTRO_200_TEXT	燃える月よ。ああ、何よりも手に入れたいものよ。ついに、部下を引き連れて、私を解放しに来てくれたのか？
$LINE_SIDEQUEST_7_INTRO_210_CHAR	トレトル・メズトリ
$LINE_SIDEQUEST_7_INTRO_210_TEXT	いいえ・・・あなたと私の両方を解放するためです。
$LINE_SIDEQUEST_7_INTRO_220_CHAR	エズティル・テノク
$LINE_SIDEQUEST_7_INTRO_220_TEXT	それは不可能だろう。
$LINE_SIDEQUEST_7_INTRO_230_CHAR	トレトル・メズトリ
$LINE_SIDEQUEST_7_INTRO_230_TEXT	私もずっとそう思っていました・・・でも、ご覧になって。
$LINE_SIDEQUEST_7_INTRO_240_CHAR	トレトル・メズトリ
$LINE_SIDEQUEST_7_INTRO_240_TEXT	今、鍵が目の前にあります。・・・それでも私は手をつけていません。
$LINE_SIDEQUEST_7_INTRO_250_CHAR	エズティル・テノク
$LINE_SIDEQUEST_7_INTRO_250_TEXT	彼女が、ここにいるのか！？
$LINE_SIDEQUEST_7_INTRO_260_CHAR	トレトル・メズトリ
$LINE_SIDEQUEST_7_INTRO_260_TEXT	そうです。それでも私は誘惑に打ち勝つことができました。
$LINE_SIDEQUEST_7_INTRO_270_CHAR	エズティル・テノク
$LINE_SIDEQUEST_7_INTRO_270_TEXT	彼女がここにいるのか！何故、私を解放してくれない？
$LINE_SIDEQUEST_7_INTRO_280_CHAR	トレトル・メズトリ
$LINE_SIDEQUEST_7_INTRO_280_TEXT	どうか考え直して！あなたには、その選択肢があるのです！
$LINE_SIDEQUEST_7_INTRO_290_CHAR	エズティル・テノク
$LINE_SIDEQUEST_7_INTRO_290_TEXT	裏切り者め！我が子たちが、お前が出来んことをするぞ！
$LINE_SIDEQUEST_7_INTRO_300_CHAR	トレトル・メズトリ
$LINE_SIDEQUEST_7_INTRO_300_TEXT	*$MCG！助けて！彼を抑えなければ！
$SCENE_SIDEQUEST_7_OUTRO_TITLE	サーとサリーア
$LINE_SIDEQUEST_7_OUTRO_00_CHAR	トレトル・メズトリ
$LINE_SIDEQUEST_7_OUTRO_00_TEXT	私たちの心の悪魔が・・・私たちをより下らない存在へ変えていく。私たちが再び一緒になれば、世界は燃えてしまう！
$LINE_SIDEQUEST_7_OUTRO_10_CHAR	エズティル・テノク
$LINE_SIDEQUEST_7_OUTRO_10_TEXT	燃えるのではない。浄化するのだ。弱くて醜い者どもの煩悩を断ち切るのだ。
$LINE_SIDEQUEST_7_OUTRO_20_CHAR	トレトル・メズトリ
$LINE_SIDEQUEST_7_OUTRO_20_TEXT	できない・・・そんなことはできない。
$LINE_SIDEQUEST_7_OUTRO_30_CHAR	エズティル・テノク
$LINE_SIDEQUEST_7_OUTRO_30_TEXT	それが・・・私に対する愛なのか？
$LINE_SIDEQUEST_7_OUTRO_40_CHAR	エズティル・テノク
$LINE_SIDEQUEST_7_OUTRO_40_TEXT	我らが何者なのか、忘れたのか！
$LINE_SIDEQUEST_7_OUTRO_50_CHAR	トレトル・メズトリ
$LINE_SIDEQUEST_7_OUTRO_50_TEXT	忘れたのはあなたよ！<N>私がどれだけ、遠い昔の日々に戻りたがっていたか・・・。
$LINE_SIDEQUEST_7_OUTRO_60_CHAR	トレトル・メズトリ
$LINE_SIDEQUEST_7_OUTRO_60_TEXT	血の系譜の前。血の果実や燃える月よりその前。<N>私たちがただ、サーとサリーアと呼び合っていたとき。
$LINE_SIDEQUEST_7_OUTRO_70_CHAR	エズティル・テノク
$LINE_SIDEQUEST_7_OUTRO_70_TEXT	その名は、もう死んだのだ。
$LINE_SIDEQUEST_7_OUTRO_80_CHAR	トレトル・メズトリ
$LINE_SIDEQUEST_7_OUTRO_80_TEXT	私たちがどう変わるかわかっていたなら、私たちは―
$LINE_SIDEQUEST_7_OUTRO_90_CHAR	エズティル・テノク
$LINE_SIDEQUEST_7_OUTRO_90_TEXT	全く同じことをしただろう。
$LINE_SIDEQUEST_7_OUTRO_100_CHAR	エズティル・テノク
$LINE_SIDEQUEST_7_OUTRO_100_TEXT	お前の望みは、かなわぬ願いだ。
$LINE_SIDEQUEST_7_OUTRO_110_CHAR	エズティル・テノク
$LINE_SIDEQUEST_7_OUTRO_110_TEXT	我らは神の王冠を戴いたのだぞ！<N>我らだけが民衆の上に立ち、判断し、導き、淘汰するんだ！もう、元には戻れん！
$LINE_SIDEQUEST_7_OUTRO_120_CHAR	エズティル・テノク
$LINE_SIDEQUEST_7_OUTRO_120_TEXT	この恐ろしい責任から逃れることはできんのだ。
$LINE_SIDEQUEST_7_OUTRO_130_CHAR	トレトリ・メズトリ
$LINE_SIDEQUEST_7_OUTRO_130_TEXT	確かに、私は大地に血で名を記した。
$LINE_SIDEQUEST_7_OUTRO_140_CHAR	トレトリ・メズトリ
$LINE_SIDEQUEST_7_OUTRO_140_TEXT	でも、過去と決別することは、できる。
$LINE_SIDEQUEST_7_OUTRO_150_CHAR	エズティル・テノク
$LINE_SIDEQUEST_7_OUTRO_150_TEXT	愚か者め。
$LINE_SIDEQUEST_7_OUTRO_160_CHAR	トレトリ・メズトリ
$LINE_SIDEQUEST_7_OUTRO_160_TEXT	お願い―
$LINE_SIDEQUEST_7_OUTRO_170_CHAR	エズティル・テノク
$LINE_SIDEQUEST_7_OUTRO_170_TEXT	我らの目的を否定するのか？<N>我らが成し遂げたことに、背を向けるのか？
$LINE_SIDEQUEST_7_OUTRO_180_CHAR	エズティル・テノク
$LINE_SIDEQUEST_7_OUTRO_180_TEXT	我らがいない間に、世界がどうなったのか、わからないのか？
$LINE_SIDEQUEST_7_OUTRO_190_CHAR	トレトリ・メズトリ
$LINE_SIDEQUEST_7_OUTRO_190_TEXT	いたら、もっと悪くなっただけです。
$LINE_SIDEQUEST_7_OUTRO_200_CHAR	トレトリ・メズトリ
$LINE_SIDEQUEST_7_OUTRO_200_TEXT	私の願いです！
$LINE_SIDEQUEST_7_OUTRO_210_CHAR	トレトリ・メズトリ
$LINE_SIDEQUEST_7_OUTRO_210_TEXT	いいえ・・・
$LINE_SIDEQUEST_7_OUTRO_220_CHAR	サリーア
$LINE_SIDEQUEST_7_OUTRO_220_TEXT	・・・サリーアだった者の願いです。お互いを解放しましょう。
$LINE_SIDEQUEST_7_OUTRO_230_CHAR	サリーア
$LINE_SIDEQUEST_7_OUTRO_230_TEXT	私に、破壊を。破壊という贈り物をください。
$LINE_SIDEQUEST_7_OUTRO_240_CHAR	エズティル・テノク
$LINE_SIDEQUEST_7_OUTRO_240_TEXT	・・・
$LINE_SIDEQUEST_7_OUTRO_250_CHAR	エズティル・テノク
$LINE_SIDEQUEST_7_OUTRO_250_TEXT	お前に贈れる、最後の贈り物だ。
$LINE_SIDEQUEST_7_OUTRO_260_CHAR	エズティル・テノク
$LINE_SIDEQUEST_7_OUTRO_260_TEXT	・・・
$LINE_SIDEQUEST_7_OUTRO_270_CHAR	エズティル・テノク
$LINE_SIDEQUEST_7_OUTRO_270_TEXT	これで、人間であった最後の名残りもかなぐり捨てた。
$LINE_SIDEQUEST_7_OUTRO_280_CHAR	エズティル・テノク
$LINE_SIDEQUEST_7_OUTRO_280_TEXT	間もなく、このひ弱な世界に裁きの手が下りてくるだろう。
$LINE_SIDEQUEST_7_OUTRO_290_CHAR	エズティル・テノク
$LINE_SIDEQUEST_7_OUTRO_290_TEXT	*心しておけ、$MCG。
$LINE_SIDEQUEST_7_OUTRO_300_CHAR	エズティル・テノク
$LINE_SIDEQUEST_7_OUTRO_300_TEXT	貴様のせいで・・・女王が・・・
$LINE_SIDEQUEST_7_OUTRO_310_CHAR	エズティル・テノク
$LINE_SIDEQUEST_7_OUTRO_310_TEXT	だが、貴様には器になってもらう<N>・・・人類を偉大なる存在へと導くためのな。
$LINE_SIDEQUEST_7_OUTRO_320_CHAR	$MCG
$LINE_SIDEQUEST_7_OUTRO_320_TEXT	・・・。
$LINE_SIDEQUEST_7_OUTRO_330_CHAR	$MCG
$LINE_SIDEQUEST_7_OUTRO_330_TEXT	・・・サーと、サリーア・・・。
$SCENE_HERMIT_1_INTRO_TITLE	あなたのために特別価格で！
$LINE_HERMIT_1_INTRO_00_CHAR	隠遁者
$LINE_HERMIT_1_INTRO_00_TEXT	おい、そこのよそ者！
$LINE_HERMIT_1_INTRO_10_CHAR	$MCG
$LINE_HERMIT_1_INTRO_10_TEXT	あなたのことを知っているような・・・。<N>以前、お会いしました？
$LINE_HERMIT_1_INTRO_20_CHAR	隠遁者
$LINE_HERMIT_1_INTRO_20_TEXT	わからん。<N>が、会わなかったとは言い切れない。ところで―
$LINE_HERMIT_1_INTRO_30_CHAR	隠遁者
$LINE_HERMIT_1_INTRO_30_TEXT	ドクロを持っているかい？
$LINE_HERMIT_1_INTRO_40_CHAR	隠遁者
$LINE_HERMIT_1_INTRO_40_TEXT	あなたの頭の頭蓋骨とは別のやつさ。<N>わしは、はっきりわかる・・・。
$LINE_HERMIT_1_INTRO_50_CHAR	隠遁者
$LINE_HERMIT_1_INTRO_50_TEXT	だって、もしそれがなかったら、頭はブヨブヨ、グラグラだからね。
$LINE_HERMIT_1_INTRO_60_CHAR	$MCG
$LINE_HERMIT_1_INTRO_60_TEXT	*あぁ・・・頭蓋骨なら$BERが集めてるわよ。<N>何か気持ち悪いけど。
$LINE_HERMIT_1_INTRO_70_CHAR	$MCG
$LINE_HERMIT_1_INTRO_70_TEXT	実は、ちょっと彼のことが心配なの。
$LINE_HERMIT_1_INTRO_80_CHAR	$MCG
$LINE_HERMIT_1_INTRO_80_TEXT	でも、ちょっとだけだよ。
$LINE_HERMIT_1_INTRO_90_CHAR	隠遁者
$LINE_HERMIT_1_INTRO_90_TEXT	ああ、レブナントの頭蓋骨じゃないよ！<N>そういう馬鹿なことはそいつだけにしときな。
$LINE_HERMIT_1_INTRO_100_CHAR	隠遁者
$LINE_HERMIT_1_INTRO_100_TEXT	わしが言ってるのは・・・
$LINE_HERMIT_1_INTRO_110_CHAR	隠遁者
$LINE_HERMIT_1_INTRO_110_TEXT	魔法のドクロだ！
$LINE_HERMIT_1_INTRO_120_CHAR	隠遁者
$LINE_HERMIT_1_INTRO_120_TEXT	石やブロンズや黒曜石でできてるドクロさ。<N>レブナントが持ち歩いてたりするんだ。
$LINE_HERMIT_1_INTRO_130_CHAR	隠遁者
$LINE_HERMIT_1_INTRO_130_TEXT	ともかく見つけたら、持って来てくれ。<N>礼はたっぷりする。
$LINE_HERMIT_1_INTRO_140_CHAR	$MCG
$LINE_HERMIT_1_INTRO_140_TEXT	何でそんなものがほしいの？
$LINE_HERMIT_1_INTRO_150_CHAR	隠遁者
$LINE_HERMIT_1_INTRO_150_TEXT	ないしょ。
$LINE_HERMIT_1_INTRO_160_CHAR	隠遁者
$LINE_HERMIT_1_INTRO_160_TEXT	もし、それを教えたら、お前がそれを独り占めするつもりなんだろう！
$LINE_HERMIT_1_INTRO_170_CHAR	隠遁者
$LINE_HERMIT_1_INTRO_170_TEXT	ライ麦のパンと麺と合わせたらどんなにウマいかなんて、教えてやらないからな。
$LINE_HERMIT_1_INTRO_180_CHAR	隠遁者
$LINE_HERMIT_1_INTRO_180_TEXT	ご飯とプルーン・シチューと合わせても、ウマいぞ。
$LINE_HERMIT_1_INTRO_190_CHAR	隠遁者
$LINE_HERMIT_1_INTRO_190_TEXT	ないしょだからな。
$SCENE_HERMIT_2_INTRO_TITLE	あり得ない取引！
$LINE_HERMIT_2_INTRO_00_CHAR	$MCG
$LINE_HERMIT_2_INTRO_00_TEXT	ちょっと待って。以前、お会いしたことありますよね？
$LINE_HERMIT_2_INTRO_10_CHAR	隠遁者
$LINE_HERMIT_2_INTRO_10_TEXT	*ああ、もちろん。ラクソスで。覚えてるか？お前の友達の$HEAが、わしを送り込んだんだ。
$LINE_HERMIT_2_INTRO_20_CHAR	$MCG
$LINE_HERMIT_2_INTRO_20_TEXT	兄弟とか、います？
$LINE_HERMIT_2_INTRO_30_CHAR	隠遁者
$LINE_HERMIT_2_INTRO_30_TEXT	ああ、いるよ！そいつの棲家は、ラクソスの東南にあるんだ。4人兄弟だよ。
$LINE_HERMIT_2_INTRO_40_CHAR	$MCG
$LINE_HERMIT_2_INTRO_40_TEXT	まさか四つ子？同じ服着てるの？
$LINE_HERMIT_2_INTRO_50_CHAR	隠遁者
$LINE_HERMIT_2_INTRO_50_TEXT	もちろん！作り話とでも？
$LINE_HERMIT_2_INTRO_60_CHAR	隠遁者
$LINE_HERMIT_2_INTRO_60_TEXT	唯一の生きがいが、お前をつけまわして装備の強化をダシにウマくてたまらん魔法のドクロをゲットすることである、そんな気が狂った男とでも？
$LINE_HERMIT_2_INTRO_70_CHAR	$MCG
$LINE_HERMIT_2_INTRO_70_TEXT	そうね・・・それは狂ってるよね。
$LINE_HERMIT_2_INTRO_80_CHAR	隠遁者
$LINE_HERMIT_2_INTRO_80_TEXT	で、魔法のドクロ持ってる？
$LINE_HERMIT_2_INTRO_90_CHAR	$MCG
$LINE_HERMIT_2_INTRO_90_TEXT	・・・。
$SCENE_HERMIT_3_INTRO_TITLE	レッツゴー！
$LINE_HERMIT_3_INTRO_00_CHAR	隠遁者
$LINE_HERMIT_3_INTRO_00_TEXT	やあ、旅人よ！
$LINE_HERMIT_3_INTRO_10_CHAR	$MCG
$LINE_HERMIT_3_INTRO_10_TEXT	またあなた？
$LINE_HERMIT_3_INTRO_20_CHAR	隠遁者
$LINE_HERMIT_3_INTRO_20_TEXT	以前お会いしたでしょうか、マダム？
$LINE_HERMIT_3_INTRO_30_CHAR	$MCG
$LINE_HERMIT_3_INTRO_30_TEXT	もう、よくわからないよ・・・。
$LINE_HERMIT_3_INTRO_40_CHAR	$MCG
$LINE_HERMIT_3_INTRO_40_TEXT	何となく魔法のドクロを集めてるんじゃないかなって。
$LINE_HERMIT_3_INTRO_50_CHAR	隠遁者
$LINE_HERMIT_3_INTRO_50_TEXT	今、魔法のドクロって言ったのか？
$LINE_HERMIT_3_INTRO_60_CHAR	隠遁者
$LINE_HERMIT_3_INTRO_60_TEXT	ああ、お前の言うとおりだよ。子どものために集めてるんだ。
$LINE_HERMIT_3_INTRO_70_CHAR	隠遁者
$LINE_HERMIT_3_INTRO_70_TEXT	わしは、神秘的なドクロを集めているんだ！
$LINE_HERMIT_3_INTRO_80_CHAR	隠遁者
$LINE_HERMIT_3_INTRO_80_TEXT	そのドクロは、石か銅か黒曜石でできている。レブナントが、そういうドクロを持ち歩いてたりする。
$LINE_HERMIT_3_INTRO_90_CHAR	隠遁者
$LINE_HERMIT_3_INTRO_90_TEXT	わしの兄弟みたいな、ゲホゲホッ、馬鹿な奴らは、ゲホゲホッ、それを魔法のドクロと勘違いしている。
$LINE_HERMIT_3_INTRO_100_CHAR	隠遁者
$LINE_HERMIT_3_INTRO_100_TEXT	でも、それとは完全に別物なんだ。本当だ！
$LINE_HERMIT_3_INTRO_110_CHAR	隠遁者
$LINE_HERMIT_3_INTRO_110_TEXT	味が、全然違うんだ。
$SCENE_HERMIT_4_INTRO_TITLE	最高の取引
$LINE_HERMIT_4_INTRO_00_CHAR	隠遁者
$LINE_HERMIT_4_INTRO_00_TEXT	おい、そこの、未だかつて見たことないヤツ！
$LINE_HERMIT_4_INTRO_10_CHAR	$MCG
$LINE_HERMIT_4_INTRO_10_TEXT	うわっ。うわっとしか言いようがないよ。わざわざここまで来たの？
$LINE_HERMIT_4_INTRO_20_CHAR	隠遁者
$LINE_HERMIT_4_INTRO_20_TEXT	いや、あれは、わしの兄たちだよ。あいつらは、いたずらが大好きなんだ。
$LINE_HERMIT_4_INTRO_30_CHAR	隠遁者
$LINE_HERMIT_4_INTRO_30_TEXT	もちろん、わしは、そんなことをしようなんて夢にも思わんがね。
$LINE_HERMIT_4_INTRO_40_CHAR	隠遁者
$LINE_HERMIT_4_INTRO_40_TEXT	お客様を混乱させるだなんて、馬鹿のやることだよ。
$LINE_HERMIT_4_INTRO_50_CHAR	$MCG
$LINE_HERMIT_4_INTRO_50_TEXT	・・・そうね。
$LINE_HERMIT_4_INTRO_60_CHAR	$MCG
$LINE_HERMIT_4_INTRO_60_TEXT	で、あなたも魔力があって神秘的でオカルトなドクロを集めてるの？
$LINE_HERMIT_4_INTRO_70_CHAR	隠遁者
$LINE_HERMIT_4_INTRO_70_TEXT	その通り！持っているか？
$LINE_HERMIT_4_INTRO_80_CHAR	$MCG
$LINE_HERMIT_4_INTRO_80_TEXT	確かめてみるよ。私を混乱させないでくれて、ありがとう。
$LINE_HERMIT_4_INTRO_90_CHAR	隠遁者
$LINE_HERMIT_4_INTRO_90_TEXT	*君のような古き友にそんな仕打ちしないよ、$MCG。
$LINE_HERMIT_4_INTRO_100_CHAR	$MCG
$LINE_HERMIT_4_INTRO_100_TEXT	・・・。
$LINE_HERMIT_4_INTRO_110_CHAR	隠遁者
$LINE_HERMIT_4_INTRO_110_TEXT	いや、わしの兄の古き友だけど！兄がよく君の話をしてたよ！
$LINE_HERMIT_4_INTRO_120_CHAR	隠遁者
$LINE_HERMIT_4_INTRO_120_TEXT	そうでなければ、君の名前を知っているわけがないだろう？
$LINE_HERMIT_4_INTRO_130_CHAR	隠遁者
$LINE_HERMIT_4_INTRO_130_TEXT	毎晩君のテントに忍び込んで、こっそり日記を盗み読むなんて、まさかそんな。それで必死こいて次の隠居に回りこむなんて、するはずないよね。
$LINE_HERMIT_4_INTRO_140_CHAR	隠遁者
$LINE_HERMIT_4_INTRO_140_TEXT	ところで、ミドルネームの「ヨーキー」って、変だね？<N>そんな名前をつけた両親を、恨んでいない？
$LINE_HERMIT_4_INTRO_150_CHAR	$MCG
$LINE_HERMIT_4_INTRO_150_TEXT	・・・。
$LINE_HERMIT_4_INTRO_160_CHAR	隠遁者
$LINE_HERMIT_4_INTRO_160_TEXT	オッケー、アップグレードしようぜ！