flag	content	comment
$TITLE_START_DEMO	Lancer la DÉMO
$TITLE_FULL_GAME	JEU COMPLET
$TITLE_START_GAME	Lancer le JEU
$TITLE_START	Commencer
$TITLE_QUIT	Quitter
$TITLE_EULA_1	En jouant à ce jeu, vous acceptez notre
$TITLE_EULA_2	Contrat de Licence Utilisateur Final
$TITLE_PLEASE_WAIT	<RE>$MISC_PLEASE_WAIT	COMMENT: this is a redirect, the text for $MISC_PLEASE_WAIT will be duplicated here. The <RE> invocation at the beginning of the string signals a redirect, and will not show up in the final text
$TITLE_BONUS_GOODIES	Bonus
$TITLE_BONUS_GOODIES_2	Secrets ?
$TITLE_CONNECTING_KONG	Connexion à KONG...
$TITLE_UNLOAD_MOD	Décharger le Mod
$TITLE_RELOAD_MOD	Recharger le Mod
$DEMO_OVER_PLEASE_WAIT	<RE>$MISC_PLEASE_WAIT
$DEMO_OVER_DONT_FORGET	N'oubliez pas votre fichier de sauvegarde !
$DEMO_OVER_EXPORT_HOW	Exportez vos fichiers de sauvegarde grâce à ce bouton.
$DEMO_OVER_USE_IT	Servez-vous-en pour continuer depuis là où vous vous êtes arrêté.
$DEMO_OVER_PLAY	Continuer à jouer !
$DEMO_OVER_THANKS	Merci d'avoir joué !
$DEMO_OVER_ENORMOUS	Cliquez sur l'ÉNORME bouton pour poursuivre votre quête !
$DEMO_OVER_ENORMOUS_2	Cliquez sur un ÉNORME bouton pour poursuivre votre quête !
$DEMO_OVER_FULL_GAME	Obtenir le JEU COMPLET !
$DEMO_OVER_FULL_GAME_SHORT	JEU<N>COMPLET !	COMMENT: <N> means a line break. <N> works too, but not <N> or <n>
$DEMO_OVER_ACTS	Actes<N>III & IV
$ERROR_TITLE	Une erreur est survenue !
$ERROR_NUMBER	Erreur
$ERROR_CONTEXT	contexte
$ERROR_MESSAGE	message
$ERROR_STACK	trace de la pile
$PARTY_FROM_BATTLE	De la bataille
$PARTY_GO_TO_MAP	Vers la carte
$PARTY_RETURN_TOWN	Retourner en ville
$PARTY_CANT_WEAPON	Ne peut<N>utiliser<N>d'ARME
$PARTY_CANT_ARMOR	Ne peut<N>utiliser<N>d'ARMURE
$PARTY_RESET_POINTS	Réinit. pts
$PARTY_X_PTS	<X> pts
$PARTY_REDESIGN	Relooker
$PARTY_CONFIRM_CHANGES	Confirmer les modifications
$PARTY_FAILED	Niveau échoué !
$PARTY_FAILED_DESC	<MCG> a été tuée.	COMMENT: <MCG> is a variable. In this exact string, the game expects this exact variable, and will replace <MCG> with Azra's name. Any other variable is ignored and will appear as-is.
$PARTY_NO_NEW_ACHIEVE	Pas de nouveau succès.
$PARTY_WELL_DONE	BIEN JOUÉ !
$PARTY_ACHIEVE_SINGULAR	succès
$PARTY_ACHIEVE_PLURAL	succès
$PARTY_1_NEW_ACHIEVE	1 nouveau succès !
$PARTY_X_NEW_ACHIEVE	<NUM> nouveaux succès !
$PARTY_PERFECT_WORD	Parfait
$PARTY_PASSED_WORD	Réussi
$PARTY_FAIL_PENALTY	Pénalité d'échec
$PARTY_TOTAL	Total
$PARTY_PERFECT	PARFAIT !
$PARTY_PERFECT+	PARFAIT !+
$PARTY_PERFECT++	PARFAIT !++
$PARTY_PERFECT_DESC	<MCG> s'en est sortie indemne !
$PARTY_PERFECT++_DESC	<MCG> et <ALLY><N>sont indemnes !	COMMENT: The game will put Zelemir, Tletl-Meztli, or any other alternate mcguffin's name where <ALLY> appears.
$PARTY_PERFECT+_DESC	<MCG> est indemne ! <N><ALLY> a été blessé !
$PARTY_PERFECT_ALLY_DEAD_DESC	<MCG> est indemne, mais <ALLY> a péri...
$PARTY_PASSED	Niveau réussi !
$PARTY_PASSED+	Niveau réussi !+
$PARTY_PASSED++	Niveau réussi !++
$PARTY_PASSED_DESC	<MCG> a survécu à la bataille,<N>mais elle a été blessée.
$PARTY_PASSED_ALLY_DEAD_DESC	<ALLY> a été tué,<N>mais <MCG> a survécu.
$PARTY_PASSED+_DESC	<MCG> a été blessée !<N><ALLY> a survécu !
$PARTY_PASSED++_DESC	<MCG> a été blessée !<N><ALLY> s'en est sorti indemne !
$PARTY_DEFEATED_WAVE_X	A vaincu la vague <X>
$PARTY_REACHED_WAVE_X	A atteint la vague <X>
$PARTY_NO_POINTS	Aucun point de compétence à réaffecter !
$PARTY_NO_AFFORD	Vous ne pouvez pas vous payer ceci !<N>Coût : <COST><N>Camelote : <SCRAP>
$PARTY_RE_ASSIGN	Réaffecter tous les points de <NAME> ?<N>Coût : <COST><N>Camelote : <SCRAP>
$PARTY_CHANGE_NAME	Renommer
$PARTY_CONFIRM_POINTS_1_1	Affecter définitivement 1 point de compétence à 1 personnage ?	COMMENT: There are 4 variants here to handle the various pluralizations
$PARTY_CONFIRM_POINTS_1_X	Affecter définitivement 1 point de compétence à <CHARS> personnages ?
$PARTY_CONFIRM_POINTS_X_1	Affecter définitivement <POINTS> points de compétence à 1 personnage ?
$PARTY_CONFIRM_POINTS_X_X	Affecter définitivement <POINTS> points de compétence à <CHARS> personnages ?
$PARTY_POINT	point
$PARTY_POINTS	points
$PARTY_CHARACTER	personnage
$PARTY_CHARACTERS	personnages
$PARTY_CONFIRM_POINTS_TITLE	Confirmer les points
$PARTY_RENAME	Renommer
$PARTY_REDESIGN	Relooker
$UI_EQUIP_NAME	Nom
$UI_EQUIP_STAT	Stats
$UI_EQUIP_OWNER	Équipé par
$UI_EQUIP_SHOW_EQUIPPED	Montrer équipé
$UI_EQUIP_CLASS_CANT_W	Cette classe ne peut pas équiper d'arme !
$UI_EQUIP_CLASS_CANT_A	Cette classe ne peut pas équiper d'armure !
$UI_EQUIP_ALL_W_SWORD	Toutes les épées ont été équipées !
$UI_EQUIP_ALL_W_BOW	Tous les arcs ont été équipés !
$UI_EQUIP_ALL_W_STAFF	Tous les bâtons ont été équipés !
$UI_EQUIP_ALL_A_LIGHT	Toutes les armures légères ont été équipées !
$UI_EQUIP_ALL_A_HEAVY	Toutes les armures lourdes ont été équipées !
$UI_EQUIP_NO_W_SWORD	Vous ne possédez aucune épée !
$UI_EQUIP_NO_W_BOW	Vous ne possédez aucun arc !
$UI_EQUIP_NO_W_STAFF	Vous ne possédez aucun bâton !
$UI_EQUIP_NO_A_LIGHT	Vous ne possédez aucune armure légère !
$UI_EQUIP_NO_A_HEAVY	Vous ne possédez aucune armure lourde !
$UI_ACCEPT_NUMS	font:18,off_y:1,off_x:-3	COMMENT: Font size and x/y offsets for options menu button labels
$UI_BACK_NUMS	font:18,off_y:1,off_x:-3
$UI_AUDIO_NUMS	font:18,off_y:1,off_x:-2
$UI_VIDEO_NUMS	font:18,off_y:1,off_x:-2
$UI_MISC_NUMS	font:18,off_y:1,off_x:-2
$UI_ACCESS_NUMS	font:18,off_y:1,off_x:-2,show_boxes:1,absence_off_x:0,speed_off_x:0	COMMENT: hide/show accessibility box graphic, offset for 'absence' text, offset for 'speed' text
$UI_ACHIEVEMENTS_NUMS	font:18,off_y:0,pop_up_off_y:0
$UI_RESTART_NUMS	font:18,off_y:1,off_x:-2
$UI_QUIT_NUMS	font:18,off_y:1,off_x:-2
$UI_CONTROLS_NUMS	font:18,off_y:1,off_x:-2
$UI_OPTIONS_NUMS	font:18,off_y:1,off_x:-2
$UI_CONTROLS_TITLE	Commandes
$UI_VIDEO_TITLE	Vidéo
$UI_AUDIO_TITLE	Audio
$UI_ACCESS_TITLE	Accessibilité
$UI_MISC_TITLE	Divers
$UI_OPTIONS_TITLE	Options
$UI_OPTIONS_MENU	Menu options
$UI_OPTIONS_SPEED	Vitesse du jeu
$UI_ACHIEVEMENTS_TITLE	Succès
$UI_AWARDS_TITLE	Prix
$UI_ACHIEVEMENTS_BUTTON_NUMBERS	font : 18,offy:-2
$UI_SFX	Bruitages :
$UI_MUSIC	Musique :
$UI_ACCESS_REWARDS	RÉCOMPENSES
$UI_ACCESS_PENALTIES	PÉNALITÉS
$UI_ACCESS_DEFAULT	*Configuration par défaut
$UI_ACCESS_FAIL	ÉCHEC
$UI_ACCESS_ABSENCE	ABSENCE
$UI_ACCESS_FLASHING	Effets de flash
$UI_ACCESS_SPEED	Vitesse du jeu
$UI_BONUS_BONUS_LEVELS	Niveaux bonus
$UI_BONUS_STARS_LINE	<STAR_NUM> Étoiles <STAR_COLOR>
$UI_BONUS_GOLD_STARS_LINE	<STAR_NUM> Étoiles d'Or
$UI_BONUS_BLUE_STARS_LINE	<STAR_NUM> Étoiles Bleues
$UI_BONUS_NUMS	select_font:14,locked_font:11
$UI_MOVIE_SELECT_A_MOVIE	Sélectionnez un film
$UI_MOVIE_SCENE	scène
$UI_MOVIE_END	fin
$UI_MOVIE_QUEST	quête
$UI_TIPS_TITLE	Trucs & Astuces
$TIP_NUMS	font:13
$UI_UPDATER_CANCEL	<RE>$MISC_CANCEL
$UI_UPDATER_SECURED_WITH	Ce mécanisme de mise à jour est sécurisé via HTTPS,<N>ainsi que par une vérification d'empreinte de clé publique.
$UI_UPDATER_ASK_DOWNLOAD	Télécharger la mise à jour ?
$UI_UPDATER_SERVER_TIMEOUT	Délai d'attente du serveur dépassé !
$UI_UPDATER_NO_INFO	Infos de mise à jour introuvables sur le serveur.
$UI_UPDATER_NO_BIG_DEAL	Ce n'est pas grave, vous pourrez quand même jouer, mais le serveur de mise à jour n'est pas accessible pour l'instant.
$UI_UPDATER_DEB	Paquet DEB
$UI_UPDATER_RPM	Paquet RPM
$UI_UPDATER_TARGZ	Archive TAR.GZ
$UI_UPDATER_CHECKING	Vérification des mises à jour...
$UI_UPDATER_UPDATE_EXISTS	Mise à jour disponible !
$UI_UPDATER_CURRENT_VERSION	Version actuelle :<T>
$UI_UPDATER_NEWEST_VERSION	Version plus récente :<T>
$UI_UPDATER_NO_UPDATES	Aucune mise à jour n'est disponible
$UI_UPDATER_PLEASE_WAIT	<RE>$MISC_PLEASE_WAIT
$UI_UPDATER_TRYING_30	Tentatives pendant 30 secondes
$UI_UPDATER_CONNECT_AGAIN	Reconnexion
$UI_UPDATER_ERROR!	ERREUR !
$UI_UPDATER_DETAILS	Détails :
$UI_UPDATER_NO_VERIFY	Impossible de vérifier le fichier de mise à jour.
$UI_UPDATER_NO_DOWNLOAD	Impossible de télécharger le fichier de mise à jour.
$UI_UPDATER_CHECKSUM_MISMATCH	Le somme de contrôle du fichier ne correspond pas à la valeur attendue.<N><N>Les causes possibles pourraient être un téléchargement incomplet (probable), un problème de sécurité (peu probable) ou le rayonnement cosmique (allez savoir !).<N><N>D'une manière ou d'une autre, la mise à jour a échoué.
$UI_UPDATER_GIVE_UP	Abandonner
$UI_UPDATER_TRY_AGAIN	Réessayer
$UI_UPDATER_CONNECTING	Connexion au serveur...
$UI_UPDATER_DOWNLOADING_FILE	Téléchargement du fichier de mise à jour...
$UI_UPDATER_DOWNLOADING_SIG	Téléchargement de la signature de la mise à jour...
$UI_UPDATER_CHECKSUM	Calcul de la somme de contrôle...
$UI_UPDATER_NAVIGATING	Navigation vers le fichier...
$UI_UPDATER_CLOSE_WINDOW	Vous devez fermer cette fenêtre avant d'installer la mise à jour.
$UI_UPDATER_FILE_IS_AT	Votre fichier de mise à jour se trouve ici :
$UI_UPDATER_IF_NO_WINDOW	Si une fenêtre de navigation ne s'ouvre pas, essayez de vous rendre à cet emplacement manuellement.
$UI_UPDATER_DOWNLOADED	Mise à jour téléchargée !
$UI_UPDATER_NAVIGATE_NOW	Naviguer vers le fichier maintenant ?
$UI_UPDATER_NOTE	Note :
$UI_UPDATER_SECURITY	Pour des raisons de sécurité, vous devez lancer l'installateur téléchargé manuellement.<N><N>Ce programme va naviguer jusqu'à l'emplacement du téléchargement de votre fichier.
$UI_UPDATER_INSTALLING	Installation de la mise à jour...
$UI_UPDATER_EXITING	Sortie de l'application...
$UI_DEFENDER_RECALL_LINE	RAPPEL :<N>+<PSI> Psi
$UI_DEFENDER_BOOST	BOOSTER : <PSI> Psi
$UI_DEFENDER_BOOST_NEED	<PSI> Psi requis
$UI_DEFENDER_BOOST_MAX	BOOST MAXIMUM
$UI_DEFENDER_BOOST_UNLOCK	Activé au NIV <LVL> DE BOOST
$UI_DEFENDER_CLICK_TO	(Cliquer pour activer/désactiver)
$UI_DEFENDER_CLICK_TO_CONSOLE	(Sélectionner pour activer/désactiver)
$UI_DEFENDER_TECHNIQUES	TECHNIQUES
$UI_DEFENDER_TECHNIQUE	Technique
$UI_DEFENDER_TRAITS	TRAITS
$UI_DEFENDER_TRAIT	Trait
$UI_DEFENDER_RECALL	Rappel
$UI_SKILLS_CLICK_TO_UPGRADE	Cliquez pour améliorer
$UI_SKILLS_MAX	MAXIMUM
$MISC_MAX	MAX
$UI_SKILLS_NO_POINTS	Aucun point disponible
$UI_SKILLS_REQ_1PT	REQUIS : Perso NIV <LVL>,<N><PT> point dans <SKILL>
$UI_SKILLS_REQ_XPT	REQUIS : Perso NIV <LVL>,<N><PT> points dans <SKILL>
$UI_SKILLS_NO_LEARN_SPELL	Vous n'avez pas encore appris ce sort.
$UI_SKILLS_MOUSE_OVER	Passez la souris pour plus d'infos.
$UI_EQUIP_OWNED	possédé
$UI_EQUIP_COMPARE	comparer
$UI_EQUIP_PRICE	prix
$UI_EQUIP_SHOW_EQUIPPED	Montrer équipé
$UI_EQUIP_EQUIP_AFTER	Équiper après l'achat
$UI_EQUIP_EQUIP_WHO	Qui va équiper ceci ?
$UI_EQUIP_EQUIPPED	Équipé
$UI_EQUIP_MAX_OWNED	MAXIMUM EN VOTRE POSSESSION
$UI_EQUIP_ALL_W_SWORD_EQUIPPED	Toutes les épées ont été équipées !
$UI_EQUIP_ALL_W_STAFF_EQUIPPED	Tous les bâtons ont été équipés !
$UI_EQUIP_ALL_W_BOW_EQUIPPED	Tous les arcs ont été équipés !
$UI_EQUIP_ALL_A_LIGHT_EQUIPPED	Toutes les armures légères ont été équipées !
$UI_EQUIP_ALL_A_HEAVY_EQUIPPED	Toutes les armures lourdes ont été équipées !
$UI_EQUIP_CANT_UPGRADE_W_SWORD	Vous ne pouvez améliorer aucune épée !
$UI_EQUIP_CANT_UPGRADE_W_BOW	Vous ne pouvez améliorer aucun arc !
$UI_EQUIP_CANT_UPGRADE_W_STAFF	Vous ne pouvez améliorer aucun bâton !
$UI_EQUIP_CANT_UPGRADE_A_LIGHT	Vous ne pouvez améliorer aucune armure légère !
$UI_EQUIP_CANT_UPGRADE_A_HEAVY	Vous ne pouvez améliorer aucune armure lourde !
$UI_EQUIP_NO_W_SWORD	Vous ne possédez aucune épée !
$UI_EQUIP_NO_W_STAFF	Vous ne possédez aucun bâton !
$UI_EQUIP_NO_W_BOW	Vous ne possédez aucun arc !
$UI_EQUIP_NO_A_LIGHT	Vous ne possédez aucune armure légère !
$UI_EQUIP_NO_A_HEAVY	Vous ne possédez aucune armure lourde !
$UI_EULA_TITLE	CONTRAT DE LICENCE UTILISATEUR FINAL
$UI_ACHIEVE_COMPLETION	Progression
$UI_ACHIEVE_CATEGORIES	Catégories
$UI_ACHIEVE_POP_UP	Notification
$UI_ACHIEVE_TRAINER	Entraînement
$UI_ACHIEVE_EASY	Facile
$UI_ACHIEVE_MEDIUM	Moyen
$UI_ACHIEVE_HARD	Difficile
$UI_ACHIEVE_IMPOSSIBLE	Impossible
$UI_CONTROLS_SPELL	Sort
$UI_CONTROLS_CLASS	Classe
$UI_CONTROLS_CHARACTER	Personnage
$UI_CONTROLS_TARGET	Cible
$UI_CONTROLS_PAUSE	Pause
$UI_CONTROLS_MINUS_SPEED	Vitesse -
$UI_CONTROLS_PLUS_SPEED	Vitesse +
$UI_CONTROLS_BOOST	Boost
$UI_CONTROLS_RECALL	Rappel
$UI_CONTROLS_BACK	Retour
$UI_CONTROLS_PRESETS	Configs
$UI_CONTROLS_TAB_NAV	Navigation<N>par onglets
$UI_CONTROLS_CYCLE	Défilement<N>défenseurs
$UI_CONTROLS_CYCLE_NUMS	off_x:-5,off_y : 0	COMMENT: moves the 'cycle defenders' text and associated buttons
$UI_CONTROLS_SCROLL	Défilement carte,<N>Placement défenseur
$UI_CONTROLS_MOVE_CURSOR	Déplacement pointeur
$UI_CONTROLS_VIRTUAL_MOUSE	Souris virtuelle
$UI_CONTROLS_CLICK	Clic
$UI_CONTROLS_SPEED	Vitesse
$UI_CONTROLS_ACCEL	Accélération
$UI_CONTROLS_SLOWEST	Plus lent
$UI_CONTROLS_SLOW	Lent
$UI_CONTROLS_NORMAL	Normal
$UI_CONTROLS_FAST	Rapide
$UI_CONTROLS_NONE	Aucune
$UI_CONTROLS_PRESET_QWERTY	Qwerty
$UI_CONTROLS_PRESET_LEFTY	Gaucher
$UI_CONTROLS_PRESET_AZERTY	Azerty
$UI_CONTROLS_PRESET_QWERTZ	Qwertz
$UI_CONTROLS_PRESET_DVORAK	Dvorak
$UI_CONTROLS_PRESET_CUSTOM	Personnalisé
$UI_DOWNLOAD_WARNING	DÉSACTIVEZ VOTRE<N>BLOQUEUR DE POP-UP !
$UI_DOWNLOAD_BODY	Cliquez sur un bouton pour télécharger<N>la version bureau du jeu.<N><N>Elle sera téléchargée dans une nouvelle fenêtre/onglet.<N>Il est possible qu'il y ait un léger délai d'attente,<N>alors attendez une minute et évitez de cliquer à répétition sur les boutons.
$UI_DOWNLOAD_LINUX	Linux
$UI_DOWNLOAD_WINDOWS	Windows
$UI_DOWNLOAD_MACINTOSH	Macintosh
$UI_DOWNLOAD_SOUNDTRACK	Bande originale
$UI_CONFLICT_TITLE	Conflit avec le Cloud !
$UI_CONFLICT_MSG	Impossible de déterminer la version qui devrait être placée dans l'emplacement <SLOT>.<N>Veuillez choisir celle que vous désirez conserver.
$UI_CONFLICT_CLOUD	CLOUD
$UI_CONFLICT_LOCAL	ORDINATEUR
$UI_CONFLICT_LOCAL	CONSOLE
$UI_CONFLICT_BETTER	Celle-ci semble la meilleure
$UI_CONFLICT_BUTTON	Utiliser celle-ci
$UI_CONFLICT_NGP	Nouvelle partie+
$UI_CONFLICT_BACKUP	Faire un backup du fichier non sélectionné vers :<N><LOC>
$UI_GAMEPLAY_MISCELLANEOUS	Divers
$UI_GAMEPLAY_CLOUD_SAVE	Sauvegardes dans le Cloud
$UI_GAMEPLAY_OFF	Activé
$UI_GAMEPLAY_ON	Désactivé
$UI_GAMEPLAY_TUTORIALS	Didacticiels
$UI_GAMEPLAY_DIALOGUE	Dialogue
$UI_GAMEPLAY_NEVER	Jamais
$UI_GAMEPLAY_ALWAYS	Toujours
$UI_GAMEPLAY_DEFAULT	Nouvelles batailles uniquement
$UI_GAMEPLAY_BATTLE_NUMBERS	Stats des batailles
$UI_GAMEPLAY_HIDE	Cacher
$UI_GAMEPLAY_SHOW	Montrer
$UI_GAMEPLAY_TRACKING	Données de tracking
$UI_GAMEPLAY_TRACK_YES	Nous envoyer des statistiques anonymes de jeu
$UI_GAMEPLAY_TRACK_NO	Oh que non, on ne me tracke pas, moi !
$UI_GAMEPLAY_AUTO_UPDATE	Mise à jour auto
$UI_GAMEPLAY_ENABLE_UPDATER	Vérifier les mises à jour au lancement du jeu
$UI_GAMEPLAY_DISABLE_UPDATER	Désactiver les mises à jour auto
$UI_GAMEPLAY_SLOW_FOOTNOTE	Ceci risque de ralentir le jeu
$UI_SAVE_PATH	Chemin des sauvegardes...
$UI_MOD_PATH	Chemin des Mods...
$TOOLTIP_CHANGE_PATH_1	NOTE :
$TOOLTIP_CHANGE_PATH_2	Vos anciens fichiers ne seront pas transférés automatiquement vers le nouvel emplacement.<N><N>Ils resteront dans le répertoire d'origine.
$UI_VIDEO_IF_DOESNT_WORK	Si la nouvelle résolution ne fonctionne pas,<N>l'affichage reviendra à l'ancienne au bout de quelques secondes.
$UI_VIDEO_RES_CHANGED	Résolution modifiée.<N>Ça vous plaît ?<N><N>Retour à la précédente dans <TIME> secondes.
$UI_VIDEO_SETTINGS	Configuration vidéo
$UI_VIDEO_WARNING	Les options vidéo sont désactivées en mode navigateur.
$UI_VIDEO_WARNING2	Votre configuration système ne supporte hélas pas la modification de résolution à la volée :(
$UI_VIDEO_WARNING3	En MODE COMPATIBILITÉ, le changement de résolution est désactivé.<N><N>Désolé !
$UI_VIDEO_MOUSE	Pointeur
$UI_VIDEO_MOUSE_DEFAULT	Par défaut
$UI_VIDEO_MOUSE_FANCY	Fantaisie
$UI_VIDEO_PARTICLES	Particules
$UI_VIDEO_SWIRL	Animation pré-combat
$UI_VIDEO_AOE	Surligner les<N>attaques de zone
$UI_VIDEO_CHANGE_RES	Changer de résolution
$UI_VIDEO_SCREEN_POS	Position de l'écran
$UI_VIDEO_CHANGE_RES_BUTTON	La modifier !
$UI_VIDEO_SHOW_ALL_RES	Montre toutes les résolutions
$UI_VIDEO_RECOMMENDED	Recommandé :
$UI_VIDEO_STANDARD_RATIO	(Ratio standard)
$UI_VIDEO_WIDESCREEN	(16:9)
$UI_VIDEO_PIXELS	Pixels
$UI_VIDEO_BIT_DEPTH	Profondeur
$UI_VIDEO_REFRESH	Rafraîchissement
$UI_VIDEO_SCALE	Échelle
$UI_VIDEO_CAN_SLOW_GAME	(Risque de ralentir le jeu)
$UI_VIDEO_WINDOWED	Fenêtré
$UI_VIDEO_FULLSCREEN	Plein écran
$UI_SAVE_ERROR_INCOMPAT	Incompatible !
$UI_SAVE_ERROR_INCOMPAT_TEXT	Erreur ! Vous jouez à la DÉMO<N>et ce fichier provient de la version COMPLÈTE.
$UI_SAVE_DEMO_IMPORT	Import depuis la démo
$UI_SAVE_DEMO_IMPORT_TEXT	Ce fichier provient de la DÉMO. Quelques ajustements vont devoir être effectués.<N>Cela ne vous dérange pas ?
$UI_SAVE_DEMO_NEWER	Ce fichier provient d'une version PLUS RÉCENTE du jeu,<N>il risque d'être incompatible.<N>Tenter tout de même l'importation ?
$UI_SAVE_DEMO_OLDER	Ce fichier provient d'une version PLUS ANCIENNE du jeu.<N>Quelques ajustements vont devoir être effectués.<N>Cela ne vous dérange pas ?
$UI_NORM_MOD_INCOMPAT_TEXT	<N>Ce fichier provient d'un Mod,<N>il risque d'être incompatible.<N><N>Tenter tout de même l'importation ?
$UI_MOD_NORM_INCOMPAT_TEXT	<N>Un Mod est actif, mais ce fichier<N>provient d'une partie normale<N>il risque d'être incompatible.<N>Tenter tout de même l'importation ?
$UI_MOD_MOD_INCOMPAT_TEXT	<N>Ce fichier provient d'un Mod différent,<N>il risque d'être incompatible.<N><N>Tenter tout de même l'importation ?
$UI_SAVE_DEMO_ATTENTION	Attention !
$UI_SAVE_MENU_LOADED	Chargement terminé !
$UI_SAVE_MENU_CHECK_GOG	Passez sur GOG pour recevoir des mises à jour gratuites !
$UI_SAVE_MENU_DOWNLOAD	Obtenir la version téléchargeable
$UI_SAVE_MENU_FULL_VERSION	Version complète
$UI_SAVE_MENU_KONG_XDEMO_LOGIN	Démo étendue - Connectez-vous sur Kongregate pour accéder au jeu complet !
$UI_SAVE_MENU_KONG_XDEMO	Version Démo Étendue
$UI_SAVE_MENU_KONG_DEMO_LOGIN_FULL	Démo - Connectez-vous sur Kongregate pour accéder au jeu complet !
$UI_SAVE_MENU_KONG_DEMO_LOGIN_XDEMO	Démo - Connectez-vous sur Kongregate pour accéder au contenu étendu !
$UI_SAVE_MENU_KONG_DEMO	<RE>$MISC_DEMO_VERSION
$UI_SAVE_CONFIRM_DELETE	Confirmer la suppression ?
$UI_SAVE_CONFIRM_DELETE_TEXT	Effacer DÉFINITIVEMENT<N>cet emplacement de sauvegarde ?
$SAVE_SLOT_PLAY	Jouer
$SAVE_SLOT_PLAY_PLUS	Jeu+
$SAVE_SLOT_NEW_GAME	Nouvelle partie
$SAVE_SLOT_NEW_GAME_PLUS	Nouvelle partie+
$SAVE_SLOT_EXPORT	Exporter
$SAVE_SLOT_IMPORT	Importer
$SAVE_SLOT_DELETE	Supprimer
$UI_DEMO_SAVES_DETECTED	Sauvegardes de la Démo détectées !
$UI_DEMO_IMPORT_SAVES	Importer les sauvegardes de la Démo ?
$UI_CLOUD_UNKNOWN	Sauvegardes dans le Cloud
$UI_CLOUD_UNKNOWN_TEXT	Activer les sauvegardes dans le Steam Cloud ?
$UI_CLOUD_UNKNOWN_TEXT_2	Vous pouvez modifier ce paramètre à tout moment dans<N><N>Options / Divers
$UI_MOD_TITLE	Modifications
$UI_MOD_LOAD_EXISTING	Charger un Mod existant
$UI_MOD_CREATE_NEW	Créer un nouveau Mod
$UI_MOD_BROWSE_QUEUE	Mes Mods
$UI_MOD_BROWSE_WORKSHOP	Steam Workshop
$UI_MOD_WEB_BROWSER	Navigateur
$UI_MOD_INSTALL_STANDALONE	Installer depuis un ZIP
$UI_MOD_INSTALL_ERROR	Le nom du répertoire de ce Mod existe déjà.<N>Tenter de l'installer avec un suffixe ?
$UI_MOD_INSTALL_ERROR2	Désolé, l'installation du Mod a échoué.
$UI_DEFQ_MODS	Mod
$UI_MOD_TITLE	Modifications
$UI_MOD_DATA_ONLY	Données uniquement (1M)
$UI_MOD_SPRITES	<PLUS>4M de Sprites
$UI_MOD_MOVIES	<PLUS>13M de Scènes Intermédiaires
$UI_MOD_BKGS	<PLUS>42M de Décors
$UI_MOD_TEMPLATE_SETTINGS	Paramètres du modèle de Mod
$UI_MOD_SELECT_DIR	Sélection du répertoire du Mod
$UI_SAVE_SELECT_DIR	Sélection du répertoire de sauvegarde
$UI_MOD_LOAD_MOD	Charger le Mod
$UI_MOD_EXISTS	Ce Mod existe.<N>Le charger ?
$UI_MOD_MISSING	Impossible de trouver settings.xml<N>Soit il n'y a pas de Mod ici,<N>soit ce Mod a un problème.
$UI_MOD_NOT_DIR	Hein ?<N>Ce n'est même pas un répertoire !<N>Réessayez.
$UI_MOD_LOADING	Chargement du Mod...
$UI_MOD_PLEASE_WAIT	Veuillez patienter pendant<N>le chargement de votre Mod.
$UI_MOD_PROGRESS	Tâche <TASK><N>Fichier <FILE><N>
$UI_MOD_LOAD_FINISH	Chargement terminé
$UI_MOD_LOAD_FINISH_TEXT	Le chargement du Mod a réussi.<N>Le jeu va redémarrer.
$UI_MOD_LOAD_FAIL	Échec du chargement !
$UI_MOD_LOAD_FAIL_TEXT	Erreur lors du chargement du Mod :
$UI_MOD_NAME	Entrez un nom pour ce Mod
$UI_MOD_EXPORTING	Exportation des données
$UI_MOD_EXPORT_FINISH	Exportation terminée !
$UI_MOD_EXPORT_FINISH_TEXT	Votre Mod se trouve ici :
$UI_MOD_EXPORT_CANCEL	Exportation annulée !
$UI_MOD_EXPORT_CANCEL_TEXT	Les fichiers se trouvent ici :
$UI_MOD_EXPORT_FAIL	Échec de l'exportation !
$UI_MOD_EXPORT_FAIL_TEXT	Une erreur s'est produite !
$UI_MOD_EXPORT_CHURN	Tâche <TASK_PROGRESS><N><N><TASK><N><PROGRESS>
$UI_MOD_DEFQ_SAVE	Fichiers de sauvegarde de Défender's Quest (*.dfq)
$UI_MOD_ALL_FILES	Tous les fichiers (*.*)
$UI_MOD_AUTHOR	Auteur
$UI_MOD_PLAY	Jouer
$UI_MOD_SHARE	Partager
$UI_MOD_UPDATE	Mise à jour
$UI_MOD_EDIT	Édition
$UI_MOD_WORKSHOP	Workshop
$UI_MOD_SHARE_TITLE	Partager le Mod
$UI_MOD_SHARE_TEXT_LOCAL	Ceci assemblera votre Mod en un seul fichier afin de faciliter sa distribution.
$UI_MOD_SHARE_TEXT_STEAM	Ceci assemblera votre Mod, puis le transmettra au Steam Workshop.
$UI_MOD_UPDATE_TEXT_STEAM	Ceci mettra à jour votre Mod sur le Steam Workshop.
$UI_MOD_ZIP_PROGRESS	Tâche <TASK><N>Fichier <FILE><N>
$UI_MOD_ZIP_FINISH	Assemblage terminé
$UI_MOD_ZIP_FINISH_TEXT	La création du ZIP du Mod a réussi.
$UI_MOD_ZIP_FAIL	Échec de l'assemblage !
$UI_MOD_ZIP_FAIL_TEXT	Une erreur s'est produite au cours de la compression des fichiers.
$UI_MOD_STEAM_UPLOAD	Transfert sur Steam...
$UI_MOD_STEAM_WAIT	En attente de la réponse de Steam...<N>(un peu de patience peut être nécessaire)
$UI_MOD_STEAM_SEND	Envoi à Steam
$UI_MOD_SHARED	Partagé
$UI_MOD_SUBSCRIBED	Abonné
$UI_MOD_ZIP_STEAM_FAIL	Échec du transfert !
$UI_MOD_ZIP_STEAM_FAIL_TEXT	Impossible de transmettre le Mod<N>au Steam Workshop.
$UI_MOD_ZIP_STEAM_FINISH	Transfert terminé
$UI_MOD_ZIP_STEAM_FINISH_TEXT	Le Mod a bien été transmis<N>au Steam Workshop.
$UI_MOD_UPDATE_STEAM_FINISH	Mise à jour terminée
$UI_MOD_UPDATE_STEAM_FINISH_TEXT	Le Mod a bien été mis à jour<N>sur le Steam Workshop.
$UI_MOD_ZIPPING	Assemblage des fichiers du Mod
$UI_MOD_MISSING_SUBSCRIBE	Abonnements souscrits
$UI_MOD_MISSING_SUBSCRIBE_TEXT	Souhaitez-vous télécharger :<N><NUM> fichier(s) d'abonnement(s) du Worskhop ?
$UI_MOD_DOWNLOAD	Téléchargement du Mod
$UI_MOD_DOWNLOAD_TEXT",,<N>"$UI_MOD_LATER	Plus tard
$UI_EQUIP_WHO_WILL	Qui va équiper :
$UI_EQUIP_CANT_SELL_UNIQUE	Impossible de vendre les objets uniques !
$UI_EQUIP_SELL_OLD_WEAPON_FOR	Vendre cette vieille arme pour <SELL_PRICE> Camelote ?
$UI_EQUIP_SELL_OLD_ARMOR_FOR	Vendre cette vieille armure pour <SELL_PRICE> Camelote ?
$UI_RECRUIT_CLASS_FULL	CLASSE PLEINE
$UI_RECRUIT_BERSERKER_NUMS	font:14,x_off:0,y_off:0
$UI_RECRUIT_RANGER_NUMS	font:14,x_off:0,y_off:0
$UI_RECRUIT_KNIGHT_NUMS	font:14,x_off:0,y_off:0
$UI_RECRUIT_MAGE_NUMS	font:10,x_off:0,y_off:-10
$UI_RECRUIT_HEALER_NUMS	font:14,x_off:0,y_off:0
$UI_RECRUIT_DRAGON_NUMS	font:14,x_off:0,y_off:0
$UI_REWARD_BOX_ENEMY_LEVELS_NUMS	y_off:-5
$UI_REWARD_BOX_COMPLETE_NUMS	x_off:5
$UI_REWARD_BOX_PERFECT_NUMS	x_off:5
$UI_BATTLE_MORE	PLUS
$UI_BATTLE_SEND_NEXT	Suivant
$UI_BATTLE_NEXT	SUIVANT
$UI_BATTLE_WAVES	Vagues
$UI_BATTLE_WAVE	Vague
$UI_BATTLE_CASH_OUT	Encaisser
$UI_BATTLE_CASH_OUT?	Encaisser ?
$UI_BATTLE_CASH_OUT_TEXT	Terminer la bataille maintenant et obtenir les récompenses que vous avez gagnées ?
$FB_LIKE_US_TEXT	Aimez-nous sur Facebook et<N>recevez GRATUITEMENT ce cadeau !
$FB_LIKE_US_YES	OK !
$FB_LIKE_US_NO	Ha ha ha. Non.
$FB_THANKS_TEXT	Merci pour votre j'aime sur Facebook !<N>Vous avez déjà reçu votre cadeau !
$FB_THANKS_OK	OK
$FB_THANKS_SUCKS	Facebook, ça craint
$FB_REBEL_TEXT	Bien dit ! À mort le système !<N>Acceptez ce cadeau à la place.
$FB_SECOND_PITCH	Vous pourrez encore obtenir ceci<N>en nous aimant sur Facebook !
$FB_SECOND_PITCH_YES	OK !
$FB_SECOND_PITCH_NO	Jamais !
$FB_HARD_SELL_TEXT	En êtes-vous vraiment certain ?<N>Regardez ! Oooouh, ça brille !
$FB_HARD_SELL_YES	Bon... OK...
$FB_HARD_SELL_NO	J'ai dit JAMAIS !
$FB_PERSISTENT_TEXT	OK, vous avez gagné...<N>On vous l'offre quand même :)
$FB_PERSISTENT_OK	La victoire est à moi !
$FB_THIS_ITEM_WILL_NOW	Cet objet apparaîtra désormais systématiquement dans l'inventaire de votre personnage.
$BOOK_PSI_TAX	Taxe PSI :
$BOOK_COST_MULT	Coût du sort x
$BOOK_COOL_MULT	Temps de recharge du sort x
$STATUS_DESC_FB_HAPPY	Vitesse +<PERCENT>%.	COMMENT: Status descriptions have LOTS of variables. Ask Lars is you have any questions.
$STATUS_DESC_FB_SAD	Vitesse -<PERCENT>%.
$STATUS_DESC_FB_BORED	N'a pas envie de bouger.
$STATUS_DESC_FB_LOL	Vitesse +<PERCENT>%.
$STATUS_DESC_FB_OMG	Vitesse +<PERCENT>%, résistance DGT -<PERCENT>%.
$STATUS_DESC_TROLL	Esquive <PERCENT>% des attaques.
$STATUS_DESC_ANONYMOUS	<PLUS><PERCENT>% de chances d'esquiver.	
$STATUS_DESC_DARK	Esquive <PERCENT>% des attaques ciblées.
$STATUS_DESC_LIGHT	Supprime le voile de ténèbres.
$STATUS_DESC_FRENZY	Vitesse +<PERCENT>%
$STATUS_DESC_BLINDED	Rate <PERCENT>% de ses attaques
$STATUS_DESC_BLEED	Dégâts reçus +<PERCENT>%.
$STATUS_DESC_EVER_POISON	<INTI> DGT/sec.
$STATUS_DESC_DISEASE	Régénération -<PERCENT>%
$STATUS_DESC_POISON	<INTI> DGT/sec pendant <TIME> sec
$STATUS_DESC_SINGLE_STUN	Ne peut plus bouger. Ne peut être infligé qu'une seule fois.
$STATUS_DESC_STUN	Ne peut plus bouger.
$STATUS_DESC_BURN	<AMT_1DIG> DGT/sec<N>Annulé par la glace.
$STATUS_DESC_INSPIRED	Dégâts +<M_MULT_PERCENT>%.
$STATUS_DESC_FREEZE	Ne peut plus bouger.<N>Annulé par le feu.
$STATUS_DESC_CHILL	Vitesse -<PERCENT>%.<N>Annulé par le feu.
$STATUS_DESC_SLOW	Vitesse -<PERCENT>%.
$STATUS_TIME_LEFT	<TIME_LEFT>/<TIME> secondes restantes.
$STATUS_TIME_FOREVER	Perpétuel.
$FLAV_DESC_LIGHT	Les ennemis NOIRS subissent +<AMT_2DIG>x<EXTRA> DGT et sont plus faciles à toucher pendant <TIME><EXTRA_TIME> sec.
$FLAV_DESC_LIGHT_SHORT	Les ennemis NOIRS subissent plus de dégâts et sont plus faciles à toucher.
$FLAV_DESC_BLINDED	Les attaques ennemies ratent <PERCENT>% <EXTRA> du temps pendant <TIME><EXTRA_TIME> sec.
$FLAV_DESC_BLINDED_SHORT	La précision des attaques ennemies est réduite pendant quelques secondes.
$FLAV_DESC_CONFUSED	Les ennemis marchent à reculons pendant <TIME><EXTRA_TIME> sec.
$FLAV_DESC_CONFUSED_SHORT	Les ennemis marchent à reculons pendant quelques secondes.
$FLAV_DESC_BLEED	Les attaques infligent <PERCENT>%<EXTRA> de dégâts en plus aux ennemis pendant <TIME><EXTRA_TIME> sec.
$FLAV_DESC_BLEED_SHORT	Augmente temporairement les dégâts infligés aux ennemis.
$FLAV_DESC_KNOCK_BACK	L'ennemi est repoussé en arrière de <AMT_1DIG><EXTRA> cases.
$FLAV_DESC_KNOCK_BACK_SHORT	L'ennemi est repoussé en arrière de quelques cases.
$FLAV_DESC_DISEASE	Réduit de <PERCENT>%<EXTRA> la régénération des ennemis.
$FLAV_DESC_DISEASE_SHORT	Réduit la régénération des ennemis.
$FLAV_DESC_POISON	<PERCENT>%<EXTRA> des dégâts de l'attaque sont infligés à l'ennemi toutes les secondes pendant <TIME><EXTRA_TIME> sec.
$FLAV_DESC_POISON_DIRECT	<AMTDMG><EXTRA> dégâts infligés par seconde à l'ennemi pendant <TIME><EXTRA_TIME> sec.
$FLAV_DESC_POISON_SHORT	Des dégâts sont infligés régulièrement à l'ennemi pendant quelques secondes.
$FLAV_DESC_SINGLE_STUN	L'ennemi ne peut plus bouger pendant <TIME><EXTRA_TIME> sec. Ne peut être infligé qu'une seule fois.
$FLAV_DESC_SINGLE_STUN_SHORT	L'ennemi ne peut plus bouger pendant quelques secondes. Ne peut être infligé qu'une seule fois.
$FLAV_DESC_STUN	L'ennemi ne peut plus bouger pendant <TIME><EXTRA_TIME> sec.
$FLAV_DESC_STUN_SHORT	L'ennemi ne peut temporairement plus bouger.
$FLAV_DESC_AUTO_KILL	Les ennemis ayant moins de <PERCENT>%<EXTRA> de Santé meurent automatiquement.
$FLAV_DESC_AUTO_KILL_SHORT	Les ennemis suffisamment affaiblis meurent automatiquement.
$FLAV_DESC_BURN	<AMTDMG><EXTRA> dégâts infligés par seconde à l'ennemi pendant <TIME><EXTRA_TIME> sec. Annulé par la glace.
$FLAV_DESC_BURN_SHORT	Des dégâts sont infligés régulièrement à l'ennemi pendant quelques secondes. Annulé par la glace.
$FLAV_DESC_INSPIRE	Augmente de <M_MULT_PERCENT>%<EXTRA> les dégâts infligés par les alliés pendant <TIME><EXTRA_TIME> sec.
$FLAV_DESC_INSPIRE_SHORT	Les alliés infligent temporairement plus de dégâts.
$FLAV_DESC_FREEZE	L'ennemi ne peut plus bouger pendant <TIME><EXTRA_TIME> sec. Annulé par le feu.
$FLAV_DESC_FREEZE_SHORT	L'ennemi ne peut temporairement plus bouger. Annulé par le feu.
$FLAV_DESC_ARMOR_PIERCE_DIRECT	L'attaque ignore <AMTDMG><EXTRA> points d'armure.
$FLAV_DESC_ARMOR_PIERCE_AMT_LESS_1	Ignore 1 point d'armure tous les <INV_AMOUNT><EXTRA> points de DGT de l'attaque.
$FLAV_DESC_ARMOR_PIERCE_AMT_GRTR_1	Ignore <AMT_1DIG><EXTRA> points d'armure pour chaque point de DGT de l'attaque.
$FLAV_DESC_ARMOR_PIERCE_SHORT	L'attaque ignore un certain nombre de points d'armure.
$FLAV_DESC_ARMOR_BREAK_DIRECT	L'attaque détruit <AMTDMG><EXTRA> points d'armure.
$FLAV_DESC_ARMOR_BREAK_AMT_LESS_1	Détruit 1 point d'armure tous les <INV_AMOUNT><EXTRA> points de DGT de l'attaque.
$FLAV_DESC_ARMOR_BREAK_AMT_GRTR_1	Détruit <AMT_2DIG><EXTRA> points d'armure pour chaque point de DGT de l'attaque.
$FLAV_DESC_ARMOR_BREAK_SHORT	L'attaque détruit un certain nombre de points d'armure.
$FLAV_DESC_CHILL	Ralentit l'ennemi de <PERCENT>%<EXTRA> pendant <TIME><EXTRA_TIME> sec. Annulé par le feu.
$FLAV_DESC_CHILL_SHORT	L'ennemi est ralenti pendant quelques secondes. Annulé par le feu.
$FLAV_DESC_SLOW	Ralentit l'ennemi de <PERCENT>%<EXTRA> pendant <TIME><EXTRA_TIME> sec.
$FLAV_DESC_SLOW_SHORT	L'ennemi est temporairement ralenti.
$FLAV_DESC_STRIKE_THROUGH	L'attaque peut toucher jusqu'à <INTI><EXTRA> ennemis.
$FLAV_DESC_STRIKE_THROUGH_SHORT	L'attaque peut toucher plusieurs ennemis.
$FLAV_DESC_CRITICAL	Dégâts = <AMT_1DIG>x<EXTRA> la normale.
$FLAV_DESC_CRITICAL_SHORT	Augmente les dégâts.
$STAT_DESC_HP	SANTÉ<N>Si elle tombe à 0, le personnage est mis hors combat.
$STAT_DESC_SPEED	VITESSE<N>Temps entre les attaques :<N>La vitesse est augmentée de 1x tous les <SPEED_SHOW_MULT> points.
$STAT_DESC_SPEED_ENEMY	VITESSE<N>La vitesse à laquelle un ennemi se déplace et attaque. 1 point = 1 case par seconde.
$STAT_DESC_ATTACK	ATTAQUE<N>Permet aux techniques d'infliger plus de dégâts.
$STAT_DESC_ATTACK_ENEMY	ATTAQUE<N>Les dégâts infligés par la meilleure attaque de l'ennemi.
$STAT_DESC_DEFENSE	DÉFENSE<N>La quantité de dégâts absorbée.
$STAT_DESC_DEFENSE_ENEMY	ARMURE<N>La quantité de dégâts absorbée.
$STAT_DESC_STRONGS	FORCES
$STAT_DESC_WEAKS	FAIBLESSES
$STAT_DESC_REGEN	RÉGÉNÉRATION<N>La vitesse à laquelle le personnage récupère de la Santé, en points/sec.
$STAT_DESC_REGEN_ENEMY	RÉGÉNÉRATION<N>La vitesse à laquelle l'ennemi récupère de la Santé, en points/sec.
$STAT_DESC_EVADE	ESQUIVE<N>Les chances d'éviter les attaques ennemies.
$STAT_DESC_EVADE_ENEMY	ESQUIVE<N>Les chances d'éviter les attaques.
$STAT_DESC_RANGE	PORTÉE<N>Le rayon d'attaque.
$STAT_DESC_RANGE_ENEMY	PORTÉE<N>Le rayon d'attaque.
$STAT_DESC_SPELLS	SORTS
$STAT_DESC_PHASING	DÉPHASAGE<N>Phase et déphase périodiquement. Ne peut être ciblé ou touché lorsque déphasé.<N>Le schéma correspond aux cases (phase, déphase).
$STAT_DESC_BARRIER	BARRIÈRE<N>Une protection efficace contre tous les dégâts. Seule une magie extrêmement puissante est capable de la lever.
$STAT_DESC_FINAL_HIT	COUP FINAL<N>Combien de dégâts <FINAL_HIT_TARGET> recevra lorsque l'ennemi atteindra la fin.
$STRONG_DMG_MULT	<PERCENT>% résistance DGT contre <FLAVOR>
$STRONG_EVADE	<PERCENT>% d'esquive <FLAVOR>
$SKILL_DESC_PSI_COST	Coût en Psi
$SKILL_DESC_COOLDOWN	Recharge
$SKILL_DESC_EFFECT	Effet
$SKILL_DESC_TARGET	Cible
$SKILL_DESC_HITS	Coups
$SKILL_DESC_HITS_NUM	Coups
$SKILL_DESC_SPECIAL",,<N>"$SKILL_DESC_SPLASH	Explosion
$SKILL_DESC_DMG	Dgt
$SKILL_DESC_ADDS_CHANCE_TO_ALL	Ajoute <PERCENT>%<EXTRA> de chances d'infliger <FLAV>* avec toutes les attaques.
$SKILL_DESC_ADDS_CHANCE_TO_ONE	Ajoute <PERCENT>%<EXTRA> de chances d'infliger <FLAV>* avec <LQ><ATTACK><RQ>.
$SKILL_DESC_ADDS_TO_ALL	Ajoute <FLAV>* à toutes les attaques.
$SKILL_DESC_ADDS_TO_ONE	Ajoute <FLAV>* à <LQ><ATTACK><RQ>.
$SKILL_DESC_TOTAL_BONUS	Bonus de stat :<N><STAT>* +<AMOUNT><EXTRA>.
$MISC_FOE_SINGULAR	ennemi
$MISC_FOE_PLURAL	ennemis
$MISC_FRIEND_SINGULAR	allié
$MISC_FRIEND_PLURAL	alliés
$MISC_1_FOE	1 ennemi
$MISC_X_FOES	<NUM> ennemis
$MISC_1_FRIEND	1 allié
$MISC_X_FRIENDS	<NUM> alliés
$MISC_ALL_FOES	Tous les ennemis à portée
$MISC_ALL_FOES_IN	Tous les ennemis dans un<?N>rayon de <TILES> cases
$MISC_ALL_FRIENDS	Tous les alliés à portée
$MISC_ALL_FRIENDS_IN	Tous les alliés dans un<?N>rayon de <TILES> cases
$MISC_ALL_TARGETS	Cibles à portée
$MISC_ALL_TARGETS_IN	Toutes les cibles dans un<?N>rayon de <TILES> cases
$MISC_X_HITS_FOE	<NUM> par ennemi
$MISC_X_HITS_FRIEND	<NUM> par allié
$MISC_X_HITS_TARGET	<NUM> par cible
$MISC_X_HITS_TOTAL	<NUM> au total
$MISC_UP_TO_X_FRIENDS	Jusqu'à <NUM> <FRIEND>
$MISC_UP_TO_X_FOES	Jusqu'à <NUM> <FOE>
$MISC_SPLASH_DAMAGE	Explosion
$MISC_SPLASH_LINE	<AMT> dgt, <TILES> cases
$MISC_SPLASH_TILES	cases
$MISC_SAVED!	Sauvegardé !
$MISC_MISS	raté
$MISC_PROBLEM?	problème ?
$MISC_COUNTER	contre
$MISC_NOM!	MIAM !
$MISC_ACHIEVEMENT!	Succès !
$MISC_AWARD!	Prix
$BASE_ATTACK	Attaque de base
$BONUS_DEFENSE	Bonus de défense
$DECIMATE_BY	Décimer de <PERCENT>%
$EN_SPELL_FRENZY_DESC	Vitesse +<PERCENT> pendant <SEC> sec
$EN_SPELL_HEAL_DESC	Soins : <PERCENT> points de Santé
$EN_SPELL_DRAGON_FIRE_1_DESC	<DMG> DGT
$EN_SPELL_DRAGON_FIRE_2_DESC	<LOW>-<HIGH> DGT
$SPECIAL_IMPROVES	Améliore <FLAVOR> :
$SPECIAL_PLUS_FLAV	Ajoute <FLAVOR> :
$SPECIAL_SAVE_VS	Protège contre <FLAVOR> si Santé >= <PERCENT>%
$TARGET_FIRST_TITLE	Cibler PREMIER
$TARGET_FIRST_TEXT	Cible l'ennemi le plus proche de la fin.
$TARGET_LAST_TITLE	Cibler DERNIER
$TARGET_LAST_TEXT	Cible l'ennemi le plus éloigné de la fin.
$TARGET_STRONG_TITLE	Cibler PLUS FORT
$TARGET_STRONG_TEXT	Cible l'ennemi ayant le plus de Santé + Armure.
$TARGET_WEAK_TITLE	Cibler PLUS FAIBLE
$TARGET_WEAK_TEXT	Cible l'ennemi ayant le moins de Santé + Armure.
$TARGET_FAST_TITLE	Cibler PLUS RAPIDE
$TARGET_FAST_TEXT	Cible l'ennemi se déplaçant le plus vite.
$TARGET_HEAL_TITLE	Priorité aux SOINS
$TARGET_HEAL_TEXT	Soigne dès c'est possible, même si une meilleure technique d'attaque est prête.
$TARGET_FIGHT_TITLE	Priorité au COMBAT
$TARGET_FIGHT_TEXT	Attaque dès c'est possible, même si une meilleure technique de soins est prête.
$TARGET_BOTH_TITLE	Priorité normale
$TARGET_BOTH_TEXT	Utilise les techniques en fonction du niveau de Boost.
$TARGET_CHEAP_TITLE	Technique LA MOINS CHÈRE
$TARGET_CHEAP_TEXT	Garde les techniques de haut niveau de Boost pour les cibles qui ne peuvent pas être tuées avec une technique plus faible.
$TARGET_EFFECT_TITLE	Optimiser LES EFFETS
$TARGET_EFFECT_TEXT	Utilise les attaques à effets sur le statut contre l'ennemi le moins affecté.
$TARGET_BULLDOG_TITLE	Mode BULLDOG
$TARGET_BULLDOG_TEXT	Ne change jamais de cible tant que l'ennemi est à portée et qu'il est en vie.<N><N>Assez dangereux, recommandé uniquement pour les joueurs expérimentés !
$TARGET_CHANCE_TITLE	Meilleure CHANCE
$TARGET_CHANCE_TEXT	Cible l'ennemi le moins susceptible d'esquiver ou de résister à l'attaque.
$TARGET_BOSS_TITLE	Cibler le BOSS
$TARGET_BOSS_TEXT	Si désactivé, ignore les boss.
$TARGET_SAVE_TITLE	Sauvegarder la configuration
$TARGET_SAVE_TEXT	Fait de la configuration actuelle de ce personnage ses paramètres par défaut.
$CONFIRM_RES_CHANGE	Résolution modifiée.<N>Ça vous plaît ?<N><N>Retour à la précédente dans <SECONDS> secondes.
$CONFIRM_RESTART_TITLE	Recommencer la bataille ?
$CONFIRM_RESTART_TEXT	Vous perdrez toute l'expérience et la Camelote gagnées jusqu'ici.
$CONFIRM_QUIT_TITLE	Quitter la bataille ?
$CONFIRM_QUIT_TEXT	<RE>$CONFIRM_RESTART_TEXT
$MISC_LEADER	chef
$MISC_LEVEL	niveau
$MISC_LVLUP	NIVSUP
$MISC_LEVEL_UPX	NIVx SUP
$MISC_LEVEL_UP!	NIVEAU SUP !
$MISC_ANONYMOUS	anonyme
$MISC_LEVEL_SHORT	NIV
$PARTY_HP	SANTÉ
$PARTY_PSI	PSI
$PARTY_XP	EXP<T>
$PARTY_ATTACK	Attaque : <T>
$PARTY_RANGE	Portée : <T>
$PARTY_SPEED	Vitesse : <T>
$PARTY_DEFEND	Défense : <T>
$PARTY_EVADE	Esquive : <T>
$PARTY_REGEN	Régen : <T><T>
$MISC_HP	points de santé
$MISC_HP_SHORT	SANTÉ
$MISC_PSI	psi
$MISC_SPEED	vitesse
$MISC_SPEED_SHORT	VIT
$MISC_ATTACK	attaque
$MISC_ATTACK_SHORT	ATT
$MISC_ARMOR	armure
$MISC_ARMOR_SHORT	ARM
$MISC_EVADE	esquive
$MISC_EVADE_SHORT	ESQ
$MISC_EVASION	esquive
$MISC_DEFEND	défense
$MISC_DEFENSE	défense
$MISC_DEFENSE_SHORT	DÉF
$MISC_RANGE	portée
$MISC_RANGE_SHORT	POR
$MISC_REGEN_LONG	régénération
$MISC_REGEN	régen
$MISC_REGEN_SHORT	RGN
$MISC_OF_DAMAGE	de DGT
$MISC_DAMAGE	dégâts
$MISC_DAMAGE_SHORT	DGT
$MISC_DAMAGE_RESIST	résistance DGT
$MISC_RESIST	résistance à <SOMETHING>
$MISC_VS	contre
$MISC_TO	à
$MISC_VERSUS	contre
$MISC_DEF_SHORT	DEF
$MISC_PHASES	phase
$MISC_SWIMS	nage
$MISC_WALKS_ON	marche toujours
$MISC_HEAL	soigne
$MISC_DEATH_SPLASH	mort explosive
$MISC_PORCUPINE	épines
$MISC_DARK	noir
$MISC_DARK_DESC	(esquive 75 % des attaques)
$MISC_SPAWNS	géniteur
$MISC_STRENGTHS	forces
$MISC_WEAKNESSES	faiblesses
$MISC_IMMUNE_TO	Immunisé contre <SOMETHING>
$MISC_AMOUNT	quantité
$MISC_AMOUNT_SHORT	qt
$MISC_SECOND	seconde
$MISC_SECONDS	secondes
$MISC_SECOND_SHORT	sec
$MISC_SECONDS_SHORT	secs
$MISC_CHANCE	chance
$MISC_THRESHOLD	palier
$MISC_BASE_ATTACK	attaque de base
$MISC_BONUS_DEFENSE	défense de base
$MISC_SAVED	sauvegardé
$MISC_UNSAVED	non sauvegardé
$MISC_EXIT	sortir
$MISC_QUIT	quitter
$MISC_CHANGE_USER	Changer d'utilisateur
$MISC_WRONG_USER	Quelque chose ne va pas avec l'utilisateur actuellement connecté.
$MISC_SIGN_IN	Se connecter
$MISC_CLOSE	fermer
$MISC_TRY_AGAIN	Réessayer
$MISC_RANDOM	aléatoire
$MISC_HIRE	RECRUTER
$MISC_CANT_AFFORD	Trop cher
$MISC_CONFIRM_RECRUIT	Confirmez le recrutement
$MISC_CONFIRM_CHANGE	Confirmez les modifications
$MISC_MAKE_CHANGE	Appliquer ces modifications ?
$MISC_HIRE_Q	Recruter <NAME> (<CLASS>) pour<N><SCRAP> Camelote ?
$MISC_MODS	Mods
$MISC_CONFIG_DIR	Dossier config
$MISC_LANGUAGES	Langues
$MISC_PLEASE_ENTER_A_NAME!	Veuillez entrer un nom !
$MISC_ARE_YOU_SURE	En êtes-vous sûr ?
$MISC_NEXT	suivant
$MISC_PREVIOUS	précédent
$MISC_PREV	préc
$MISC_CANCEL	annuler
$MISC_IGNORE	Ignorer
$MISC_UNDO_ALL	annuler tout
$MISC_UNDO	annuler
$MISC_DOWNLOAD	télécharger
$MISC_BEGIN	commencer
$MISC_LEAVE	partir
$MISC_WEAPONS	armes
$MISC_ARMOR	armures
$MISC_RECRUIT	recruter
$MISC_TALK	discuter
$MISC_QUIT	quitter
$MISC_ENTER	entrer
$MISC_YES	oui
$MISC_NO	non
$MISC_OK	OK
$MISC_ACCEPT	accepter
$MISC_BACK	retour
$MISC_REFUSE	refuser
$MISC_RESTART	recommencer
$MISC_RESTART?	Recommencer ?
$MISC_OKAY	OK
$MISC_QUIT_BATTLE	quitter la bataille
$UI_QUIT_NUMS	font:16,off_y:3,off_x:0
$MISC_NONE	rien
$MISC_SLOW	lent
$MISC_FAST	rapide
$MISC_XP	EXP
$MISC_EXPERIENCE	expérience
$MISC_SCRAP	Camelote
$MISC_COST	coût
$MISC_GAIN	gains
$MISC_CASUAL	occasionnel
$MISC_CASUAL_SHORT	occa.
$MISC_EASY	normal
$MISC_EASY_SHORT	normal
$MISC_NORMAL	normal
$MISC_NORMAL_SHORT	normal
$MISC_ADVANCED	avancé
$MISC_ADVANCED_SHORT	avan.
$MISC_EXTREME	extrême
$MISC_EXTREME_SHORT	extr.
$MISC_SELECT_CHALLENGE	Choix du défi :
$MISC_REWARD	Récompense :
$MISC_PERFECT_BONUS	Bonus si parfait :
$MISC_WAVES	Vagues
$MISC_ENEMY_LEVELS	Niveaux des ennemis
$MISC_TYPES	Types
$MISC_PASS	réussi
$MISC_PERFECT	parfait
$MISC_PERFECT!	parfait !
$MISC_COMPLETE	réussi
$MISC_COMPLETE!	réussi !
$MISC_STRANGER	étranger
$MISC_DESCRIPTION	description
$MISC_DEFENDER	défenseur
$MISC_DEFENDERS	défenseurs
$MISC_STATS	stats
$MISC_STATUS	statut
$MISC_NO_AFFORD	TROP CHER
$MISC_BUY	acheter
$MISC_UPGRADE	améliorer
$MISC_SELL	vendre
$MISC_NOTHING	rien
$MISC_NOTHING!	rien !
$MISC_SPECIAL	spécial
$MISC_UNKNOWN	inconnu
$MISC_MORE	plus...
$MISC_X_MORE	<X> de plus...
$MISC_EQUIP	équiper
$MISC_CANT_EQUIP!	Impossible à équiper
$MISC_UNEQUIP	enlever
$MISC_SKILLS	compétences
$MISC_SKILL	compétence
$MISC_BOOST	boost
$MISC_SPELL	sort
$MISC_LOCKED	verrouillé
$MISC_SKIP	passer
$MISC_NOTHING_TO_EQUIP	Rien à équiper !
$MISC_ENABLED	activé
$MISC_DISABLED	désactivé
$MISC_CONFIRM	confirmer
$MISC_YOU_SURE	En êtes-vous sûr ?
$MISC_LOADING	Chargement...
$MISC_ENTER_TEXT	Entrez le texte :
$MISC_LOADING_PERCENT	Chargement...<PERCENT>%
$MISC_BATTLE	Bataille
$MISC_TOWN	Ville
$MISC_JOURNAL	Journal
$MISC_MOVIES	Films
$MISC_OPTIONS	Options
$MISC_CREDITS	Générique
$MISC_PARTY	Groupe
$MISC_ERROR	erreur
$MISC_ERROR!	erreur !
$MISC_BONUS	Bonus
$MISC_TIPS	Astuces
$MISC_CONTINUE	continuer
$MISC_PLEASE_WAIT	Veuillez patienter...
$MISC_CLICK_HERE	cliquez ici
$MISC_ASSIGN_POINTS	Affecter<N>les points
$MISC_NOBODY	Personne
$MISC_EMPTY	Vide
$MISC_CHANGE	Changer
$MISC_RESET	Réinitialiser
$MISC_DEFAULT	Par défaut
$MISC_SELECT	Sélectionner
$DATA_DUMP_LOCALES	Exportation des paramètres régionaux...
$DATA_DUMP_DATA	Exportation des fichiers de données...
$DATA_DUMP_CUTSCENE	Exportation des images des scènes intermédiaires...
$DATA_DUMP_BKG	Exportation des décors...
$DATA_DUMP_EMBED	Exportation des graphismes embarqués...
$DATA_DUMP_IMAGES	Exportation des images de données...
$DATA_DUMP_TABLES	Exportation des tables de données...
$DATA_DUMP_MOD_INFO	Exportation des infos de Mod...
$DATA_DUMP_MAP_FILES	Exportation des fichiers de carte...
$DATA_DUMP_MAP_IMAGES	Exportation des images de carte...
$DATA_DUMP_AUDIO	Exportation de l'audio...
$REWARD_NEXT_LEVEL	Déverrouille le niveau suivant
$REWARD_FINISH	Termine le jeu
$REWARD_QUEST	Quête accomplie
$REWARD_NO_XP	Rien !
$REWARD_NO_GOLD	Rien !
$REWARD_XP	<PLUS> <XP> EXP
$REWARD_GOLD	<PLUS> <GOLD> CAMELOTE
$HERO_BLURB_SLAK	Un étrange jeune homme, à la fois courageux et instable...
$HERO_BLURB_KETTA	Une chasseuse nomade, cynique et désillusionnée...
$HERO_BLURB_BAKAL	Un vieux moine à la voix douce, en quête d'absolution pour ses péchés...
$HERO_BLURB_WRENNA	La dernière princesse de Quaid, n'aspirant qu'à venger son royaume perdu...
$HERO_BLURB_MARKOS	Un chevalier endurci, usé par les combats incessants...
$HERO_BLURB_NIRU	Violente et mystérieuse, cette dragonne ne partage pas ses secrets...
$TALK_ASH	RÉFUGIÉ ASHANI
$TALK_QUAID	RÉFUGIÉ QUAIDIEN
$TALK_NOMAD	RÉFUGIÉ NOMADE
$TALK_CULTIST	PRÊTRE SANGUINAIRE
$MAP_TEXT_LAIR	Antre
$MAP_TEXT_SHRINE	Autel
$MAP_TEXT_HERMIT	Ermite
$MAP_TEXT_PRISON	Prison
$MAP_TEXT_UNKNOWN	???
$MAP_TEXT_TREASURE	Caverne
$MCGUFFIN_LEARN_SPELL	<MCG> a appris un nouveau sort !
$YOU_GOT_JOIN	<NAME> (<CLASS>)<N>a rejoint le groupe !
$YOU_GOT	Vous avez obtenu
$YOU_GOT_X	<NUM> x <THING> !
$YOU_GOT_NO_EQUIP_YET	Personne dans votre groupe ne peut encore équiper <THING>. Ne vous en faites pas, continuez à jouer et de nouveaux personnages capables de le faire vous rejoindront bientôt.
$YOU_GOT_NO_EQUIP	Cet objet ne peut pas être équipé.
$TOOLTIP_CASUAL	En mode Occasionnel, les ennemis ont moins de points de vie et infligent moins de dégâts.
$TOOLTIP_NORMAL	Le défi normal.<N><N>La plupart des joueurs devraient commencer par ce mode.
$TOOLTIP_ADVANCED	Un défi plus ardu, avec de plus belles récompenses.<N><N>Revenez lorsque vous serez assez fort.
$TOOLTIP_EXTREME	Le défi le plus difficile, avec les plus belles récompenses.<N><N>Préparez-vous !
$TIP_00_TITLE	Coincé ?
$TIP_00_TEXT	<N><N>Il peut parfois être utile de revenir en arrière pour rejouer un niveau précédent afin de gagner de l'expérience, de l'argent, et d'acquérir un meilleur équipement. Vous pouvez également essayer la difficulté « Occasionnel » pour vous simplifier un peu les choses.
$TIP_10_TITLE	Raccourcis
$TIP_10_TEXT	Vous pouvez contrôler le jeu au clavier !<N><N>- Sélection des sorts<N>- Sélection des défenseurs à invoquer<N>- Booster / Rappeler les défenseurs<N>- Pause / Reprise<N>- Défilement des défenseurs invoqués<N>- Modification des options de ciblage / vitesse<N>- Navigation entre les onglets de l'interface<N>- Déplacement du pointeur / clic au clavier<N><N>(Personnalisez les touches depuis le menu Options)
$TIP_20_TITLE	Compétences
$TIP_20_TEXT	Chaque défenseur gagne 1 point de compétence lorsqu'il gagne un niveau.<N><N>Affectez ces points dans le menu groupe pour déverrouiller de nouvelles capacités de combat.<N><N>1) TECHNIQUES (rond) - Des attaques utilisables au combat<N>2) TRAITS (carré) - Des capacités passives, qui fonctionnent en permanence<N><N>Les techniques les plus avancées nécessitent de booster un personnage pour qu'il puisse les utiliser.
$TIP_30_TITLE	Qui gagne de l'expérience ?
$TIP_30_TEXT	<N><N>À la fin d'une bataille, tout le monde gagne la même quantité d'expérience, à condition d'avoir été invoqué et d'être encore en vie.<N><N>Les autres gagnent la moitié d'expérience. L'EXP par personnage est la même, quel que soit le nombre de personnages.<N><N>Vous pouvez modifier cette pénalité depuis le menu Accessibilité.
$TIP_40_TITLE	Carte
$TIP_40_TEXT	Vous pouvez cliquer-glisser pour faire défiler la carte, ou bien naviguer à l'aide du clavier.<N><N>Le défilement est associé par défaut aux touches fléchées.
$TIP_50_TITLE	Rappel pour 100% de Psi
$TIP_50_TEXT	Rappeler des défenseurs ne vous permet normalement de récupérer qu'une fraction de l'énergie Psi investie.<N><N>Si vous les rappelez avant l'apparition du premier ennemi, vous récupérerez cependant 100% de votre Psi.
$TIP_60_TITLE	Site web et forum
$TIP_60_TEXT	Si vous avez une question, rejoignez la communauté en ligne de Defender's Quest sur le site www.defendersquest.com !<N><N>Nous disposons d'un forum où vous pourrez poser vos questions, d'un wiki collaboratif, ainsi que d'un blog de développement.
$TIP_70_TITLE	Placer les défenseurs
$TIP_70_TEXT	Vous pouvez utiliser le clavier pour placer des défenseurs pendant la bataille.<N><N>Les commandes sont associées par défaut aux touches fléchées.
$TIP_80_TITLE	Effets de bataille
$TIP_80_TEXT	La couleur des nombres affichés indique le type des dégâts infligés. Blanc correspond à des dégâts normaux, gris à des dégâts minorés par une armure, rouge à des dégâts de saignement, orange à des dégâts de feu, violet à des dégâts de poison, et un nombre en gras indique un coup critique.<N><N>Vous pouvez activer ou désactiver l'affichage de ces nombres depuis le menu Options.
$TIP_90_TITLE	Objets uniques
$TIP_90_TEXT	En jouant certains niveaux à des niveaux de difficulté supérieurs, vous pourrez parfois gagner des objets uniques. Ces puissants artefacts ne peuvent pas être trouvés dans les boutiques.
$TIP_100_TITLE	Rappel
$TIP_100_TEXT	Rappeler des défenseurs invoqués vous permet de récupérer une fraction de l'énergie Psi investie.<N><N>La quantité récupérée diminue lorsque le défenseur est blessé.
$TIP_110_TITLE	Accessibilité
$TIP_110_TEXT	Si vous souffrez d'un handicap, vous pouvez ajuster certains paramètres depuis le menu Options :<N><N>1) Vidéo - Jouer en mode plein écran, mettre les graphismes à l'échelle<N>2) Commandes - Modifier les contrôles du jeu<N>3) Accessibilité - Active ou désactive certains effets, modifie la vitesse de jeu et le multiplicateur d'expérience
$TIP_110C_TEXT	Si vous souffrez d'un handicap, vous pouvez ajuster certains paramètres depuis le menu Options :<N><N>1) Commandes - Modifier les contrôles du jeu<N>2) Accessibilité - Active ou désactive certains effets, modifie la vitesse de jeu et le multiplicateur d'expérience
$TIP_120_TITLE	Message d'intérêt général
$TIP_120_TEXT	Ce conseil est juste là afin que personne n'essaye d'analyser des codes ou de déchiffrer des énigmes.
$TIP_130_TITLE	Options de ciblage
$TIP_130_TEXT	Si vous cliquez sur un défenseur, vous pourrez lui donner différentes consignes de ciblages, comme de favoriser les ennemis en avant, en arrière, les plus forts, les plus faibles ou les plus rapides. Servez-vous de ces paramètres pour optimiser vos attaques. Par exemple, « fort » peut vous permettre de vous concentrer sur les grosses unités, ou d'affaiblir une horde d'ennemis.
$TIP_130C_TEXT	Si vous sélectionnez un défenseur, vous pourrez lui donner différentes consignes de ciblages, comme de favoriser les ennemis en avant, en arrière, les plus forts, les plus faibles ou les plus rapides. Servez-vous de ces paramètres pour optimiser vos attaques. Par exemple, « fort » peut vous permettre de vous concentrer sur les grosses unités, ou d'affaiblir une horde d'ennemis.
$TIP_140_TITLE	Ciblage avancé
$TIP_140_TEXT	En plus des options de ciblage de base, il existe quatre paramètres optionnels : <N><N>1) Technique la moins chère<N>2) Optimiser les effets<N>3) Meilleure chance<N>4) Mode bulldog<N><N>Ces paramètres ne sont pas obligatoires, mais ils peuvent aider les joueurs expérimentés à optimiser leurs stratégies. Vous pouvez même sauvegarder les paramètres de ciblage par défaut d'un personnage donné !
$TIP_150_TITLE	Feu et glace
$TIP_150_TEXT	Le feu et la glace ne font pas bon ménage. Transi et Gelé éteindront Embrasé, et Embrasé fera fondre Gelé et annulera Transi.
$TIP_160_TITLE	Hauts niveaux de difficulté
$TIP_160_TEXT	Les difficultés « Avancé » et « Extrême » seront en général trop dures pour être tentées immédiatement.<N><N>Tentez le coup après avoir remporté les quelques batailles suivantes en mode normal.
$TIP_170_TITLE	Équipement
$TIP_170_TEXT	Lorsque vous achetez de l'équipement pour un personnage, ses anciennes possessions peuvent vous permettre d'améliorer d'autres membres de votre groupe à moindres frais.
$TIP_180_TITLE	L'union fait la force
$TIP_180_TEXT	Grouper vos défenseurs force les ennemis à répartir leurs attaques, ce qui augmente les chances de survie de vos personnages.<N><N>Le défaut de cette stratégie est que vous couvrez une zone de plus petite taille.
$TIP_190_TITLE	Multiplicateurs de gains
$TIP_190_TEXT	Si vous souhaitez ajuster la vitesse de montée en niveau de vos personnages, vous pouvez modifier le multiplicateur global de gain d'expérience depuis le menu Options.<N><N>Le réglage par défaut est à 100 %.<N><N>Vous pouvez également modifier le multiplicateur pour les gains de Camelote.
$TIP_200_TITLE	Désactivation de techniques
$TIP_200_TEXT	Il peut arriver qu'une technique particulière vienne perturber vos projets (les boules de feu des Dragons peuvent par exemple libérer des ennemis que vous venez de geler). Vous pouvez également avoir envie de garder une attaque puissante pour plus tard. Dans ce cas, vous pouvez cliquer sur un défenseur, puis sur une technique dans le menu en bas à droite afin de la désactiver temporairement.
$TIP_200C_TEXT	Il peut arriver qu'une technique particulière vienne perturber vos projets (les boules de feu des Dragons peuvent par exemple libérer des ennemis que vous venez de geler). Vous pouvez également avoir envie de garder une attaque puissante pour plus tard. Dans ce cas, vous pouvez sélectionner un défenseur, puis sur une technique dans le menu en bas à droite afin de la désactiver temporairement.
$TIP_210_TITLE	Où sont mes sauvegardes ?
$TIP_210_TEXT	Dans le menu Sauvegarde, vous trouverez un bouton orné d'une icône en forme de dossier avec une clé anglaise.<N><N>Ce bouton vous amènera à l'emplacement où vos sauvegardes et votre fichier de configuration sont enregistrés.
$TIP_220_TITLE	Nouvelle partie+
$TIP_220_TEXT	Une fois le jeu normal terminé, vous pourrez vous lancer dans une nouvelle aventure avec votre ancien groupe, avec des batailles plus difficiles et des récompenses de folie !<N><N>Depuis le menu Sauvegarde, sélectionnez NOUVELLE PARTIE+ sur votre ancien emplacement de sauvegarde.
$TIP_230_TITLE	Améliorations
$TIP_230_TEXT	En mode NP+, vous pourrez obtenir des artéfacts spéciaux qui vous permettront d'améliorer l'équipement unique récolté au cours d'une partie normale. Ces objets améliorés sont dotés de pouvoirs spéciaux !
$TIP_240_TITLE	Missions bonus
$TIP_240_TEXT	Lorsque vous aurez gagné suffisamment d'Étoiles, vous commencerez à déverrouiller des batailles bonus. Ces missions spéciales proposent des défis supplémentaires et des récompenses spécifiques.
$TIP_250_TITLE	Brûlure Psi ?
$TIP_250_TEXT	Le sort Foudre provoque une « Brûlure Psi » qui détruit une partie de la récompense en Psi que vous rapporte un ennemi à sa mort. Si le sort inflige 40 % de dégâts à un ennemi, 40 % de la récompense normale en Psi pour sa destruction sera perdue...
$TIP_260_TITLE	Support de Mods
$TIP_260_TEXT	Saviez-vous que vous pouvez créer vos propres Mods (Modifications) pour Defender's Quest ? <N><N>Cliquez sur le gros bouton « M » dans le menu Sauvegarde. Vous pourrez modifier quasiment tout ce que vous voudrez... Statistiques, niveaux, classes, personnages, scènes intermédiaires, graphismes, objets, etc.
$TIP_270_TITLE	Maman
$TIP_270_TEXT	<N><N>Pensez à téléphoner à votre maman, elle aimerait bien avoir de vos nouvelles...
$TYPE_DARK	Noir
$TYPE_SHEEP	Mouton
$TYPE_SPLITTER	Diviseur
$TYPE_WORM	Ver
$TYPE_BOSS	Boss
$TYPE_NORMAL	Normal
$TYPE_CULTIST	Sanguinaire
$TYPE_WATER	Aquatique
$TYPE_FAST	Rapide
$TYPE_SNAIL	Lent
$TYPE_REVENANT	Revenant
$TYPE_ATTACKER	Combattant
$TYPE_SPITTER	Diviseur
$TYPE_NUKE_ON_KILL	Explosif
$TYPE_ARMOR	Cuirassé
$TYPE_STATIONARY	Stationnaire
$TYPE_TELEPORTER	Téléporteur
$TYPE_EXALTED	Exalté
$TYPE_NO_END_DAMAGE	ZéroDégâts
$GETSCRAP1	Un tas de débris, de guenilles, d'outils cassés et d'objets plus ou moins tranchants en métal rouillé.<N><N>Qui pourrait bien vouloir de ça ?
$GETSCRAP2	Apparemment, les habitants de la Fosse se servent de cette camelote comme monnaie d'échange.
$END	fin
$BATTLE_STARTING_FORMATION_TEXT	Utiliser la même formation de départ que la dernière fois ?
$DATA_DUMP_BACKGROUNDS	<RE>$DATA_DUMP_BKG
$DATA_DUMP_CUTSCENES	<RE>$DATA_DUMP_CUTSCENE
$DATA_DUMP_MUSIC	Exportation de la musique...
$DATA_DUMP_SFX	Exportations des bruitages...
$DATA_DUMP_SPRITES	Exportation des sprites...
$LQ	« 
$MISC_ABSORB_X	absorbe <X>
$MISC_ABSORB_X_RESIST_Y	absorbe <X>, résistance <Y>%
$MISC_ACCEPT_AND_CLOSE	Accepter & fermer
$MISC_BOOST_X	booste <X>
$MISC_COST:	coût :
$MISC_DEFEAT	Défaite
$MISC_DEFENSE_ABS	défense
$MISC_DEMO_VERSION	Version Démo
$MISC_DEMO_VERSION_DESC	Ceci est une démo publique de préversion de Defender’s Quest : Valley of the Forgotten, Édition Spéciale HD.<N><N>Il est possible qu’elle comporte quelques bugs, et les graphismes et les fonctionnalités ne sont pas finalisés.<N><N>Gardez à l’esprit que cette version n’est pas censée être représentative du produit final.
$MISC_DQ_NEWS	Tenez-vous au courant !
$MISC_DQ_SITE	DefendersQuest.com
$MISC_EASIER	plus facile
$MISC_ERROR_INVALID_MOD_NAME	nom de mod invalide !
$MISC_ERROR_MOD_BAD	Ce mod est incompatible avec cette version du jeu. Désolé !
$MISC_ERROR_MOD_EXISTS	Un mod portant ce nom existe déjà !
$MISC_ERROR_UNKNOWN	Erreur inconnue. Désolé !
$MISC_ERROR_UNZIP	Impossible de dézipper le mod. Modifier le chemin du mod dans le menu options, ou vérifiez l’espace disponible sur votre disque dur.
$MISC_GAME_DATA	Données du jeu
$MISC_GOLD	Camelote
$MISC_GOLD:	Camelote :
$MISC_HARD	<RE>$MISC_EXTREME
$MISC_HARDER	plus difficile
$MISC_HARD_SHORT	<RE>$MISC_EXTREME_SHORT
$MISC_INFO	info
$MISC_LEVEL_SHORT_X	NIV <X>
$MISC_LEVEL_SUPER_SHORT	N
$MISC_LEVEL_PARTY_GEM	Niveau	Appears on character blocks in the party screen
$MISC_LEVEL_WAVE_BLOCK	Niveau	Appears on enemy wave blocks in battle
$MISC_LEVEL_X	Niveau <X>
$MISC_MEDIUM	<RE>$MISC_ADVANCED
$MISC_MEDIUM_SHORT	<RE>$MISC_ADVANCED_SHORT
$MISC_MENU	menu
$MISC_NEED_PSI	PSI<N>REQUIS
$MISC_NONE_DEFAULT	Aucun *
$MISC_NO_CHANGE	aucun changement
$MISC_OTHER	Autre
$MISC_PLUS_X%_TO_ARMOR_MULT	<PLUS_OR_MINUS><X> à MULT. ARMURE
$MISC_PLUS_X%_TO_DEFENSE_MULT	<PLUS_OR_MINUS><X>% à DÉFENSE
$MISC_PLUS_X%_TO_DODGE	<PLUS_OR_MINUS><X> à ESQUIVE
$MISC_PLUS_X%_TO_EVADE	<RE>$MISC_PLUS_X%_TO_DODGE
$MISC_PLUS_X%_TO_REGEN_MULT	<PLUS_OR_MINUS><X>% à RÉGÉNÉRATION
$MISC_PLUS_X_STAT	<PLUS><X> <STAT>
$MISC_PLUS_X_TO_ARMOR_ABS	<PLUS_OR_MINUS><X> à ARMURE
$MISC_PLUS_X_TO_ATTACK	<PLUS_OR_MINUS><X> à ATTAQUE
$MISC_PLUS_X_TO_ATTACK_SPEED	<PLUS_OR_MINUS><X> à VITESSE
$MISC_PLUS_X_TO_DEFENSE_ABS	<PLUS_OR_MINUS><X> à DÉFENSE
$MISC_PLUS_X_TO_HP	<PLUS_OR_MINUS><X> à SANTÉ
$MISC_PLUS_X_TO_RANGE	<PLUS_OR_MINUS><X> à PORTÉE
$MISC_PLUS_X_TO_REGEN_ABS	<PLUS_OR_MINUS><X> à RÉGÉNÉRATION
$MISC_PSI_SHORT	psi
$MISC_RESIST_X	résistance <X>%
$MISC_SAVE_DATA	Sauvegarder les données
$MISC_SEND_NEXT	SUIVANT
$MISC_THORNS	épines
$MISC_UNIQUE	unique
$MISC_VICTORY	Victoire
$MISC_WAIT	ATTENTE
$MISC_WEAPON	<RE>$MISC_WEAPONS
$MISC_X_PSI	<X> PSI
$RQ	 »
$SKILL_DESC_HEAL	Soins
$STATE_CRASH_DETAILS	Détails :
$STATE_CRASH_PROMPT	Que souhaitez-vous faire ?
$STATE_CRASH_SEND	Envoyer un rapport<N>au développeur
$STATE_CRASH_SHOW_DUMP	Afficher les<N>fichiers de dump
$STATE_CRASH_TITLE	Erreur critique !
$STATUS_DESC_DARK_FRENZY	<RE>$STATUS_DESC_FRENZY
$STATUS_DESC_EVER_BLEED	<RE>$STATUS_DESC_BLEED
$STATUS_DESC_FB_EXISTENTIAL	-<PERCENT>% vitesse, +<PERCENT>% résist. dégâts
$STATUS_DESC_FIRE	<RE>$STATUS_DESC_BURN
$STATUS_DESC_INSPIRE	<RE>$STATUS_DESC_INSPIRED
$STATUS_DESC_INSPIRED_HIT	<RE>$STATUS_DESC_INSPIRED
$STAT_DESC_ARMOR	ARMURE<N>Quantité de dégâts absorbée.
$STAT_DESC_ARMOR_ENEMY	ARMURE<N>Quantité de dégâts absorbée.
$STAT_DESC_SPAWN	ENGENDRE:<N>
$STAT_DESC_THORNS	ÉPINES<N>Inflige des dégâts à tout attaquant au corps-à-corps.
$STAT_DESC_XP	EXPÉRIENCE<N>
$TARGET_SPECIFIC_TEXT	Sélection manuelle d’un ennemi spécifique à attaquer, en ignorant tous les autres.
$TARGET_SPECIFIC_TITLE	Cible SPÉCIFIQUE
$TITLE_OPTIONS	Options
$UI_ACCESS_SEE_ALSO	Voir aussi :
$UI_ALL_FILES	Tous les fichiers
$UI_CONTROLS_ACCEPT	Accepter
$UI_CONTROLS_ACCEPT_SELECT	Accepter/Sélectionner
$UI_CONTROLS_AUTO	Auto-détection
$UI_CONTROLS_BACK_CANCEL	Retour/Annuler
$UI_CONTROLS_CANCEL	Annuler
$UI_CONTROLS_CURSOR	Curseur
$UI_CONTROLS_DEVICE	Dispositif
$UI_CONTROLS_GAMEPAD	Gamepad
$UI_CONTROLS_GAMEPAD_MODEL	Modèle
$UI_CONTROLS_KEYBOARD	Souris & clavier
$UI_CONTROLS_LOGITECH	Logitech
$UI_CONTROLS_MENU	Menu
$UI_CONTROLS_MENU_ALT	Menu 2
$UI_CONTROLS_MINUS_PLUS_SPEED	-/+<N>Vitesse
$UI_CONTROLS_NAVIGATE_MENU	Naviguer dans le menu
$UI_CONTROLS_OUYA	Ouya
$UI_CONTROLS_POINTER	Pointeur
$UI_CONTROLS_PRESET_COLEMAK	Colemak
$UI_CONTROLS_PRESET_DEFAULT	Par défaut
$UI_CONTROLS_PRESET_PS	PlayStation
$UI_CONTROLS_PRESET_PSJ	Japonais
$UI_CONTROLS_PRESET_WIIU	WiiU par défaut
$UI_CONTROLS_PRESET_XBOX	XBox par défaut
$UI_CONTROLS_PS3	Playstation 3
$UI_CONTROLS_PS4	Playstation 4
$UI_CONTROLS_SEE_ALSO	Voir aussi :
$UI_CONTROLS_SELECT	Sélection
$UI_CONTROLS_XBOX1	Xbox One
$UI_CONTROLS_XBOX360	Xbox 360
$UI_CONTROLS_XINPUT	Xinput
$UI_DQ_SAVE_FILES	Sauvegardes de DQ<X>
$UI_EQUIP_ALL_ACC_BOOK	Tous les livres sont équipés !
$UI_EQUIP_NO_ACC_BOOK	Vous n’avez aucun livre !
$UI_GRAPHICS_HD	HD
$UI_GRAPHICS_ORIGINAL	Originaux
$UI_HIGH	Élevé
$UI_HIGH()	Élevé(<X>)
$UI_LOGGING_ALWAYS	Toujours
$UI_LOGGING_ASK	Demander à chaque fois
$UI_LOGGING_CRASH	Enregistrer le journal de crash
$UI_LOGGING_CRASH_CONTENT	Inclure avec le journal de crash :
$UI_LOGGING_CRASH_OPTIONS	Configuration du jeu
$UI_LOGGING_CRASH_REPLAY	Enregistrement des contrôles utilisateur
$UI_LOGGING_CRASH_SAVES	Fichiers de sauvegardes
$UI_LOGGING_CRASH_SCREENSHOT	Capture d’écran
$UI_LOGGING_CRASH_SYSTEM	Configuration système
$UI_LOGGING_NEVER	Jamais
$UI_LOGGING_SEND	Envoyer les journaux de crash au développeur
$UI_LOGGING_TITLE	Journalisation
$UI_LOW	Faible
$UI_LOW()	Faible(<X>)
$UI_MOD_LOAD_MOD_TEXT	Charger le mod <LQ><MOD><RQ> ?<N>Ceci fera redémarrer le jeu.
$UI_MOD_ZIP_FILES	Fichiers Zip (*.*)
$UI_RESOLUTION_CHOICES	Disponible :
$UI_RESOLUTION_CURRENT	Actuel :
$UI_RESOLUTION_CURRENT_PARENTHESES	(Actuel)
$UI_RESOLUTION_TITLE	Résolution du moniteur
$UI_SELECT_A_FILE_TEXT	Sélectionnez un fichier de sauvegarde à importer
$UI_SELECT_A_FILE_TITLE	Veuillez sélectionner un fichier !
$UI_VIDEO_CHANGE_RES_TO	Passer la résolution en <X>
$UI_VIDEO_CUTSCENES	Cinématiques
$UI_VIDEO_GRAPHICS	Graphismes
$UI_VIDEO_HD	Élargi (16:9)
$UI_VIDEO_MATCH_MONITOR	Correspondance plein écran
$UI_VIDEO_MODE	Mode
$UI_VIDEO_RESOLUTION	Résolution plein écran du moniteur
$UI_VIDEO_SCREEN_SIZE	Taille de la fenêtre de jeu
$UI_VIDEO_SD	Standard (4:3)
$UI_VIDEO_SELECT_NEW	Sélectionnez...
$UI_VIDEO_SPRITES	Sprites
$WEAK_DMG_MULT	<PLUS><PERCENT>% DGT de <FLAVOR>
$YOU_GOT_MONEY	Vous avez obtenu <MONEY> Camelote !
$MISC_PLEASE_RECONNECT_CONTROLLER	Reconnectez la manette
$PRESS_A	Appuyez sur <A> pour continuer.
$MISC_REQUIRES_RESTART	(redémarrage nécessaire)
$MISC_PICTURE_SIZE	Taille de<N>l'image
$MISC_SIGNED_OUT	<USER> s’est déconnecté(e).
$MISC_SIGNED_IN	Connecté en tant que <USER>.
$MISC_SWITCH_USER	Changer d'utilisateur
$MISC_RESTART_XBOX	Redémarrer votre Xbox ?
$ACTIONS_BATTLECONTROLS	Bataille
$ACTIONS_BATTLE_BACK	<RE>$BATTLE_BACK
$ACTIONS_BATTLE_CYCLE_NEXT	Défenseur suivant
$ACTIONS_BATTLE_CYCLE_PREVIOUS	Défenseur<N>précédent
$ACTIONS_BATTLE_DEFENDERS	<RE>$BATTLE_DEFENDERS
$ACTIONS_BATTLE_FINE_MOVE	<RE>$BATTLE_FINE_MOVE
$ACTIONS_BATTLE_FREE_MOVE	<RE>$BATTLE_FREE_MOVE
$ACTIONS_BATTLE_MENU	<RE>$BATTLE_MENU
$ACTIONS_BATTLE_MENU_MOVE	<RE>$BATTLE_MOVE
$ACTIONS_BATTLE_PAUSE	<RE>$MISC_PAUSE
$ACTIONS_BATTLE_SELECT	<RE>$BATTLE_SELECT_UNIT
$ACTIONS_BATTLE_SPEED_MINUS	Vitesse -
$ACTIONS_BATTLE_SPEED_PLUS	Vitesse +
$ACTIONS_BATTLE_SPELLS	Sorts
$ACTIONS_BATTLE_SPELL_SPAM	Répéter sort
$ACTIONS_BATTLE_TILE_MOVE	<RE>$BATTLE_TILE_MOVE
$ACTIONS_CUTSCENECONTROLS	Cinématique
$ACTIONS_CUTSCENE_NEXT	<RE>$MISC_NEXT
$ACTIONS_CUTSCENE_PREVIOUS	<RE>$MISC_PREVIOUS
$ACTIONS_CUTSCENE_SKIP	<RE>$MISC_SKIP
$ACTIONS_MAPCONTROLS	Carte du monde
$ACTIONS_MAP_EXIT	<RE>$MISC_EXIT
$ACTIONS_MAP_JOURNAL	<RE>$MISC_JOURNAL
$ACTIONS_MAP_MENU	<RE>$MISC_MENU
$ACTIONS_MAP_MOVE	Déplacement curseur
$ACTIONS_MAP_MOVE_MAP	Déplacement sur carte
$ACTIONS_MAP_SCROLL_MAP	Défilement carte
$ACTIONS_MAP_SELECT	<RE>$MISC_SELECT
$ACTIONS_MENUCONTROLS	Menu
$ACTIONS_MENUCONTROLSWITHANALOG	Menu
$ACTIONS_MENU_CANCEL	Annuler
$ACTIONS_MENU_MENU	Menu
$ACTIONS_MENU_MOVE	Déplacement curseur
$ACTIONS_MENU_SELECT	Sélection
$ACTIONS_MENU_THING_1	Choix 1
$ACTIONS_MENU_THING_2	Choix 2
$ACTIONS_MENU_THING_3	Choix 3
$BATTLE_BACK	<RE>$MISC_BACK
$BATTLE_DEFENDERS	<RE>$MISC_DEFENDERS
$BATTLE_FINE_MOVE	Déplacement lent
$BATTLE_FREE_MOVE	Pointeur doigt
$BATTLE_MAP	carte
$BATTLE_MENU	<RE>$MISC_MENU
$BATTLE_MOVE	Déplacement
$BATTLE_MOVE_MOUSE	Déplacement souris
$BATTLE_SELECT_UNIT	Sélection<N>d'unité
$BATTLE_SPELLS	<RE>$STAT_DESC_SPELLS
$BATTLE_TILE_MOVE	Déplacement case
$BOOK_COOLDOWN_OP	Temps de recharge du sort <X>
$BOOK_COST_OP	Coût du sort <X>
$CONTROL_SWITCH_WARNING	Vous ne pouvez pas changer de technique fondamentale de contrôle pendant une bataille. Désolé !
$DATA_DUMP_MAPS	<RE>$DATA_DUMP_MAP_FILES
$EQUIP_THE_THING	<RE>$MISC_EQUIP
$GAMEPAD_A	Bouton A
$GAMEPAD_B	Bouton B
$GAMEPAD_BACK	Bouton Back
$GAMEPAD_BUTTON_SPACER	
$GAMEPAD_DPAD	Croix multidirectionnelle
$GAMEPAD_DPAD_DOWN	Croix multidirectionnelle bas
$GAMEPAD_DPAD_LEFT	Croix multidirectionnelle gauche
$GAMEPAD_DPAD_RIGHT	Croix multidirectionnelle droite
$GAMEPAD_DPAD_UP	Croix multidirectionnelle haut
$GAMEPAD_EMPTY	Rien
$GAMEPAD_LEFT_ANALOG_STICK	Stick analogique gauche
$GAMEPAD_LEFT_ANALOG_STICK_X_MINUS	Stick analogique gauche, vers la GAUCHE
$GAMEPAD_LEFT_ANALOG_STICK_X_PLUS	Stick analogique gauche, vers la DROITE
$GAMEPAD_LEFT_ANALOG_STICK_Y_MINUS	Stick analogique gauche, vers le HAUT
$GAMEPAD_LEFT_ANALOG_STICK_Y_PLUS	Stick analogique gauche, vers le BAS
$GAMEPAD_LEFT_SHOULDER	Gâchette haute gauche
$GAMEPAD_LEFT_STICK_CLICK	Stick analogique gauche, CLIQUÉ
$GAMEPAD_LEFT_TRIGGER	Gâchette gauche
$GAMEPAD_NOTE	Sélectionnez pour personnaliser
$GAMEPAD_RIGHT_ANALOG_STICK	Stick analogique droit
$GAMEPAD_RIGHT_ANALOG_STICK_X_MINUS	Stick analogique droit, vers la GAUCHE
$GAMEPAD_RIGHT_ANALOG_STICK_X_PLUS	Stick analogique droit, vers la DROITE
$GAMEPAD_RIGHT_ANALOG_STICK_Y_MINUS	Stick analogique droit, vers le HAUT
$GAMEPAD_RIGHT_ANALOG_STICK_Y_PLUS	Stick analogique droit, vers le BAS
$GAMEPAD_RIGHT_SHOULDER	Gâchette haute droite
$GAMEPAD_RIGHT_STICK_CLICK	Stick analogique droit, CLIQUÉ
$GAMEPAD_RIGHT_TRIGGER	Gâchette droite
$GAMEPAD_START	Bouton Start
$GAMEPAD_TEMP_SPACER	,,,,,,
$GAMEPAD_X	Bouton X
$GAMEPAD_Y	Bouton Y
$GO_TO_EQUIP_MENU	<RE>$MISC_EQUIP
$LOGITECH_A	bouton 2 (façade)
$LOGITECH_B	bouton 3 (façade)
$LOGITECH_BACK	bouton 9 (arrière)
$LOGITECH_DPAD	<RE>$GAMEPAD_DPAD
$LOGITECH_DPAD_DOWN	<RE>$GAMEPAD_DPAD_DOWN
$LOGITECH_DPAD_LEFT	<RE>$GAMEPAD_DPAD_LEFT
$LOGITECH_DPAD_RIGHT	<RE>$GAMEPAD_DPAD_RIGHT
$LOGITECH_DPAD_UP	<RE>$GAMEPAD_DPAD_UP
$LOGITECH_EMPTY	<RE>$GAMEPAD_EMPTY
$LOGITECH_LEFT_ANALOG_STICK	<RE>$GAMEPAD_LEFT_ANALOG_STICK
$LOGITECH_LEFT_ANALOG_STICK_X_MINUS	<RE>$GAMEPAD_LEFT_ANALOG_STICK_X_MINUS
$LOGITECH_LEFT_ANALOG_STICK_X_PLUS	<RE>$GAMEPAD_LEFT_ANALOG_STICK_X_PLUS
$LOGITECH_LEFT_ANALOG_STICK_Y_MINUS	<RE>$GAMEPAD_LEFT_ANALOG_STICK_Y_MINUS
$LOGITECH_LEFT_ANALOG_STICK_Y_PLUS	<RE>$GAMEPAD_LEFT_ANALOG_STICK_Y_PLUS
$LOGITECH_LEFT_SHOULDER	bouton 5 (gâchette haute gauche) 
$LOGITECH_LEFT_STICK_CLICK	<RE>$GAMEPAD_LEFT_STICK_CLICK
$LOGITECH_LEFT_TRIGGER	bouton 7 (gâchette analogique gauche)
$LOGITECH_RIGHT_ANALOG_STICK	<RE>$GAMEPAD_RIGHT_ANALOG_STICK
$LOGITECH_RIGHT_ANALOG_STICK_X_MINUS	<RE>$GAMEPAD_RIGHT_ANALOG_STICK_X_MINUS
$LOGITECH_RIGHT_ANALOG_STICK_X_PLUS	<RE>$GAMEPAD_RIGHT_ANALOG_STICK_X_PLUS
$LOGITECH_RIGHT_ANALOG_STICK_Y_MINUS	<RE>$GAMEPAD_RIGHT_ANALOG_STICK_Y_MINUS
$LOGITECH_RIGHT_ANALOG_STICK_Y_PLUS	<RE>$GAMEPAD_RIGHT_ANALOG_STICK_Y_PLUS
$LOGITECH_RIGHT_SHOULDER	bouton 6 (gâchette haute droite) 
$LOGITECH_RIGHT_STICK_CLICK	<RE>$GAMEPAD_RIGHT_STICK_CLICK
$LOGITECH_RIGHT_TRIGGER	bouton 8 (gâchette analogique droite)
$LOGITECH_START	bouton 10 (Start)
$LOGITECH_X	bouton 1 (façade)
$LOGITECH_Y	bouton 4 (façade)
$MISC_ACCESSORIES	accessoires
$MISC_ACCESSORY	accessoire
$MISC_ACCESSORY_PLURAL	<RE>$MISC_ACCESSORIES
$MISC_ACCESSORY_SINGULAR	<RE>$MISC_ACCESSORY
$MISC_ADJUST_REWARDS	100 % est la quantité par défaut, ajustez-la avec haut et bas pour modifier vos récompenses.
$MISC_ARMOR_PLURAL	<RE>$MISC_ARMOR
$MISC_ARMOR_SINGULAR	<RE>$MISC_ARMOR
$MISC_BREAK_HERO_MODE_TEXT	Vous avez choisi de jouer en <LQ>Mode Héros<RQ>, ce qui vous interdit de recruter des personnages génériques.<N>Souhaitez-vous quitter ce mode pour pouvoir recruter un personnage ?
$MISC_BREAK_HERO_MODE_TITLE	Quitter le Mode Héros ?
$MISC_CURRENT_SAVE	Sauvegarde actuelle :
$MISC_CUSTOM_SETTINGS	Personnaliser...
$MISC_DEFAULT_SETTINGS	Par défaut (recommandé pour les nouveaux joueurs)
$MISC_DELETE_ACHIEVEMENT	Supprimer les succès ?
$MISC_DELETE_BOTH_GOG_ACHIEVEMENT	Supprimer les succès locaux & GOG
$MISC_DELETE_BOTH_STEAM_ACHIEVEMENT	Supprimer les succès locaux & Steam
$MISC_DELETE_LOCAL_ACHIEVEMENT	Supprimer les succès locaux uniquement
$MISC_DEVICE_DISCONNECTED_TEXT	<NAME> de l'emplacement <SLOT> déconnectée !
$MISC_DEVICE_DISCONNECTED_TITLE	Périphérique déconnecté !
$MISC_EDIT	Éditer
$MISC_FAIL_TT_TEXT	La quantité d’Expérience et de Camelote soustraite de vos récompenses si vous perdez une bataille.<N>-50 % est la quantité défaut, ajustez-la avec haut et bas pour modifier la pénalité.
$MISC_FAIL_TT_TITLE	<RE>$UI_ACCESS_FAILURE_PENALTY
$MISC_GOLD_TT_TEXT	La Camelote (l’argent) que vous obtenez après une bataille.<N><RE>[$MISC_ADJUST_REWARDS]
$MISC_GOLD_TT_TITLE	Camelote
$MISC_HERO_MODE	Mode Héros
$MISC_HERO_MODE_TEXT	Il vous est interdit de recruter des personnages génériques.<N>PAS DU TOUT recommandé pour les nouveaux joueurs !<N><N>Notes :<N>Vous pourrez revenir sur votre décision plus tard en essayant de recruter un personnage et en confirmant votre volonté de quitter ce mode.<N><N>Nous vous recommandons vraiment de configurer les gains d’Expérience et de Camelote sur 300 % lorsque vous jouez en Mode Héros.<N><N>Ce paramétrage n’est pas obligatoire pour les succès en « Mode Héros », l’absence de personnages génériques est largement suffisante.
$MISC_HERO_MODE_TEXT_SONY	Il vous est interdit de recruter des personnages génériques.<N>PAS DU TOUT recommandé pour les nouveaux joueurs !<N><N>Notes :<N>Vous pourrez revenir sur votre décision plus tard en essayant de recruter un personnage et en confirmant votre volonté de quitter ce mode.<N><N>Nous vous recommandons vraiment de configurer les gains d’Expérience et de Camelote sur 300 % lorsque vous jouez en Mode Héros.<N><N>Ce paramétrage n’est pas obligatoire pour les prix en « Mode Héros », l’absence de personnages génériques est largement suffisante.
$MISC_HERO_MODE_TITLE	<RE>$MISC_HERO_MODE
$MISC_INPUT_0	Entrée :
$MISC_INPUT_1	Entrée 1 :
$MISC_INPUT_2	Entrée 1 :
$MISC_INPUT_3	Entrée 1 :
$MISC_INSPECT	inspecter
$MISC_LOAD_ORDER	Ordre de chargement
$MISC_NEW_GAME_SETTINGS	Configuration de la nouvelle partie
$MISC_NO_HARDWARE	Votre système ne supporte pas l’accélération matérielle. Le jeu pourra tout de même s’exécuter, mais vous devrez peut-être réduire la qualité graphique si vous notez des ralentissements.
$MISC_OVERWRITE	Confirmation d'écrasement
$MISC_OVERWRITE2	Écraser « <MODNAME> » ?
$MISC_OVERWRITE_TEXT	Certains mods auxquels vous êtes abonné entrent en conflit avec les versions locales. Les écraser un par un ?
$MISC_OVERWRITE_TEXT2	<SOURCE><N><N>--><N><N><DEST>
$MISC_PAUSE	pause
$MISC_RESTORE_DEFAULTS	Restaurer les paramètres par<N>défaut
$MISC_SAVE_ERROR_TEXT	La sauvegarde automatique a échoué. Vérifiez les permissions de vos fichiers...<N>Nous réessayerons plus tard.
$MISC_SAVE_ERROR_TITLE	Erreur de sauvegarde automatique !
$MISC_SAVE_FIXED_TEXT	La sauvegarde automatique a réussi, vous avez dû corriger ce qui clochait.<N>Nous allons arrêter de vous embêter avec ça.
$MISC_SAVE_FIXED_TITLE	La sauvegarde automatique fonctionne !
$MISC_SELECTED	Sélectionné
$MISC_SLOT	emplacement
$MISC_TITLE_SAFE_TEXT	Déplacez les sticks analogiques jusqu'à ce que toutes les boîtes soient visibles.
$MISC_UNIVERSAL	Universel
$MISC_WARNING	Attention !
$MISC_WAVE_X	Vague <X>
$MISC_WEAPON_PLURAL	<RE>$MISC_WEAPONS
$MISC_WEAPON_SINGULAR	arme
$MISC_XP_TT_TEXT	Le nombre de points d'expérience obtenus après une bataille.<N><RE>[$MISC_ADJUST_REWARDS]
$MISC_XP_TT_TITLE	Expérience
$NEW_GAME_PLUS_NOTE	Depuis le menu Sauvegarde, sélectionnez NOUVELLE PARTIE+ sur votre ancien emplacement de sauvegarde.
$PS3_A	<RE>$PS4_A
$PS3_B	<RE>$PS4_B
$PS3_BACK	Touche SELECT (sélection)
$PS3_DPAD	<RE>$PS4_DPAD
$PS3_DPAD_DOWN	<RE>$PS4_DPAD_DOWN
$PS3_DPAD_LEFT	<RE>$PS4_DPAD_LEFT
$PS3_DPAD_RIGHT	<RE>$PS4_DPAD_RIGHT
$PS3_DPAD_UP	<RE>$PS4_DPAD_UP
$PS3_EMPTY	<RE>$PS4_EMPTY
$PS3_LEFT_ANALOG_STICK	<RE>$PS4_LEFT_ANALOG_STICK
$PS3_LEFT_ANALOG_STICK_X_MINUS	<RE>$PS4_LEFT_ANALOG_STICK_X_MINUS
$PS3_LEFT_ANALOG_STICK_X_PLUS	<RE>$PS4_LEFT_ANALOG_STICK_X_PLUS
$PS3_LEFT_ANALOG_STICK_Y_MINUS	<RE>$PS4_LEFT_ANALOG_STICK_Y_MINUS
$PS3_LEFT_ANALOG_STICK_Y_PLUS	<RE>$PS4_LEFT_ANALOG_STICK_Y_PLUS
$PS3_LEFT_SHOULDER	<RE>$PS4_LEFT_SHOULDER
$PS3_LEFT_STICK_CLICK	Touche L3
$PS3_LEFT_TRIGGER	<RE>$PS4_LEFT_TRIGGER
$PS3_RIGHT_ANALOG_STICK	<RE>$PS4_RIGHT_ANALOG_STICK
$PS3_RIGHT_ANALOG_STICK_X_MINUS	<RE>$PS4_RIGHT_ANALOG_STICK_X_MINUS
$PS3_RIGHT_ANALOG_STICK_X_PLUS	<RE>$PS4_RIGHT_ANALOG_STICK_X_PLUS
$PS3_RIGHT_ANALOG_STICK_Y_MINUS	<RE>$PS4_RIGHT_ANALOG_STICK_Y_MINUS
$PS3_RIGHT_ANALOG_STICK_Y_PLUS	<RE>$PS4_RIGHT_ANALOG_STICK_Y_PLUS
$PS3_RIGHT_SHOULDER	<RE>$PS4_RIGHT_SHOULDER
$PS3_RIGHT_STICK_CLICK	Touche R3
$PS3_RIGHT_TRIGGER	<RE>$PS4_RIGHT_TRIGGER
$PS3_START	Touche START (mise en marche)
$PS3_X	<RE>$PS4_X
$PS3_Y	<RE>$PS4_Y
$PS4_A	Touche croix
$PS4_B	Touche cercle
$PS4_X	Touche carré
$PS4_Y	Touche triangle
$PS4_BACK	Touche SHARE
$PS4_BACK_PS4	Touche pavé tactile
$PS4_START	Touche OPTIONS
$PS4_LEFT_SHOULDER	Touche L1
$PS4_RIGHT_SHOULDER	Touche R1
$PS4_LEFT_TRIGGER	Touche L2
$PS4_RIGHT_TRIGGER	Touche R2
$PS4_DPAD	Touches directionnelles
$PS4_DPAD_DOWN	Touche bas
$PS4_DPAD_LEFT	Touche gauche
$PS4_DPAD_RIGHT	Touche droite
$PS4_DPAD_UP	Touche haut
$PS4_LEFT_ANALOG_STICK	Joystick gauche
$PS4_LEFT_ANALOG_STICK_X_MINUS	Joystick gauche, vers la GAUCHE
$PS4_LEFT_ANALOG_STICK_X_PLUS	Joystick gauche, vers la DROITE
$PS4_LEFT_ANALOG_STICK_Y_MINUS	Joystick gauche, vers le HAUT
$PS4_LEFT_ANALOG_STICK_Y_PLUS	Joystick gauche, vers le BAS
$PS4_LEFT_STICK_CLICK	Touche L3
$PS4_RIGHT_ANALOG_STICK	Joystick droit
$PS4_RIGHT_ANALOG_STICK_X_MINUS	Joystick droit, vers la GAUCHE
$PS4_RIGHT_ANALOG_STICK_X_PLUS	Joystick droit, vers la DROITE
$PS4_RIGHT_ANALOG_STICK_Y_MINUS	Joystick droit, vers le HAUT
$PS4_RIGHT_ANALOG_STICK_Y_PLUS	Joystick droit, vers le BAS
$PS4_RIGHT_STICK_CLICK	Touche R3
$PS4_EMPTY	<RE>$GAMEPAD_EMPTY
$PSVITA_A	<RE>$PS4_A
$PSVITA_B	<RE>$PS4_B
$PSVITA_BACK	Touche SELECT
$PSVITA_DPAD	<RE>$PS4_DPAD
$PSVITA_DPAD_DOWN	<RE>$PS4_DPAD_DOWN
$PSVITA_DPAD_LEFT	<RE>$PS4_DPAD_LEFT
$PSVITA_DPAD_RIGHT	<RE>$PS4_DPAD_RIGHT
$PSVITA_DPAD_UP	<RE>$PS4_DPAD_UP
$PSVITA_EMPTY	<RE>$PS4_EMPTY
$PSVITA_LEFT_ANALOG_STICK	<RE>$PS4_LEFT_ANALOG_STICK
$PSVITA_LEFT_ANALOG_STICK_X_MINUS	<RE>$PS4_LEFT_ANALOG_STICK_X_MINUS
$PSVITA_LEFT_ANALOG_STICK_X_PLUS	<RE>$PS4_LEFT_ANALOG_STICK_X_PLUS
$PSVITA_LEFT_ANALOG_STICK_Y_MINUS	<RE>$PS4_LEFT_ANALOG_STICK_Y_MINUS
$PSVITA_LEFT_ANALOG_STICK_Y_PLUS	<RE>$PS4_LEFT_ANALOG_STICK_Y_PLUS
$PSVITA_LEFT_SHOULDER	<RE>$PS4_LEFT_SHOULDER
$PSVITA_LEFT_STICK_CLICK	<RE>$GAMEPAD_LEFT_STICK_CLICK
$PSVITA_LEFT_TRIGGER	<RE>$PS4_LEFT_TRIGGER
$PSVITA_RIGHT_ANALOG_STICK	<RE>$PS4_RIGHT_ANALOG_STICK
$PSVITA_RIGHT_ANALOG_STICK_X_MINUS	<RE>$PS4_RIGHT_ANALOG_STICK_X_MINUS
$PSVITA_RIGHT_ANALOG_STICK_X_PLUS	<RE>$PS4_RIGHT_ANALOG_STICK_X_PLUS
$PSVITA_RIGHT_ANALOG_STICK_Y_MINUS	<RE>$PS4_RIGHT_ANALOG_STICK_Y_MINUS
$PSVITA_RIGHT_ANALOG_STICK_Y_PLUS	<RE>$PS4_RIGHT_ANALOG_STICK_Y_PLUS
$PSVITA_RIGHT_SHOULDER	<RE>$PS4_RIGHT_SHOULDER
$PSVITA_RIGHT_STICK_CLICK	<RE>$GAMEPAD_RIGHT_STICK_CLICK
$PSVITA_RIGHT_TRIGGER	<RE>$PS4_RIGHT_TRIGGER
$PSVITA_START	Touche START
$PSVITA_X	<RE>$PS4_X
$PSVITA_Y	<RE>$PS4_Y
$SAVE_SLOT_DELETE_TEXT	Supprime définitivement cette sauvegarde de votre ordinateur. Vous savez ce que vous faites, n’est-ce pas ?
$SAVE_SLOT_DELETE_TITLE	Supprimer la sauvegarde
$SAVE_SLOT_EXPORT_TEXT	Faire une copie de votre sauvegarde vers un fichier texte.
$SAVE_SLOT_EXPORT_TITLE	Exporter la sauvegarde vers un fichier
$SAVE_SLOT_IMPORT_TEXT	Chercher un fichier de sauvegarde de Defender’s Quest sur votre ordinateur.
$SAVE_SLOT_IMPORT_TITLE	Importer une sauvegarde depuis un fichier
$SAVE_SLOT_NEW_GAME_PLUS_TEXT	Lance une nouvelle quête bien plus difficile, en conservant toute vote expérience, vos compétences et votre équipement. La Nouvelle partie+ comporte de nouveaux types d’ennemis, de nouvelles quêtes secondaires, de l’équipement plus puissant, et un journal beaucoup plus détaillé.<N><N>NOTE : la progression de votre équipe est PARTAGÉE entre votre partie originale et la Nouvelle partie+. Vous pouvez donc librement passer de l’une à l’autre sans rien perdre.
$SAVE_SLOT_NEW_GAME_PLUS_TITLE	Commencer une Nouvelle partie+
$SAVE_SLOT_PLAY_PLUS_TEXT	La progression de votre équipe est PARTAGÉE entre votre partie originale et la Nouvelle partie+. Vous pouvez donc librement passer de l’une à l’autre sans rien perdre.
$SAVE_SLOT_PLAY_PLUS_TITLE	Reprendre la Nouvelle partie+
$SHOP_EQUIP	<RE>$MISC_EQUIP
$SKILL_DESC_SPECIAL	Spécial
$SKILL_DESC_SPLASH	Explosion
$SOFT_KEYBOARD_BACKSPACE	Effacement arrière
$SOFT_KEYBOARD_CLEAR	Suppr
$SOFT_KEYBOARD_SPACE	Espace
$UI_ACCESS_FAILURE_PENALTY	Pénalité d’échec
$UI_CONFLICT_CONSOLE	CONSOLE
$UI_CONTROLS_GAMEPAD_ACTION_SET	Action configurée
$UI_CONTROLS_GAMEPAD_ICONS	Icônes
$UI_CONTROLS_INERTIA	Inertie
$UI_CONTROLS_PSVITA	Playstation Vita
$UI_CONTROLS_STEAM_CONTROLLER	Steam Controller
$UI_CONTROLS_STEAM_CONTROLLER_CONFIG	Configuration
$UI_CONTROLS_STEAM_CONTROLLER_CONFIG_FAIL_TEXT	Impossible d'ouvrir l'écran de configuration : Steam est-il en mode Big Picture, et l'overlay Steam fonctionne-t-il ?
$UI_CONTROLS_STEAM_CONTROLLER_CONFIG_FAIL_TITLE	Erreur Steam !
$UI_DEMO_IMPORT_OPTIONS	Importer les paramètres depuis la démo ?
$UI_DEMO_OPTIONS_DETECTED	Paramètres de la démo détectés !
$UI_LEGACY_IMPORT_SAVES	Importer les sauvegardes depuis une ancienne version de Defender’s Quest ?
$UI_LEGACY_SAVES_DETECTED	Anciennes sauvegardes détectées !
$UI_LEGAL_TITLE	Légal
$UI_MOD_DOWNLOAD_TEXT	
$UI_MOD_LATER	Plus tard
$XBOX360_A	Touche A
$XBOX360_B	Touche B
$XBOX360_X	Touche X
$XBOX360_Y	Touche Y
$XBOX360_BACK	Touche BACK
$XBOX360_DPAD	Bouton multidirectionnel
$XBOX360_DPAD_DOWN	Bouton multidirectionnel bas
$XBOX360_DPAD_LEFT	Bouton multidirectionnel gauche
$XBOX360_DPAD_RIGHT	Bouton multidirectionnel droit
$XBOX360_DPAD_UP	Bouton multidirectionnel haut
$XBOX360_EMPTY	<RE>$GAMEPAD_EMPTY
$XBOX360_LEFT_ANALOG_STICK	Stick analogique gauche
$XBOX360_LEFT_ANALOG_STICK_X_MINUS	Stick analogique gauche, vers la GAUCHE
$XBOX360_LEFT_ANALOG_STICK_X_PLUS	Stick analogique gauche, vers la DROITE
$XBOX360_LEFT_ANALOG_STICK_Y_MINUS	Stick analogique gauche, vers le HAUT
$XBOX360_LEFT_ANALOG_STICK_Y_PLUS	Stick analogique gauche, vers le BAS
$XBOX360_LEFT_SHOULDER	Gâchette haute gauche
$XBOX360_LEFT_STICK_CLICK	Stick analogique gauche (appuyer)
$XBOX360_LEFT_TRIGGER	Gâchette gauche
$XBOX360_RIGHT_ANALOG_STICK	Stick analogique droit
$XBOX360_RIGHT_ANALOG_STICK_X_MINUS	Stick analogique droit, vers la GAUCHE
$XBOX360_RIGHT_ANALOG_STICK_X_PLUS	Stick analogique droit, vers la DROITE
$XBOX360_RIGHT_ANALOG_STICK_Y_MINUS	Stick analogique droit, vers le HAUT
$XBOX360_RIGHT_ANALOG_STICK_Y_PLUS	Stick analogique droit, vers le BAS
$XBOX360_RIGHT_SHOULDER	Gâchette haute droite
$XBOX360_RIGHT_STICK_CLICK	Stick analogique droit (appuyer)
$XBOX360_RIGHT_TRIGGER	Gâchette droite
$XBOX360_START	Touche START
$XBOXONE_A	Touche A
$XBOXONE_B	Touche B
$XBOXONE_X	Touche X
$XBOXONE_Y	Touche Y
$XBOXONE_BACK	Touche Affichage
$XBOXONE_DPAD	BMD
$XBOXONE_DPAD_DOWN	BMD bas
$XBOXONE_DPAD_LEFT	BMD gauche
$XBOXONE_DPAD_RIGHT	BMD droit
$XBOXONE_DPAD_UP	BMD haut
$XBOXONE_EMPTY	<RE>$GAMEPAD_EMPTY
$XBOXONE_LEFT_ANALOG_STICK	Stick analogique gauche
$XBOXONE_LEFT_ANALOG_STICK_X_MINUS	Stick analogique gauche, vers la GAUCHE
$XBOXONE_LEFT_ANALOG_STICK_X_PLUS	Stick analogique gauche, vers la DROITE
$XBOXONE_LEFT_ANALOG_STICK_Y_MINUS	Stick analogique gauche, vers le HAUT
$XBOXONE_LEFT_ANALOG_STICK_Y_PLUS	Stick analogique gauche, vers le BAS
$XBOXONE_LEFT_SHOULDER	Gâchette haute gauche
$XBOXONE_LEFT_STICK_CLICK	Stick analogique gauche (appuyer)
$XBOXONE_LEFT_TRIGGER	Gâchette gauche
$XBOXONE_RIGHT_ANALOG_STICK	Stick analogique droit
$XBOXONE_RIGHT_ANALOG_STICK_X_MINUS	Stick analogique droit, vers la GAUCHE
$XBOXONE_RIGHT_ANALOG_STICK_X_PLUS	Stick analogique droit, vers la DROITE
$XBOXONE_RIGHT_ANALOG_STICK_Y_MINUS	Stick analogique droit, vers le HAUT
$XBOXONE_RIGHT_ANALOG_STICK_Y_PLUS	Stick analogique droit, vers le BAS
$XBOXONE_RIGHT_SHOULDER	Gâchette haute droite
$XBOXONE_RIGHT_STICK_CLICK	Stick analogique droit (appuyer)
$XBOXONE_RIGHT_TRIGGER	Gâchette droite
$XBOXONE_START	Touche Menu
$YOU_GOT_NEW_GAME_PLUS_TEXT	Félicitations ! Vous pouvez désormais vous lancer dans une nouvelle aventure avec votre ancienne équipe!<N><N>Affrontez des ennemis mutants dotés de nouvelles capacités, imprégnez votre équipement de nouveaux pouvoirs étonnants, et remplissez votre bibliothèque d’un tas de nouveaux livres. Accomplissez de nombreuses quêtes secondaires avec de nouvelles histoires et de nouvelles cinématiques, déverrouillez le commentaire du développeur, découvrez la traduction des paroles d’Eztli-Tenoch, rencontrez de nouveaux personnages, et bien plus !<N><N><RE>[$NEW_GAME_PLUS_NOTE]<N><N>Vous pourrez revenir à votre partie <LQ>normale<RQ> à tout moment.
$YOU_GOT_NEW_GAME_PLUS_TITLE	Nouvelle partie+ déverrouillée !
$MISC_NO_SIGN_IN_WARNING	Votre progression ne sera pas sauvegardée si vous n'êtes pas connecté.
$MISC_NEW_USER	Nouvel utilisateur