flag	content
$ENTRY_JOURNAL_INDEX_TITLE	Содержание
$ENTRY_JOURNAL2_INDEX_TITLE	СЕКРЕТ
$ENTRY_JOURNAL_INDEX_LEFT_00	Записи в журнале
$ENTRY_JOURNAL_INDEX_LEFT_10	День 1: @Где я?@
$ENTRY_JOURNAL_INDEX_LEFT_20	Ночь 1: @[berserker_hero]@
$ENTRY_JOURNAL_INDEX_LEFT_30	День 3: @Дополнение@
$ENTRY_JOURNAL_INDEX_LEFT_40	Ночь 3: @Дополнение@
$ENTRY_JOURNAL_INDEX_LEFT_50	День 3: @Тюрьма@
$ENTRY_JOURNAL_INDEX_LEFT_60	День 4: @Промежуточный мир@
$ENTRY_JOURNAL_INDEX_LEFT_61	День 4: @Образование@
$ENTRY_JOURNAL_INDEX_LEFT_62	День 4: @Учет книг@
$ENTRY_JOURNAL_INDEX_LEFT_70	День 5: @[ranger_hero]@
$ENTRY_JOURNAL_INDEX_LEFT_80	День 8: @Дополнение@
$ENTRY_JOURNAL_INDEX_LEFT_90	Ночь 7: @Сожжение Карска@
$ENTRY_JOURNAL_INDEX_LEFT_100	День 8: @Лаксос@
$ENTRY_JOURNAL_INDEX_LEFT_101	День 9: @Путешествия@
$ENTRY_JOURNAL_INDEX_LEFT_110	День 9: @[mcguffin_hero]@
$ENTRY_JOURNAL_INDEX_LEFT_120	День 10: @Смерть Озимала@
$ENTRY_JOURNAL_INDEX_LEFT_130	Ночь 10: @Монастырь@
$ENTRY_JOURNAL_INDEX_LEFT_140	День 11: @[healer_hero]@
$ENTRY_JOURNAL_INDEX_LEFT_141	День 11: @Каркасская рукопись@
$ENTRY_JOURNAL_INDEX_LEFT_150	День 13: @[mage_hero]@
$ENTRY_JOURNAL_INDEX_LEFT_160	День 14: @Кочевники@
$ENTRY_JOURNAL_INDEX_LEFT_170	День 15: @Странный сон@
$ENTRY_JOURNAL_INDEX_LEFT_171	Ночь 15: @Странные слова@
$ENTRY_JOURNAL_INDEX_RIGHT_01	День 16: @Грозные слова о шрамах на губах@
$ENTRY_JOURNAL_INDEX_RIGHT_00	День 17: @Сокровище пустыни@
$ENTRY_JOURNAL_INDEX_RIGHT_02	Ночь 17: @Лиса@
$ENTRY_JOURNAL_INDEX_RIGHT_10	День 18: @[knight_hero]@
$ENTRY_JOURNAL_INDEX_RIGHT_20	День 19: @Письмо от [knight_hero]@
$ENTRY_JOURNAL_INDEX_RIGHT_30	Ночь 19: @Мой ответ: Черновик 1@
$ENTRY_JOURNAL_INDEX_RIGHT_40	День 20: @Ответ от [knight_hero_pos]@
$ENTRY_JOURNAL_INDEX_RIGHT_50	День 21: @Письмо от <LQ>[knight_hero_up]<RQ>@
$ENTRY_JOURNAL_INDEX_RIGHT_60	Ночь 21: @Внимание: [berserker_hero]@
$ENTRY_JOURNAL_INDEX_RIGHT_70	Ночь 22: @[dragon_hero]@
$ENTRY_JOURNAL_INDEX_RIGHT_71	День 23: @Речь@
$ENTRY_JOURNAL_INDEX_RIGHT_72	День 24: @Головорез@
$ENTRY_JOURNAL_INDEX_RIGHT_73	День 24: @Смерть супер-овцы@
$ENTRY_JOURNAL_INDEX_RIGHT_80	День 24: @Дополнение@
$ENTRY_JOURNAL_INDEX_RIGHT_81	День 25: @Ахинея@
$ENTRY_JOURNAL_INDEX_RIGHT_90	День 25: @Второй сон@
$ENTRY_JOURNAL_INDEX_RIGHT_91	День 26: @История [mage_hero_pos]@
$ENTRY_JOURNAL_INDEX_RIGHT_92	День 27: @Зло внутри@
$ENTRY_JOURNAL_INDEX_RIGHT_93	День 27: @История [knight_hero_pos]@
$ENTRY_JOURNAL_INDEX_RIGHT_100	День 28: @Смерть Зелемира@
$ENTRY_JOURNAL_INDEX_RIGHT_110	День 29: @Третий сон@
$ENTRY_JOURNAL_INDEX_RIGHT_117	День 30: @Сон и безумие@
$ENTRY_JOURNAL_INDEX_RIGHT_111	День 32: @Императрица@
$ENTRY_JOURNAL_INDEX_RIGHT_112	День 33: @Черная мантия@
$ENTRY_JOURNAL_INDEX_RIGHT_113	День 33: @Четвертый сон@
$ENTRY_JOURNAL_INDEX_RIGHT_114	День 34: @держись подальше от моего дневника@
$ENTRY_JOURNAL_INDEX_RIGHT_115	День 34: @Пятый сон@
$ENTRY_JOURNAL_INDEX_RIGHT_116	День 35: @Шестой сон@
$ENTRY_JOURNAL_INDEX_RIGHT_120	День 35: @Трон Эзтли@
$ENTRY_JOURNAL_INDEX_RIGHT_121	День 36: @Энви@
$ENTRY_JOURNAL_INDEX_RIGHT_130	День 37: @Тлетл-Мезтли@
$ENTRY_JOURNAL_INDEX_RIGHT_131	День 38: @Мир?@
$ENTRY_JOURNAL_INDEX_RIGHT_132	День 38: @Прощальный сон@
$ENTRY_JOURNAL_INDEX_RIGHT_140	День 39: @Побег?@
$ENTRY_JOURNAL_INDEX_RIGHT_150	День 40: @За Зелемиром@
$ENTRY_JOURNAL_INDEX_RIGHT_160	@Эпилог@
$ENTRY_JOURNAL_INDEX_RIGHT_170	@Дополнение@
$ENTRY_JOURNAL_INTRO_TITLE	
$ENTRY_JOURNAL_INTRO_LEFT_00	День 1 - Где я?
$ENTRY_JOURNAL_INTRO_LEFT_10	Я, наверное, сошла с ума, но тем не менее я попытаюсь записать события, которые предстают перед моими глазами. Читатель может сделать свои выводы; я сообщаю только о тех событиях, которые еще могу разобрать своим помутневшим рассудком.<N>Я знаю наверняка, что заразилась чумой, которая разоряет нашу прекрасную столицу. Я знаю точно, что я, как и другие жертвы до меня, была вывезена из города и брошена в преисподнюю. Оттуда началась такая странная и ужасающая серия событий, что я все еще задаюсь вопросом, сплю ли я или мне все это грезится.<N>Когда лихорадка взяла надо мной верх, я оказалась в темном месте. Прежде чем стала очередной жертвой.<N>
$ENTRY_JOURNAL_INTRO_RIGHT_00	Здесь появился великолепный трон, и на нем восседал человек, которого я раньше никогда не видела. Он был полностью из золота. Я сначала подумала, что это статуя, но он произнес команду.<N>Его голос тоже был золотым, и его грани звучали с силой грома. Этот язык не был похож на те, которые я слышала или изучала в великой библиотеке Эшей, но мое тело вскочило как по команде. Мои вены напряжены, как будто кровь вот-вот вырвется из моего тела и поспешит присоединиться к нему.<N>У меня разрывается сердце лишь при мысли об этом.<N>-[mcguffin_hero] Ливбар
$ENTRY_JOURNAL_SLAK_TITLE	
$ENTRY_JOURNAL_SLAK_LEFT_0_00	Ночь 1 - [berserker_hero]
$ENTRY_JOURNAL_SLAK_LEFT_0_10	Когда я решила писать про [berserker_hero], то осознала, что придется отбросить строгий язык столицы и использовать жаргон, более подходящий этому индивиду.<N>[berserker_hero] – полный придурок. Он придурок, к тому же полный.<N>Недостаток интеллекта он восполняет запахом. Если две горящие навозные кучи могли бы спариваться и произвести на свет потомство, то их гнилое потомство испугалось бы зловония, которое исходит из подмышек [berserker_hero]. Разумеется, преследующие нас ожившие трупы пахнут словно изысканные духи по сравнению с ним.<N>Но [berserker_hero] не просто красивая мордашка. Он еще и самая притягательная личность, которую я могу описать как <LQ>тупой как пробка.<RQ> Вчера он спорил в течение пятнадцати минут со скалой, об которую он ударился ногой. И он проиграл.
$ENTRY_JOURNAL_SLAK_RIGHT_0_00	Честно говоря, мне повезло путешествовать в такой компании.
$ENTRY_JOURNAL_SLAK_RIGHT_0_10	<N>День 3 - дополнение
$ENTRY_JOURNAL_SLAK_RIGHT_0_20	<N>В интересах справедливости я должна признаться, что он самый храбрый человек, которого я когда-либо видела. Все его тело покрыто паутиной шрамов, хотя это мало меня удивляет, если вспомнить, что он отказывается носить одежду или броню. Полагаю, суть в том, что он и невыносимый болван, и невероятно опытный воин, и я вынуждена признать, что рада его присутствию.
$ENTRY_JOURNAL_SLAK_RIGHT_0_30	<N>АХ-Х-Х! Я ТОЖЕ ТЕБЯ ЛЮБЛЮ! ХО-ХО-ХО<N><N><N><N>Я НЕ СПЛЮ. ПРОСТО ЛЕЖУ, РАЗМИНАЮ ЯГОДИЦЫ
$ENTRY_JOURNAL_SLAK_RIGHT_0_40	<N>Кроме того, очевидно, что он может читать и писать! Где, черт побери, этот кровожадный бродяга получил образование?<N><N><N>P.S. Если ты когда-нибудь украдешь мой журнал снова, я размозжу тебе голову, пока ты будешь спать..
$ENTRY_JOURNAL_SLAK_LEFT_1_00	Ночь 3 - дополнение второе
$ENTRY_JOURNAL_SLAK_LEFT_1_10	Итак, для протокола, [berserker_hero] спит голым. Все попытки мести будут проходить в течение дня, начиная с этого момента.<N>И еще, шрамы не заканчиваются на талии.<N><N><N><N><N><N>Я тебя ненавижу.
$ENTRY_JOURNAL_SLAK_LEFT_1_20	<N>А ТЫ ДУМАЕШЬ ЧТО ХАН И ХАРИССА НЕ СРАЖАЮТСЯ ВМЕСТЕ СО МНОЙ?
$ENTRY_JOURNAL_PRISON_TITLE	
$ENTRY_JOURNAL_PRISON_LEFT_0_00	День 3 - Тюрьма
$ENTRY_JOURNAL_PRISON_LEFT_0_10	Три дня назад я думала, что преисподняя - это тюрьма. Теперь я уверена, что даже в аду намного хуже.<N>Человека, держащего нас, называют Озимал Каз. Он жестокий, мелкий, отвратительный человек. Я не в силах понять, как мой соотечественник мог стать неисправимым извергом.<N>Я могла ожидать такое от Куэйдов, которые провели последние два десятилетия, совершенствуя свою жестокость в восточных областях. Даже самый безжалостный из вождей кочевников умерил бы гнев своей крови быстрее, чем эти выродки.<N>И он из столицы, судя по акценту! Этот монстр вырос в тени самого храма!<N>
$ENTRY_JOURNAL_PRISON_RIGHT_0_00	Я сижу здесь с другими пленниками, схваченными без разбора: бандиты и разбойники, мужчины, женщины, дети, Эши, кочевники, Куэйды, всех нас ожидает смерть от рук этого человека.<N>Днем и ночью мы слышали непрекращающиеся стоны его пленных загробников, оглушительную какофонию, прерываемую только предсмертными криками последней жертвы. И я не способна ничего сделать! Если бы я только была в Колизее с этими несчастными жертвами, у них хотя бы был шанс в сражении.<N>При всем своем хвастовстве, Озимал выглядел нерешительным в вопросе второй <LQ>расправы<RQ> надо мной.  Возможно, он боялся потерять слишком много загробников. Наверняка создавать и поддерживать их - нелегкий труд, а его маленькая империя, похоже, нуждалается в загробниках, чтобы поддерживать верность вассалов.<N>
$ENTRY_JOURNAL_PRISON_LEFT_1_00	Слова моего таинственного помощника постоянно звучат в моей голове. Озимал хочет продемонстрировать мои навыки на <LQ>человеку в красном.<RQ> Кто этот человек в красном? И кто этот таинственный незнакомец, который намерен спасти меня? Почему я так важна?<N>В этом потоке вопросов я уверена в одном: я до сих пор занималась только насилием по отношению к тем, кто уже мертв, но если я когда-либо доберусь до Озимала, над изменением этой политики стоит поразмыслить.
$ENTRY_JOURNAL_HALFWAY_WORLD_TITLE	
$ENTRY_JOURNAL_HALFWAY_WORLD_LEFT_0_00	День 4 - Промежуточный мир
$ENTRY_JOURNAL_HALFWAY_WORLD_LEFT_0_10	<LQ>Промежуточный мир<RQ> - это подходящее слово для места, которое я не могу описать словами, где нахожусь сама и в которое затягиваю других.<N>Однажды, когда я была очень молода, я чуть не утонула, плавая на отмелях Кевели. Это единственный опыт, с которым я могу провести параллели. Здесь та же самая паника, когда задыхаясь в муках, мое сердце пытается вырваться из моей груди. Но на этот раз рука отца не вытащит меня в безопасное место. Здесь нет берега, за который можно цепляться, только мгновение смерти протяженностью в вечность.<N>Суть моего появления в этом месте вне моего понимания. Я лишь знаю, что иду туда, где должна быть. Оказавшись там, я ощущу своих соратников, но не при помощи зрения, а так же, как я чувствую руки, не смотря на них.
$ENTRY_JOURNAL_HALFWAY_WORLD_RIGHT_0_00	Я уверена, что они там и призываю их силой, которой владею. Эта сила мала, и я изучаю эти силы словно беспомощный младенец, передвигающий свое тело, но даже этого достаточно, чтобы спасти мою жизнь. Хоть я и ненавижу странствовать в этом ужасном промежуточном мире, но безусловно, это лучше, чем судьба, которая ожидала меня вне его.
$ENTRY_JOURNAL_AN_EDUCATION_TITLE	
$ENTRY_JOURNAL_AN_EDUCATION_LEFT_0_00	День 4 - Образование
$ENTRY_JOURNAL_AN_EDUCATION_LEFT_0_10	Today, as my mind still swirled with the giddiness of our last victory, my eye was caught by a piece of parchment on the ground. Eager to replenish my own painfully finite supply, I snatched up the abandoned page. I was immediately shocked by its quality. While its edges and creases showed the wear of its journey into the Pit, its thickness and spotless, creamy tone betrayed the wealth from which it originated. This was no pay-scribe's scratch sheet.<N><N>It was at this point that I saw the seal of the Lord Regent. Hungrily, my eyes raced to the opening line:
$ENTRY_JOURNAL_AN_EDUCATION_LEFT_0_20	<LQ>You errant and vagabond wretch scarcely worthy of being called my son,<RQ>
$ENTRY_JOURNAL_AN_EDUCATION_LEFT_0_30	Filled with what Zenimon the Wise termed the <LQ>joy of others' woe,<RQ> I read on with shameful curiosity:
$ENTRY_JOURNAL_AN_EDUCATION_LEFT_0_40	<LQ>Words cannot express my rage. Vashtal reports to me that, on arriving in the land of the Carcassians, he
$ENTRY_JOURNAL_AN_EDUCATION_RIGHT_0_00	discovered you were not in attendance at University, as I had ordered both for your betterment and safety, but rather found an unwashed Nomad heathen masquerading under your name, and studying in your stead. This foul barbarian disclosed that he had been paid a not insignificant sum of gold to receive your education for you, whilst you, no doubt, gallivanted off into the wilderness in search of – <RQ>
$ENTRY_JOURNAL_AN_EDUCATION_RIGHT_0_10	The rest of the text is a mystery to me, for, just at the point that the narrative was waxing especially interesting, [berserker_hero] tore the page from my hand, wadded it into a ball, and ate it while screaming <LQ>It tastes like lies! Lies and dead sheep! But mostly lies!<RQ> directly into my face. His breath leaves much to be desired.<N><N>He then threw a rock at [ranger_hero], and the two launched into a slap-fight lasting half an hour.
$ENTRY_JOURNAL_BOOKKEEPING_TITLE	
$ENTRY_JOURNAL_BOOKKEEPING_LEFT_0_00	День 5 - Учет книг
$ENTRY_JOURNAL_BOOKKEEPING_LEFT_0_10	After freeing the last prisoners from Ozimal's pathetic den, I must confess that I derived a shameful amount of enjoyment from raiding the wretch's personal quarters. His few remaining guards had fled at the sight of our victory over their trained revenant, leaving the petty tyrant's chambers ripe for plunder. We procured as much as we could carry from his private larder, acquiring sausages, oil, and a significant quantity of cheeses to help us on our journey. I would have liked to set fire to the rest, but I feared the resultant smoke would betray our position, and hasten the return of the villain and his army. As if sensing my frustration, [berserker_hero] took it upon himself to <LQ>desecrate<RQ> the remaining foodstuffs. He then went on to desecrate the bed, a large section of the floor, and some of the walls. It was not an act one of my station or sex should approve of, but I find it difficult to not grin when I think of the unpleasant discovery awaiting Ozimal on his return.<N><N>[berserker_hero] must imbibe truly astounding quantities of water.
$ENTRY_JOURNAL_BOOKKEEPING_RIGHT_0_00	Sadly, I find my mirth short-lived. On Ozimal's lecturn, I discovered (just prior to the <LQ>desecration<RQ>) several scraps of parchment which made up the bookkeeping side of his base empire. Going over them now, I see laid out, in most matter-of-fact fashion, the figures of tributes levied, punishments doled out, slaves taken – he writes about human lives as if they were nothing more than smoked hams to line his larder and he a busy merchant.<N><N>One manuscript, in particular, preys upon my mind.
$ENTRY_JOURNAL_BOOKKEEPING_RIGHT_0_10	<LQ>To be procured:<N><N>For the Red Collector – survivors of unusual appearance or ability.<N><N>For the Quaidman – young woman, Quaid, blonde hair, facial scars, possibly with the Selini. Desired dead. Proof required.<N><N>For the Man-Seller – Nomad girls, pretty. Higher price for young.
$ENTRY_JOURNAL_BOOKKEEPING_LEFT_1_00	For Ash contact – proof of Lord Warden's demise.<N><N>For University Philosopher – preserved flesh of infected, skull talismans, related charms.<N><N>For the Black Robes – Ashani survivors, fresh entries preferred.<N><N>For the Carcassian – boy, nomad appearance, white hair, possibly traveling in the company of one identical to himself. Desired dead. Proof required.<RQ>
$ENTRY_JOURNAL_BOOKKEEPING_LEFT_1_10	To see my own fate, which at the time seemed fantastic in its horror, a single item in a list of planned villainies is a sobering experience. I had thought myself a grand exception in my misery. Now I find such things are merely the daily operations of Ozimal's vile enterprise.<N><N>I find most melancholy of all the thought that many of these crimes were to be perpetrated at the behest of parties outside of the Pit. What can this miserable place possibly have to offer the outside world?
$ENTRY_JOURNAL_BOOKKEEPING_RIGHT_1_00	It is a grim time indeed, when men search hell for fresh evils.
$ENTRY_JOURNAL_KETTA_TITLE	
$ENTRY_JOURNAL_KETTA_LEFT_0_00	День 5 - [ranger_hero]
$ENTRY_JOURNAL_KETTA_LEFT_0_10	Больше всего мне нравится в [ranger_hero] то, что от нее несет как от козы.<N>Я имею в виду, что сложно сделать выбор между такими чертами победителя, как необузданная незрелость, постоянные унизительные комментарии, тупой сарказм, склонность к мелкому воровству и ужасные привычки в еде, но когда вы делите с ней палатку, этот резкий запах коз затмевает все выше сказанное.<N>Иногда ночью северный ветер посвистывает со стороны мужской части лагеря, и дуновения ветра приносят легко узнаваемый запах [berserker_hero]. Полученная смесь ароматов может быть описана только как божественная. Именно в такие ночи я крепче всего сплю, так как мое тело предпочитает бессознательный сон, а не попытку постичь благоуханные раздражители, противостоящие моим чувствам.
$ENTRY_JOURNAL_KETTA_RIGHT_0_00	День 8 - дополнение
$ENTRY_JOURNAL_KETTA_RIGHT_0_10	Вчера вечером [ranger_hero] разбудила меня воплями на языке кочевников. Крик примерно переводится как <LQ>Девушка сомнительного морального качества, она моя! <RQ> Затем она вырвала клок моих волос, сунула их под подушку и сразу заснула.<N>Для [ranger_hero] было нетипично извиняться, она дошла до того, что показала, как сплести косу из лошадиной гривы, чтобы спрятать мою лысину. Она утверждает, что не понимает, какой сон мог побудить такую вспышку. Я по-прежнему в недоумении.
$ENTRY_JOURNAL_AZRA_BY_SLAK_TITLE	
$ENTRY_JOURNAL_AZRA_BY_SLAK_LEFT_0_00	День 10 - [mcguffin_hero] отстой!
$ENTRY_JOURNAL_AZRA_BY_SLAK_LEFT_0_10	ТАК ТЫ ДУМАЕШЬ ЧТО ЕСЛИ Я НЕ МОГУ ПРОЧИТАТЬ ТВОЙ КРАСИВЕНЬКИЙ ЯЗЫК ТО Я НЕ УЗНАЮ ЧТО ТЫ ПИСАЛА ОБО МНЕ?<N>НУ ДОГАДАЙСЯ ЧТО, ПРИНЦЕССА! МЫ СОБИРАЕМСЯ НАПИСАТЬ ЗАМЕТКУ В ЖУРНАЛЕ ПРО ТЕБЯ!<N>ЧТО Я МОГУ СКАЗАТЬ О [mcguffin_hero_up]? ТО ЧТО ЕЕ ЛИЦО ТАКОЕ ХУДОЕ ЧТО ОНА ВЫГЛЯДИТ КАК РЫБА! А ЕЩЕ У НЕЕ ШЕЯ СЛИ-И-ИШКОМ ДЛИННАЯ ДЛЯ ТЕЛА.<N>И ЕЕ УШИ ВЫГЛЯДЯТ КАК ВЫСОХШИЕ АБРИКОСЫ. И ЕЕ ВОЛОСЫ СЛОВНО СОЛОМА. И ЕЕ ПЕРСОНАЛЬНАЯ ГИГИЕНА СОВСЕМ НЕ ТАК БЛИЗКА К СОВЕРШЕНСТВУ КАК ОНА СЧИТАЕТ.
$ENTRY_JOURNAL_AZRA_BY_SLAK_RIGHT_0_00	КАК ТЕБЕ ТАКОЙ ПОВОРОТ, ЛОХУШКА? ПОЛАГАЮ ТЕПЕРЬ Я ЗНАЮ КТО НА САМОМ ДЕЛЕ МОИ ДРУЗЬЯ.<N>С НАИЛУЧШИМИ ПОЖЕЛАНИЯМИ,<N>[ranger_hero_up] КОТОРАЯ ЛЮБИТ ПОЖРАТЬ ДЕРЬМА И [berserker_hero_up] ПОЧЕМУ МОЕ ИМЯ ТАК ДОЛГО ПИСАТЬ?
$ENTRY_JOURNAL_KARSK_BURNED_TITLE	
$ENTRY_JOURNAL_KARSK_BURNED_LEFT_0_00	Ночь 7 - Сожжение Карска
$ENTRY_JOURNAL_KARSK_BURNED_LEFT_0_10	Смерть была повсюду. Последние девять месяцев чумы в столице стерли мою детскую неосведомленность о происходящем, обусловленную моим привилегированным положением. Но я никогда раньше не видела такого жестокого уничтожения. Даже костры трупов за воротами Храма не могли с этим сравниться.<N>У меня нет слов.<N>Я кое-что поняла о природе нашего врага.
$ENTRY_JOURNAL_LAKSOS_TITLE	
$ENTRY_JOURNAL_LAKSOS_LEFT_0_00	День 8 - Лаксос
$ENTRY_JOURNAL_LAKSOS_LEFT_0_10	Мы стали свидетелями странного ритуала кочевников во время прибывания в Лаксосе. Родился ребенок у главы Карада, небольшого, но все еще процветающего племени. Родители представили ребенка перед двумя большими деревянными идолами.<N>Глава достал небольшой кусочек дерева, который он возложил на голову каждому идолу, а потом и на голову ребенку. Затем он достал маленький нож и начал вырезать блок, позволяя стружке падать на лицо младенца. Закончив свою работу, он протянул сквозь резьбу сухожилие животного и надел на шею ребенка.<N>Прозвучал сильный вопль, и внезапно все соплеменники начали танцевать, петь и праздновать в обычной манере перепалок кочевников. Я так и не смогла разглядеть, что вырезал глава.
$ENTRY_JOURNAL_LAKSOS_RIGHT_0_00	Позже я спросила [ranger_hero], что означал тот ритуал, и она вытащила небольшую деревянную лисицу, висящую на ее шее. Она сказала, что этот дух был слугой богов ее племени, данный при рождении в качестве защитника и гида, и будет похоронен с ней, когда она умрет, чтобы гарантировать безопасный проход в рай. Подобно тому, как боги племени были закреплены Творцом в момент происхождения племени, так и личные духи были даны каждому члену племени при рождении.<N>Я спросила [ranger_hero], будет ли столь же ужасна потеря личного идола для человека, как и потеря идола для племени. Она улыбнулась и показала мне семь снятых с врагов идолов, объяснив, что теперь их души потратят много веков, пытаясь найти рай самостоятельно. Я спросила, не беспокоит ли ее столь ужасное обращение со своими соплеменниками, а она смерила меня ледяным взглядом и спросила, не беспокоят ли меня мои большие уши, а затем ушла петь о еде на козлином языке. Когда-нибудь я размозжу ей голову камнем.
$ENTRY_JOURNAL_JOURNEYS_TITLE	
$ENTRY_JOURNAL_JOURNEYS_LEFT_0_00	День 9 - Путешествия
$ENTRY_JOURNAL_JOURNEYS_LEFT_0_10	I am growing more skilled at walking and writing simultaneously. There is little else to do as we journey, save listen to the endless prattling of my companions, or think on the terrifying mystery of the enemy that pursues us – two activities from which I would welcome any distraction. Hence, this journal.<N><N>I had never fancied myself a traveler; all of my 23 years were occupied in the capitol and its surrounding locales. My childish wanderlust was sated by the written word.<N><N>In those idle moments of daydream when I did entertain fantasies of travel, I always thought it would be to our Western brethren. How interesting it would be to follow the Temple pilgrims on their homeward journey, men of the mountains, dark as Nomads, and beyond them men darker still, people of the sea, all united by the way of Selinadt. Seven kingdoms bound together by the truth of the Fountain.<N><N>If I sought the fear and excitement of heathen lands, I
$ENTRY_JOURNAL_JOURNEYS_RIGHT_0_00	needed only to look at the great map of Kezmir Zentbar's travels that hung across the library's north wall. There, my eager eyes could journey to the North, into the realm of the Carcassians, who we speak of as a single people, but are so many and varied that Gozal the Elder claimed any three of their city states would feel as different as Ash, Quaid, and Nomad. And beyond them the heathen of the heathens, the fantastical terrors of unknown shores, and the great mountain on which Kezmir inscribed the legend <LQ>Here there live the eaters of the moon.<RQ><N><N>What a dismal comparison my current journey makes, here on the doorstep of Ash, where all things familiar turn grim and terrible.
$ENTRY_JOURNAL_OZIMAL_DEAD_TITLE	
$ENTRY_JOURNAL_OZIMAL_DEAD_LEFT_0_00	День 10 - Смерть Озимала
$ENTRY_JOURNAL_OZIMAL_DEAD_LEFT_0_10	Я думала, что получу небольшое удовлетворение от смерти Озимала. Увы, нет.<N>Он был не более чем трупом со стеклянными глазами, неуклюже прогнувшимся под волей нашего врага, пешкой до самой смерти. Земля избавлена от злого, жестокого человека. Но кто заметит это в преисподней?
$ENTRY_JOURNAL_MONASTERY_TITLE	
$ENTRY_JOURNAL_MONASTERY_LEFT_0_00	Ночь 10 - Монастырь
$ENTRY_JOURNAL_MONASTERY_LEFT_0_10	Я предполагаю, что было глупо с моей стороны ожидать что что-то в преисподней, могло бы напомнить мне дом, но я была потрясена, увидев здесь монастырь Селини. Это внушительное, зловещее строение, больше походило на крепость, чем на храм. Я понимаю все эти меры предосторожности, но это трудно сочетается с Храмом фонтана, в котором я выросла, где даже охранники при себе имеют дубины, чтобы никто не сеял хаос и разрушение в месте рождения гармонии.<N>Обнадеживало то, что окунув руки в фонтан, я знала, что я стояла в том же месте, что и каждый верующий до меня, возвращавшийся к самому Селинадту. Здесь я была покорной слугою, отделенным от царей и пророков не чем иным, как временем.<N><LQ>Подобно тому, как вода превращается в туман над
$ENTRY_JOURNAL_MONASTERY_RIGHT_0_00	долиной, выпадает в виде снега в горах, реки врываются в моря, так же и каждый человек, рожденный той же сущностью, должен служить различным ролям своего времени и месту, и так достичь гармонии в небесной машине.<RQ><N>Интересно, какая роль отведена мне в этом беззаконном и ужасном месте, где гармония и мудрость кажутся далекой фантазией.<N>В этом храме-крепости чувствуешь себя в безопасности. Но какая цель у этих монахов? Эти внушительные стены и боевые укрепления являются не более, чем приспособлением, которые позволяют служить духу Селинадта здесь, в этом месте беззакония.<N>Как говорил великий человек, <LQ>истина остается истиной, на каком бы языке она не была написана.<RQ> Эти средства защиты являются не более чем языком преисподней; истина внутри остается истиной.<RQ>
$ENTRY_JOURNAL_BAKAL_TITLE	
$ENTRY_JOURNAL_BAKAL_LEFT_0_00	День 11 - Старец [healer_hero]
$ENTRY_JOURNAL_BAKAL_LEFT_0_10	Преподобный старец [healer_hero] является оазисом здравомыслия в этом логове хаоса. Хотя скорость нашего бегства оставляет мало времени для разговора, те несколько слов, которыми я с ним перекинулась, сильно подняли мне настроение.<N>Хотела бы я сделать для него то же самое. Его мучает какая-то внутренняя тоска. Я вижу это снова и снова в загорелом лице спокойного монаха. Совершенно очевидно, что он когда-то был солдатом: шрамы, осанка и манеры - все это указывает на жизнь воина.<N>В монастыре я узнала, что он не принадлежит к духовенству, несмотря на то, что все называют его преподобный старец. На самом деле, он не занимает руководящую должность, по крайней мере, официально. Тем не менее, его сверстники регулярно обращаются и прислушиваются к нему, как если бы он был начальником. Сам отец-настоятель по сравнению с ним кажется простым послушником.<N>
$ENTRY_JOURNAL_BAKAL_RIGHT_0_00	Сам отец-настоятель по сравнению с ним кажется простым послушником. <N>Это приключение, кажется, и волнует, и вдохновляет [healer_hero], как будто его душа так или иначе лежит на чаше весов. Теперь я могу понять, почему [ranger_hero] боится его. Время от времени я вижу решимость в его глазах, которая может соперничать с нашим преследователем. Я просто молюсь, чтобы [healer_hero] в один прекрасный день смог найти для себя тот мир, который он приносит другим.
$ENTRY_JOURNAL_MANUSCRIPT_TITLE	
$ENTRY_JOURNAL_MANUSCRIPT_LEFT_0_00	День 11 – Каркасская рукопись
$ENTRY_JOURNAL_MANUSCRIPT_LEFT_0_10	<N>Cleared of all threat, the river outside of [healer_hero_pos] Chapter House has yielded a great bounty. ([berserker_hero], having finished with the revenant, spent the remainder of the day savagely depopulating the water of all other occupants.) While the resultant feast of broiled fish has most pleasantly filled my belly, it is one of the revenant corpses that fills my mind.<N><N>Of all that vile host we purged from the river, one carcass stood out from the rest. He had once been a herald of no small importance, judging by the quality of his dress, and the strange pattern and cut of his attire leads me to believe he hailed from one of the many Northern city states. While the rest of his accoutrements were far too damp-rotted to be of any use, he bore on his belt a watertight capsule of waxed leather. Inside, I discovered a still legible piece of parchment.<N><N>The contents validate my theory as to the man's origin. The text appears to be written in one of the many
$ENTRY_JOURNAL_MANUSCRIPT_RIGHT_0_00	Northern languages with which I am woefully unfamiliar (my own specialization being the speech of Ash, ancient and modern, and the dialects of its surrounding peoples, especially our Western brethren.)<N><N>Perhaps it is some great moral flaw that my mind, surrounded by so much carnage and grief, still rejoices at such puzzles. It is a great comfort to me, even if it is also a great selfishness, to shut out the dark and bloody world which has become my life, and dedicate my energies wholeheartedly to the deciphering of some mysterious manuscript. If I close my eyes, I can almost feel myself back at the Library.<N><N>On my own, I have already been able to tease out several details, despite my ignorance of the language. I see, repeated several times, what appears to be a group of glyphs borrowed from the Nomad (a tongue which, at the risk of sounding boastful of my linguistic prowess, I shall admit to possessing a meager command of). It roughly translates to <LQ>ornamented woman,<RQ> or <LQ>Queen<RQ> (as I have seen it used in some texts), though perhaps <LQ>Woman of Many Symbols<RQ> would be closer to the literal meaning. The arrangement of the text around it
$ENTRY_JOURNAL_MANUSCRIPT_LEFT_1_00	leads me to suspect that this Nomad loan may be a proper name, possibly that of the manuscript's author, or perhaps the intended recipient.<N><N>Such is the extent of the discoveries I can make on my own. I may call on the aid of [healer_hero], who I am told holds a not inconsiderable level of ability in several Carcassian tongues.<N><N>ADDENDUM:<N><N>[healer_hero] does indeed possess the skill with which his fellow monks credited him. Despite the obscurity of the dialect, he was able, within only a few moments, to present me with a translation of the text's opening line:<N><N><LQ>Return to me, my beloved,<RQ> Further progress was considerably slower, and the resulting interpretation far from complete, but a strange picture has begun to emerge. The second line, <LQ>And to our children who are weeping,<RQ> indicates that the relationship between the writer and recipient was far deeper than a tawdry love affair.
$ENTRY_JOURNAL_MANUSCRIPT_RIGHT_1_00	From there, [healer_hero] tells me the language becomes increasingly difficult, and the few words he can understand seem such gibberish that he begins to doubt his accuracy. <LQ>What voice have I to challenge the one you now hear?<RQ> is the only other complete statement [healer_hero] is able to produce. The remainder of the text is a mystery we cannot pierce, save for a word which [healer_hero] says could mean either <LQ>gray<RQ> or <LQ>dust,<RQ> several repetitions of the phrase <LQ>you return to blood,<RQ> and many uses of the proper name I discovered previously.<N><N>Hearing me say the name out loud, [ranger_hero] has corrected my understanding of the Nomad loan. In the Northeast (where it seems this manuscript originates), the word for <LQ>symbol<RQ> has somewhat different connotations. According to [ranger_hero], a more accurate translation of the phrase would be <LQ>Woman of Many Mystic Charms.<RQ> The magical quality of the woman has, sadly, not granted me any new insights into the text. All I can say is that she had, at the very least, bewitched the author's heart. Judging by the wealth apparent in his messenger, this Carcassian King (as I would guess) spared no expense in
$ENTRY_JOURNAL_MANUSCRIPT_LEFT_2_00	seeking the return of his wayward woman of many mystic charms. Whether she heeded the pleading of her husband and children, or even received the message at all, is a mystery I doubt any shall ever know.
$ENTRY_JOURNAL_WRENNA_TITLE	
$ENTRY_JOURNAL_WRENNA_LEFT_0_00	День 13 - [mage_hero_fu]
$ENTRY_JOURNAL_WRENNA_LEFT_0_10	Описание Полимона о величия Куэйдов не будет преувеличением. [mage_hero] действительно <LQ>бледнее луны и в два раза дальше.<RQ> Если говорить точнее, я бы еще добавила <LQ>чем сам Меркурий<RQ>. Я никогда не видела, чтобы у кого-то крыша ехала с такой скоростью. Даже [berserker_hero] последователен в своем безумии. [mage_hero] как бушующий океан, только она будто все знала и тут же безнадежно наивна. Часто в ее действиях проскальзывает ощущение спланированной хитрости, но когда я чувствую, что мои подозрения подтвердятся, она становится по-детски опасно безумной, чего не позволит себе ни один актер.<N>Иногда мне кажется, что я вижу среди этого безумия девушку, такую же как и я: испуганную и одинокую, обуздавшую ужасающую силу. Интересно, видит ли она это сама.
$ENTRY_JOURNAL_NOMADS_TITLE	
$ENTRY_JOURNAL_NOMADS_LEFT_0_00	День 14 - Кочевники
$ENTRY_JOURNAL_NOMADS_LEFT_0_10	Было интересно лично видеть племена кочевников, коренных жителей, населявших степи и горы между городами империй Эшей и Куэйда. Кантимал Полимон описал более сотни различных племен во время великой экспедиции на восток, хотя я полагаю, что многие из них погибли при разрушительных военных столкновениях. Здесь, в зреисподней, я встретила представителей двадцати семи*  различных племен, но сколько выжило во внешнем мире, трудно сказать.<N>Как следует из названия, племена ведут кочевой образ жизни, разводя коз и лошадей в степях. Лишь малая часть этого поведения передалась в преисподнюю, где для защиты требуется возводить укрепления.<N>*Менее половины этих племен ведут полноценный образ жизни.
$ENTRY_JOURNAL_NOMADS_LEFT_0_20	
$ENTRY_JOURNAL_NOMADS_RIGHT_0_00	Полноценные племена создают деревни такие, как Карск, развившие для выживания разведение коз и основы сельского хозяйства.<N>Одинокие кочевники (те, чьи племена были уничтожены или рассеяны) нашли убежище в более многонациональных поселениях таких, как Лаксос, или стали лучниками - передают сообщения и охраняют торговые пути между деревнями преисподней.
$ENTRY_JOURNAL_DREAM1_TITLE	
$ENTRY_JOURNAL_DREAM1_LEFT_0_00	День 15 - Странный сон
$ENTRY_JOURNAL_DREAM1_LEFT_0_10	Прошло много времени с тех пор, как мне что-нибудь снилось. Ужасные ощущения промежуточного мира, кажется, так доминируют над моим духом, что даже во сне я ничего не чувствую, кроме его отголоска. Тем не менее, средь лихорадочных видений моей разыгравшейся болезни, я видела сон.<N>Это был сон, настолько глубокий, что он усилил в моей голове ужасы всего, что я видела. Действительно, все события моих 23 лет, казалось, ничто по сравнению с ним.<N>Я стояла на высоком балконе. Я была не в себе. Мои руки были темными и красивыми, покрыты странными символами и окружены золотыми лентами. Мое платье было усыпано множеством драгоценных камней, таких, что сокровища всего мира не могли сравниться даже с частью моей одежды.
$ENTRY_JOURNAL_DREAM1_RIGHT_0_00	Луна свисала низко в небесах, гигантская и огненно-красная. Я могла бы дотянуться и прикоснуться к ней кончиками пальцев.<N>Голос позвал меня, и я обернулась. Рядом со мной на балконе стоял человек. Он был высокий, выше любого человека, которого я когда-либо видела. Его волосы и борода были черными как ночь, длинными и украшены золотыми кольцами. От его присутствия мир тускнел и уменьшался.<N>Он посмотрел на меня цепким взглядом, и я поняла, что мы были едины. Я спустила огненную луну и разделила ее между нами.<N>Я проснулась дрожа, прижимая руку к сердцу, как будто я по-прежнему держала красную луну. Меня охватила настолько сильная тоска, что я заплакала. В эту минуту,  я готова была пойти на все, чтобы вернуться в сон.
$ENTRY_JOURNAL_DREAM1A_TITLE	
$ENTRY_JOURNAL_DREAM1A_LEFT_0_00	Ночь 15 - Странные слова
$ENTRY_JOURNAL_DREAM1A_LEFT_0_10	Despite the tumultuous events of the day, [ranger_hero] has remained her usual obnoxious, unflappable self. We took our meal and retired to the small quarters the hospital has provided us as if nothing had happened at all. Or so it seemed to me at the time. I was awoken strangely during the night. [ranger_hero] stood with her hand over my mouth. <LQ>You were talking,<RQ> she explained, as she backed away to her own palett. I asked her what it was I had spoken in my sleep, but she only shook her head. <LQ>I did not understand,<RQ> she said. Her eyes betrayed a fear I have never seen in her before. After many long moments, when she must have believed I slept again, she began to whisper. I could make out very little of her hushed supplications, but one Nomad phrase lodged itself in my ear. It roughly translates to <LQ>Defend me from those set apart.<RQ><N><N>When the whispering stopped, and I was certain she had returned to sleep, I took out my journal and began to write this entry by the light of the flickering fire.
$ENTRY_JOURNAL_DREAM1A_RIGHT_0_00	I had only vague impressions of the words my unconscious lips uttered – half sounds, strange and unfamiliar. As I tried to cast my mind back to that pre-waking state, a sudden recollection struck me, not of the syllables I voiced, but the meaning they tried to communicate.<N><N>I began to write feverishly, worried that if I stopped to comprehend my thought, it would vanish.<N><N>I have finished my transcription, such as it is. I know not what to think.
$ENTRY_JOURNAL_DREAM1A_RIGHT_0_10	I am a storm<N><N>trapped and eating itself<N><N>deprived of even death<N><N>the god inside me scratches
$ENTRY_JOURNAL_FEARSOME_WORDS_TITLE	
$ENTRY_JOURNAL_FEARSOME_WORDS_LEFT_0_00	День 16 – Грозные слова о шрамах на губах
$ENTRY_JOURNAL_FEARSOME_WORDS_LEFT_0_10	In traveling with Quaid royalty I find that my curiosity outweighs my natural apprehension, for better or for worse. For her part, [mage_hero] is happy to answer most of my questions. These are always posed with some level of trepidation on my part – there is no telling which question will be met with a girlish smile and which will precipitate a terrifying fervor.<N><N>Her moods are many and the transitions between them mercurial. Even with years of practice, I doubt that I would ever be able to anticipate what goes on behind her storm-gray eyes. Occasionally, I look at her youthful face and my mind struggles to reconcile it with the litany of atrocities that were committed by her people. Other times, I can see in the sneer of her scarred lip the fanatical mania to carry out all of those horrors and more.<N><N>In the panic and chaos that preceded our last battle – as I braced myself to leap from this world into the halfway
$ENTRY_JOURNAL_FEARSOME_WORDS_RIGHT_0_00	place – my scrambling mind was transfixed by a single piercing image. [mage_hero] stood with her head bowed, hands gripping her staff till her knuckles showed white-hot against the duller ivory of her flesh. Her eyes were screwed shut with the intensity of someone who believes the outside world can be forced into nonexistence through sheer willpower. Her lips mouthed strange Quaid words over and over till the rhythm of it surrounded her like tumultuous flood waters. She was trembling. I saw her for the merest fraction of a moment, but it seemed a glimpse of the eternal, as if this strange, pale girl would stand whispering her fury to the world's end and beyond.<N><N>After the battle, I asked her what it was that she was saying. She took a moment and translated the words into her surprisingly proficient Ash:
$ENTRY_JOURNAL_FEARSOME_WORDS_RIGHT_0_10	Flame guide me!<N>Flame consume me!<N>Burn my brittle heart to ashes<N>And replace it with your will!
$ENTRY_JOURNAL_FEARSOME_WORDS_LEFT_1_00	By the time she finished the last words, she was shaking. She followed my gaze to her trembling frame and apologized sheepishly, explaining that the <LQ>Holy Anger<RQ> had taken her again.<N><N>I find my mind drawn again and again to the image of her trembling body in the throes of <LQ>Holy Anger,<RQ> fearsome words on scarred lips. What will happen as we enter these Quaid ruins? I hesitate to imagine how the tempest of [mage_hero_pos] mind will weather walking through the bones of her dead Empire.
$ENTRY_JOURNAL_FEARSOME_WORDS_TITLE	
$ENTRY_JOURNAL_DESERT_FORTRESS_TITLE	
$ENTRY_JOURNAL_DESERT_FORTRESS_LEFT_0_00	День 17 - Сокровище пустыни
$ENTRY_JOURNAL_DESERT_FORTRESS_LEFT_0_10	Я часто задавалась вопросом, откуда на востоке появились жилища наших главных врагов. В столице война казалась чем-то недосягаемым, так как туда доходили только мрачные сообщения о ежедневных потерях и постоянные причитания многочисленных раненых воинов, попрошайничавших на улицах.<N>После невыносимой жизни под страхом вид настоящего города Куйэдов – странный опыт. Я поражена красотой и изобретательностью его дизайна, но больше всего, я потрясена его дружескими отношениями.<N>Я замечаю все детали, на которые легла рука жизни города: потертые булыжники хорошо проторенных улиц, памятник, покрытый следами вандализма молодого поколения, рыночные прилавки, расположенные точно так же, как и в других городах.<N>
$ENTRY_JOURNAL_DESERT_FORTRESS_RIGHT_0_00	Легко заметить, как мой собственный отец сидит на углу улицы, смеется и проклинает, обмениваясь историями с другими стариками в городе.<N>И все же люди из этого места разрушили Терну и убили его жителей, всех мужчин, женщин и детей.
$ENTRY_JOURNAL_THE_FOX_TITLE	
$ENTRY_JOURNAL_THE_FOX_LEFT_0_00	Ночь 17 - Лиса
$ENTRY_JOURNAL_THE_FOX_LEFT_0_10	When I was a child, I once found a dying fox in the gardens that surrounded the Royal Library. How this wild creature had reached the heart of the city is a mystery to me, but his presence had caused the silent patrons to forsake their meditations and attack the small beast with stones and fallen branches, their anger turning the gardens around them into an armory. Broken and bloodied, the fox had dragged himself into an alcove to die. I could hear his small whimpering breaths from the path where I walked with my mother. I darted away and slipped into the doorway of the alcove. The fox froze at my appearance. The whimpering stopped in his red mouth. He met me with a silence containing more pain and anger than any warning growl ever could. His eyes stayed locked with mine as my mother pulled me back to the path and out of view.<N><N>I am reminded of that moment as I sit here waiting in vain for sleep to take me. I braced myself for a violent tempest, but [mage_hero] has walked these ruined halls the whole day long in dispassion, seemingly unaffected by the signs of death all around her.
$ENTRY_JOURNAL_THE_FOX_RIGHT_0_00	I kept waiting for the storm to break, but when it did, it was not at all in the manner anticipated.<N><N>As I searched the halls and tunnels of this ruin for any clues to our whereabouts, I stumbled across a small scrap of parchment, covered in the burns and stains of violence. A full half of the text had been destroyed – as if the horror of the battle were so fierce even words could not escape. What remained appeared an elegant but hastily written Quaid. I presented it to [healer_hero], but he pronounced that the remaining script had no pertinence to our quest. He seemed eager to remove it from his gaze.<N><N>I do not know why I did what I did.
$ENTRY_JOURNAL_THE_FOX_RIGHT_0_10	My dream has left me unsure of my own motivations.
$ENTRY_JOURNAL_THE_FOX_RIGHT_0_20	I would like to say that I spoke to her out of a desire for friendship, or even simply idle curiosity, but I fear my actions were born of a hunger to hurt the only available target for all of my fear and hate. All my life the Quaid have been the invisible source of all anguish. Perhaps I merely wanted to see one suffer the pain of loss they so frequently inflicted upon us. Perhaps her calmness irritated me. Or perhaps I envied her strength and
$ENTRY_JOURNAL_THE_FOX_LEFT_1_00	wanted to break it. I do not know.<N><N>Whatever the reason, I took the scrap of parchment and gave it to [mage_hero]. She disappeared into her tent and returned sometime later with a freshly inked translation on new sheepskin. It reads as follows:
$ENTRY_JOURNAL_THE_FOX_LEFT_1_10	This, our Great Tomb...<N>...last of...<N>Jewel of the desert.<N>None shall mourn... the greatest...<N>A woeful thing, wrought... sons of men...<N>We die...<N>... a finality not even honor...<N>... woeful ones...<N>No greatness...<N>... abandoned ashes...<N>... woeful...<N>... evil...
$ENTRY_JOURNAL_THE_FOX_RIGHT_1_00	They are obviously the words of one of the Quaid defenders, doomed to die in the siege. His eloquence in the face of his death – indeed the death of everything he knew – left me without words. As I stood pondering the ruined elegy, I was shocked to find the bottom of the page stained with tears.<N><N>I opened the flap to [mage_hero_pos] tent but stopped before I could say anything. She was curled in the far end, her flaxen hair hanging in limp strands over her face. Her fox eyes, incarnadined with sorrows I can never know, met mine. It was the same silence as all those years ago, heavy with more pain and anger than any words could ever hold.<N><N>I left immediately, but the image still haunts me. This time, I threw the stones.
$ENTRY_JOURNAL_THE_FOX_LEFT_2_00	ADDENDUM:<N><N>I'VE GOT A POEM FOR YOU:
$ENTRY_JOURNAL_THE_FOX_LEFT_2_10	MUSCLES...<N>... TOO MANY TO COUNT...<N>SEXINESS... SO MUCH...<N>KHAN... KARISSA...<N>BASTIONS OF POWER AND GLORY.<N>AN AMAZING THING, WROUGHT...<N>THE ABS OF SLAK<N>ALL GREATNESS...<N>... MESMERIZING GLUTES...<N>... GLISTENING...<N>... POWERFUL...<N><N>
$ENTRY_JOURNAL_THE_FOX_LEFT_2_20	THE MISSING WORDS ARE BECAUSE I FLEXED AND THE FABRIC OF REALITY TORE.
$ENTRY_JOURNAL_MARKOS_TITLE	
$ENTRY_JOURNAL_MARKOS_LEFT_0_00	День 18 - [knight_hero]
$ENTRY_JOURNAL_MARKOS_LEFT_0_10	Я настолько привыкла к компании безумцев, что перестала верить здравому смыслу!<N>[knight_hero] - любезный, умный, вообще полный благих намерений, иногда даже забавный. Черт возьми, он даже верит в личную гигиену... и я жду, когда он покажет свою истинную натуру.<N>Должно быть, что-то с ним не так! Некоторые причуды, некоторая раздражительность, некоторая иррациональность. После этого приключения я точно усвоила одну вещь: нет ничего нормального в преисподней.<N>Это ведь усы, да? Он прячет безумие за усами.
$ENTRY_JOURNAL_LETTER_MARKOS_1_TITLE	
$ENTRY_JOURNAL_LETTER_MARKOS_1_LEFT_0_00	День 19
$ENTRY_JOURNAL_LETTER_MARKOS_1_LEFT_0_10	Для леди [mcguffin_hero] Ливбар от [knight_hero_fu] Кашантира, служащего Эшу рыцаря.<N>Леди, с крайним уважением к вашей позиции в качестве командира этой группы, я хотел бы затронуть некоторые оговорки по поводу вашего выбора компании. А именно, я не могу гарантировать вашу безопасность, да и вообще безопасность всего этого предприятия, пока мы продолжаем путешествовать с [mage_hero_fu] Лэн Лэксми.<N>Вы можете уверять меня, что она <LQ>не так уж плоха<RQ> и, что война Куэйдов закончилась, но уверяю вас, что она посвятила себя ей и для нее она еще не закончилась. Она фанатично посвящена тому, чего больше не существует. Нам негде проверить ее безумие. И если глас Куэйдов потребует от [mage_hero_fu] перерезать во сне всем нам горло, то, скорее всего, мы однажды не увидим рассвета.
$ENTRY_JOURNAL_LETTER_MARKOS_1_RIGHT_0_00	Я советую разорвать с ней отношения, как можно скорее и как можно мягче.<N>Твой скромный слуга,<N>[knight_hero_fu] Кашантир
$ENTRY_JOURNAL_LETTER_MARKOS_2_TITLE	
$ENTRY_JOURNAL_LETTER_MARKOS_2_LEFT_0_00	Ночь 19 - Письмо для [knight_hero_fu], Черновой вариант номер 1
$ENTRY_JOURNAL_LETTER_MARKOS_2_LEFT_0_10	Дорогой [knight_hero_fu],<N>Отвечая на ваше письмо, я хочу затронуть три момента.<N>Во-первых, почему вы написали мне письмо, когда вы и так видите меня каждый день, почему бы не подойти и не поговорить со мной? Что-то не так с моей личной гигиеной? Кто-то из-за этого тайно насмехается надо мной?<N>Во-вторых, прекратите уже называть меня леди.<N>В-третьих, оставьте наконец в покое [mage_hero] или я... Я не знаю, нашлю на ваши бакенбарды огонь или типа того.
$ENTRY_JOURNAL_LETTER_MARKOS_2_RIGHT_0_00	П.С. - Я просто пошутила о ваших бакенбардах, я бы никогда не подожгла их, потому что тогда вы будете выглядеть странно, и пришлось бы придумать вам новое прозвище, втайне произносимое за вашей спиной, а г-н Превосходноусейшество действительно мне нравится. Тем не менее, я просто хочу сказать, что у [mage_hero_fu] были тяжелые времена, так почему бы не подшучивать над тем, кто этого заслуживает, к примеру, над [berserker_hero], который, кажется, думает, что я не знаю, что он читает за моей спиной, хотя у этого придурка, изо рта несет, как от двух туалетных кучек.
$ENTRY_JOURNAL_LETTER_MARKOS_2_RIGHT_0_10	<N><N>Я ВАС ЛЮБЛЮ [knight_hero_up] Я ХОЧУ ВСЕГДА ОЩУЩАТЬ ПРИКОСНОВЕНИЕ ВАШИХ УСОВ ДАЖЕ НЕСМОТРЯ НА ТО ЧТО ВЫ НЕ ТАКОЙ КРЕПКИЙ КАК [berserker_hero_up] А ТАКЖЕ ВЫ НОСИТЕ ЮБКУ ХА-ХА-ХА-ХА ПОЗВОЛЬТЕ ВЫЙТИ ЗА ВАС ЗАМУЖ!!!!
$ENTRY_JOURNAL_LETTER_MARKOS_3_TITLE	
$ENTRY_JOURNAL_LETTER_MARKOS_3_LEFT_0_00	День 20
$ENTRY_JOURNAL_LETTER_MARKOS_3_LEFT_0_10	Леди [mcguffin_hero_fu],<N>Полагаю, что я не должен был получить ваше последнее письмо, учитывая то, что его доставил [berserker_hero_fu], который впоследствии сбежал из лагеря и сам себя жестоко избил половником.<N>Это говорит о том, что я возвращаю письмо непрочитанным. Кроме того, пожалуйста, помойте половник, когда будете использовать его. Спасибо.<N>П.С. - Г-н Превосходнеусейшество? В самом деле? Это лучшее, что вы могли придумать?<N>-[knight_hero_fu] Кашантир
$ENTRY_JOURNAL_LETTER_MARKOS_SLAK_TITLE	
$ENTRY_JOURNAL_LETTER_MARKOS_SLAK_LEFT_0_00	День 21
$ENTRY_JOURNAL_LETTER_MARKOS_SLAK_LEFT_0_10	ЭЙ [mcguffin_hero_up] Я [knight_hero_up] Я ХОЧУ ОТ ТЕБЯ ДЕТЕЙ ВОТ ПОЧЕМУ Я ТОЖЕ НОШУ ЮБКУ А ЕЩЕ [berserker_hero_up] НЕОТРАЗИМЫЙ<N>АБСОЛЮТНО<N>ИСКРЕННЕ ВАШ [knight_hero_up]
$ENTRY_JOURNAL_LETTER_AZRA_SLAK_TITLE	
$ENTRY_JOURNAL_LETTER_AZRA_SLAK_LEFT_0_00	Ночь 21
$ENTRY_JOURNAL_LETTER_AZRA_SLAK_LEFT_0_10	Дорогой [berserker_hero_fu],<N>Если ты читаешь это, значит ты еще раз тайком проник в мою палатку, чтобы испортить мой журнал и/или размалевать своим почерком мое творение. Но в этот раз не получится. Ты видишь палатку позади себя? Угадай, что за этой палаткой?<N>Я дам тебе подсказку: она держит половник, и все это ей не нравится.
$ENTRY_JOURNAL_LETTER_AZRA_SLAK_LEFT_0_20	ХА-ХА Я ПОЧТИ ТЕБЕ ПОВЕРИЛ К ТОМУ ЖЕ МЕНЯ ЗОВУТ [knight_hero_up] И Я ЛЮБЛЮ НОСИТЬ КРАСИВЫЕ ПЛА
$ENTRY_JOURNAL_NIRU_TITLE	
$ENTRY_JOURNAL_NIRU_LEFT_0_00	Ночь 22 - [dragon_hero]
$ENTRY_JOURNAL_NIRU_LEFT_0_10	Я слышала о драконах много раз. Мой двоюродный брат в детстве был ими одержим, и он с удовольствием слушал любые легенды, которые я могла найти в библиотеке, от научных постулатов Полимона, до сказаний кочевников. Затем эти истории были бездумно повторены мною в детской манере: перевернуты наизнанку и скомканы, без остановки и передышки. Несмотря на качество лекций, много материала осталось в глубинах моего ума. Теперь, когда в моей группе настоящий дракон, эти детские уроки вновь нахлынули на меня.<N>В ходе этого приключения я поняла, что мои предрассудки оказываются глубоко неверны при столкновении с живым объектом изучения. Тем не менее, в данном случае я считаю, что мои знания верны: [dragon_hero] - это толстая, жадная, эгоистичная, ставшая высокомерной ящерица, уступившая иллюзиям божественности и мании накопительства.
$ENTRY_JOURNAL_NIRU_RIGHT_0_00	Такое могучее существо действительно представляет реальную опасность. Она ничего не сказала по поводу поедания кого-то в нашей группе, но убивает все, что слегка ее раздражает, и вообще относится ко всем <LQ>смертным<RQ> как к недостойным ее.<N>Превосходство часто граничит с невежеством. [dragon_hero] владеет заветным <LQ>кубком размером с дракона<RQ>. Если бы она разбиралась в письменности Эша, то знала бы, что надпись снизу гласит, что на самом деле речь идет об артефакте, который известен, как <LQ>ночной горшок лорда Редамала<RQ>. Всякий раз, когда меня вновь выводит из себя ее гонор, мне достаточно лишь вспомнить о ее радостном использовании этого <LQ>кубка.<RQ>
$ENTRY_JOURNAL_NIRU_LEFT_1_00	Ночь 24 - Дополнение
$ENTRY_JOURNAL_NIRU_LEFT_1_10	Все в шоке от ее двойственной натуры, оказывается, [dragon_hero] - удивительно заботливый родитель.<N>Когда я вижу, как она беспокоится за свое потомство, то сразу вспоминаю свою мать. Странно сравнивать с ней гигантского монстра, способного поджарить нас или сожрать в любую минуту, но именно это приходит мне в голову.<N>Я знаю, что такое сочувствие убило бы меня, но я не смогу понять потерю, которую она должна чувствовать по своим птенцам, которых забрали с собой загробники. Кажется, что эта большая трагедия нашего времени касается даже самого сильного и равнодушного среди нас.
$ENTRY_JOURNAL_SPEECH_TITLE	
$ENTRY_JOURNAL_SPEECH_LEFT_0_00	День 23 – Речь
$ENTRY_JOURNAL_SPEECH_LEFT_0_10	Today, while carrying out the whims of a fat, stupid, terrifying, fortunately illiterate lizard, I stumbled across a collection of scrolls. Most were old and mildewed beyond recognition, but one remained legible. I was shocked to recognize the Lord Regent's Ascension Speech:
$ENTRY_JOURNAL_SPEECH_LEFT_0_20	It is with great solemnity and deepest sorrow that I take up the robe and office of Lord Regent. We stand a people doubly bereaved. No sooner had we been made orphans by the death of High King Zenimal but our mourning ears were assailed by the news of Crown Prince Zelemir's death on the battlefield.<N><N>Though the ship be unsteady and the course unknown, I assure you, a new day crests the horizon.<N><N>I ask you to accept my captainage till the firstborn of the fountain, the blood of Ashantimon, rise up to take the helm and lead his people to peace.
$ENTRY_JOURNAL_SPEECH_RIGHT_0_00	It seems many lifetimes ago that I stood in the capitol and listened to these words from the mouth of the Lord Regent himself. What a great gulf stands between me and that young girl who wept in the Temple Square, wondering how the sun would rise without a king in Ash.
$ENTRY_JOURNAL_ASSASSIN_TITLE	
$ENTRY_JOURNAL_ASSASSIN_LEFT_0_00	День 24 - Головорез
$ENTRY_JOURNAL_ASSASSIN_LEFT_0_10	I made a strange discovery today, in the curious, elated moments that always follow one of our hard-fought victories. We were sifting through the remnants of our fallen foes, looking for salvageable gear, when I found an item of a most peculiar nature.<N><N>It was similar to a lamellar harness, or what was left of one, with scraps of the thin gambeson that had once been worn beneath it. The plates were smaller, and their connections more intricate, than anything I have seen in our own armies or those of the Quaid. The delicate contours of its design, as well as the presence of fibers caught between the segments, lead me to believe that it was worn under regular clothing. This attempt at secrecy suggests to me that the armor in question was civilian, rather than military in origin.<N><N>The largest mystery posed by the harness is the damage which, lamentably, renders it unusable by our party. There is a hole, more than a hand's breadth wide, roughly where the wearer's heart would have been
$ENTRY_JOURNAL_ASSASSIN_RIGHT_0_00	located. The surrounding scales are twisted and blackened as if the victims of incredible heat and force.<N><N>Such destruction is no stranger to me. I have seen it on countless vanquished revenant corpses, when I have used my meager powers to strike them down with the spirit of lightning. But this is not my work.<N><N>Most disturbingly, the damaged plates are flexed outwards, as if the terrifying heat and pressure had been exerted from the inside of the armor.<N><N>I cannot help but ask, what person would have worn such an outfit, and more vexing still, what would have killed them in such a bizarre manner?<N><N>ADDENDUM:<N><N>I am shaking still, as I write this, from the events that just transpired, and the death I just narrowly avoided.<N><N>I had begun to disassemble the cuirass I previously described, pulling the metal plates from their connecting silk cord, in the hopes of turning an
$ENTRY_JOURNAL_ASSASSIN_LEFT_1_00	unwearable armor into tradable scrap. I was about to take hold of the remaining sleeve of the gambeson to tear it loose, when [knight_hero] seized my hand. Still holding my wrist, he took his knife and cut open the seam of the gambeson. Inside were a row of sharp needles. He continued cutting down the length of the sleeve to reveal more hidden barbs. All told, there were 32 of them, each tipped with poison, sewn into the outer layer of fabric where one might grab an attacker's arm.<N><N>As [knight_hero] continued his dissection, we discovered a thin pocket, stitched into the sleeve's wrist. Inside was a piece of parchment, rolled on itself. The illustration was not unlike the many illuminated manuscripts I handled back in the great Library of Ash, though foreign in the style. Despite significant damage, the image is still discernible: a slender woman sits on a throne. Her face is obscured by scorch marks, but long white hair runs down her shoulders and mingles with the jewels around her neck. At her feet sit two boys, dark-skinned and golden eyed. The woman rests her hands on the boys' heads. Their hair, like hers, is white.
$ENTRY_JOURNAL_ASSASSIN_RIGHT_1_00	The edges of the parchment are jagged, as if it was cut from some much larger page with a knife. Its reverse side is covered in an assortment of symbols of unknown origin, meticulously traced in black ink.<N><N>[knight_hero], for his part, tries to make light of the entire event. The barbs, he says, have most certainly sat for so long that their poison no longer holds any potency. He assures me that his intervention was simply to spare me a sore thumb. These are his words, but I see in his eyes a concern that betrays his jokes.<N><N>How he anticipated the existence of these stings within the assassin's harness is something I have been unable to drag out of him.
$ENTRY_JOURNAL_SUPERSHEEP_TITLE	
$ENTRY_JOURNAL_SUPERSHEEP_LEFT_0_00	День 24 - Смерть супер-овцы
$ENTRY_JOURNAL_SUPERSHEEP_LEFT_0_10	The Axxima Vatta Muttanaxxor lies dead by my hand.<N><N>This, according to [dragon_hero_pos] gleeful boasting, is an accomplishment to be remembered for generations. Of course, she also seems to be of the mind that she accomplished this feat single-handedly (clawedly?), so perhaps her opinion is not to be taken seriously.<N><N>I will admit to enjoying the festivities. Deep in the bowels of a dead city, pursued by madmen and revenant, surrounded by chaos, it is nice to have a moment to actually enjoy something, even if it is a feast thrown by an overgrown lizard with delusions of divinity and a habit of threatening immolation for the slightest offense. How strange it is to see her caper about the bonfire with her offspring. For lack of any better word, she seems happy, if such an emotion can be applied to a monster. I would never think such a creature's moods could be contagious, but I do find myself beginning to feel something of our host's
$ENTRY_JOURNAL_SUPERSHEEP_RIGHT_0_00	exuberance. I have slain a legendary creature! I have feasted on its flesh! I have imbibed a not-insignificant quantity of something [berserker_hero] calls <LQ>boot wine!<RQ><N><N>I shall not explain the origins of this substance's nomenclature out of deference to those future readers who may be faint of heart, but I will say that I am on my second boot-full, and, while my palate may never recover from the horrors wreaked upon it, my insides are roaringly warm, and the outside world bobs and pulses in a most pleasing manner.<N><N>The progenitor of this rare vintage is currently on all fours, cavorting about the flames with our reptilian hosts and screaming <LQ>This is my dragon roar!<RQ> We shall not discuss any further the sound that follows, nor the orifice from which it originates, but both its regularity and volume are impressive.<N><N>On the third boot-full, I find that my initial negative impressions of [berserker_hero_pos] creation were perhaps too hasty. Flavor is entirely the wrong frame of reference with which to judge this substance. Texture, viscosity, a
$ENTRY_JOURNAL_SUPERSHEEP_LEFT_1_00	combination of temperature and gravitational impulses... If lightning were made out of leather and mud –<N><N>My boot is empty. This must be rectified.<N><N>It happened again! The boot with the thing doesn't stay there when you drink all of it… Where does it go? Why does the boot not stay full? Why does the... Solution! New boot.<N><N>Boot five is by far the most boot-full boot of the whole lot of them. Its boots have boots. Texture: amazing. Flavor: beyond words. Room: spinning.<N><N>I just ate a little bit of the sheep<N><N>I didn't even cook it on the fire<N><N>I just ate it raw<N><N>It was amazing<N><N>It's like... Okay: sideburns.<N><N>Am I
$ENTRY_JOURNAL_SUPERSHEEP_RIGHT_1_00	Is it weird to want<N><N>I just want to crawl inside the sideburns and curl up and take a nap<N><N>Like a little hammock<N><N>Just curl up and<N><N>I bet they smell nice<N><N>Is that sick? That might be sick.<N><N>I might be sick...I might be
$ENTRY_JOURNAL_SUPERSHEEP_RIGHT_1_10	Утро 25 - Дополнение
$ENTRY_JOURNAL_SUPERSHEEP_RIGHT_1_20	Never<N><N>Never never never never never never never<N><N>Never never<N><N>Never again.
$ENTRY_JOURNAL_DREAM2_TITLE	
$ENTRY_JOURNAL_DREAM2_LEFT_0_00	День 25 - Второй сон
$ENTRY_JOURNAL_DREAM2_LEFT_0_10	Сегодня мне снова приснился сон. Он выглядел иначе, но сон не изменился. Или, по крайней мере, не изменился тот, кому он снился.<N>Я стояла в большом зале. Его стены вздымались выше меня, возвышались настолько высоко, что казалось облака были потолком. Каждая стена была ярко-золотистой и украшена удивительными драгоценными камнями, которые я никогда не видела. В моих руках был кубок, вырезанный из какого-то блестящего материала, темно-красный и холодный на ощупь.<N>Несмотря на окружавшие меня чудеса, в первую очередь, для меня был ценен кубок, я держала его так, чтобы не пролить ни капли из него. Вдруг в зале потемнело, и в него хлынула омерзительная толпа. Они колотили и оскорбляли меня, после чего вырвали кубок из рук. Я закричала и достала из<N>
$ENTRY_JOURNAL_DREAM2_RIGHT_0_00	одежды острый кинжал, нанося удары и убивая их, пока зал не потемнел от крови.<N>Несмотря на свои потери, толпа прижимала меня, пока не вытеснила из зала в тусклый вестибюль. Я сопротивлялась, но все же орда сумела отражать удары, пока я полностью не выдохлась. Я потеряла сознание, и толпа бросилась через меня, стремясь сорвать яркие драгоценные камни со стен.<N>Я пролежала долгое время, считая, что умерла. Когда, наконец, я смогла встать на ноги, зал был пуст. Стены были ободраны и поцарапаны, и все было покрыто сажей и грязью. Я везде искала, но кубка нигде не было. Казалось, я целую вечность бродила по залу, кричала, но я была одна. Кубок был потерян.<N>Я села среди руин и заплакала.
$ENTRY_JOURNAL_DREAM2_RIGHT_0_00	Despite their losses the throng pressed against me till I was forced out of the hall, into a dim antechamber. I fought, but all around the horde struck back till I was completely broken. I collapsed, and the rabble rushed over me, eager to tear down the bright jewels from the walls. <N><N>I lay for a long time, believing myself to have died. When I finally could climb to my feet, the hall was empty. The walls had been torn down and smashed, and everything was covered in soot and filth. I looked, but the goblet was nowhere. I wandered the hall for an eternity, crying out, but I was alone. The goblet had been taken from me. <N><N>I sat down in the ruin and wept.
$ENTRY_JOURNAL_ZELEMIR_DEAD_TITLE	
$ENTRY_JOURNAL_ZELEMIR_DEAD_LEFT_0_00	День 28 - Смерть Зелемира
$ENTRY_JOURNAL_ZELEMIR_DEAD_LEFT_0_10	Цареубийство - очень странное чувство. Я понимаю, что сделала единственную разумную вещь, но все же пролила королевскую кровь Эшей. Он так отклонился от своей цели, что мог подвергнуть опасности весь порядок бытия. Однако, чувство не дает мне покоя. Это первый раз, когда я убила - истинного человека из плоти и крови.<N>[mage_hero] колеблется между радостью и гневом, проклиная его имя, как будто она может убить мертвого снова и снова. Я думаю, это не совсем показное желание, учитывая наши действия за прошлые недели.<N>Больше всего меня волнует то, что до сих пор загробники преследуют нас. Их лидер и создатель мертв. Кто может по-прежнему управлять ими?<N>Я задаю вопрос и уже знаю ответ, хотя я не хочу в
$ENTRY_JOURNAL_ZELEMIR_DEAD_RIGHT_0_00	этом признаться. Это не его воля. Ощущения отличаются. Другая рука ведет их.<N>Я почувствовала странную власть, о которой говорил Зелемир, зло, запечатанное кровью жертвы. Эзтли-Тенох.
$ENTRY_JOURNAL_GIBBERISH_TITLE	
$ENTRY_JOURNAL_GIBBERISH_LEFT_0_00	День 25 - Ахинея
$ENTRY_JOURNAL_GIBBERISH_LEFT_0_10	[knight_hero] woke me today. We had paused briefly to consume some small scraps of food, and I, weary from the long march, reclined in the cool stone archway we had just passed. Sleep, which has troubled me somewhat of late, came easily for once. My slumber cannot have lasted more than a few moments. Presently I opened my eyes to find [knight_hero] standing in front of me. He informed me that we had to press on, and, as he took the path in front of me, added that I had been speaking gibberish in my sleep.<N><N>Though it may have been mere nonsense to his ears, I felt meaning clinging to the corners of my half-sleeping mind. I drew out my journal and, in a rush that dared not stop and examine lest I should lose my quarry, jotted out what I remembered.
$ENTRY_JOURNAL_GIBBERISH_RIGHT_0_00	How beautiful how beautiful how beautiful you were<N>and I destroyed it<N>and made you like myself<N><N>and now and now and now<N>I am the prisoner and madman<N>who eats his own mind<N>because he cannot eat the world
$ENTRY_JOURNAL_WRENNASTORY_TITLE	
$ENTRY_JOURNAL_WRENNASTORY_LEFT_0_00	День 26 – История [mage_hero_pos]
$ENTRY_JOURNAL_WRENNASTORY_LEFT_0_10	I continue to discover great chasms between the world around me, as it stands in actuality, and the carved and colored interpretation of it that sits in my mind. It seems I have spent most of my life judging, not things themselves, but the intellectual fabrications I have created of them.<N><N>As we sat around the campfire tonight, [mage_hero] began to tell a story. I braced myself, expecting a journey into the grim and macabre: casual killings at a young age, or the violent fervor of the zealot.<N><N>Instead, she told a story about her youngest sister.<N><N>This child, seven years [mage_hero_pos] junior, envied the older girl's mobility. So great was this feeling of inadequacy that she took to – at unexpected moments – clambering onto [mage_hero_pos] back, and so parasitically assuming the height and athleticism she coveted. [mage_hero] soon became adept at removing this unwanted passenger, to the young girl's great frustration. This
$ENTRY_JOURNAL_WRENNASTORY_RIGHT_0_00	continued for some time, with the youngest repeatedly attaching herself to the oldest, only to be immediately unseated. One day [mage_hero] woke to find her sister perched at the head of her bed, laboriously covering herself with the contents of a pilfered jar of honey, hoping, with this makeshift adhesive in place, to permanently bond herself to her chosen beast of burden.<N><N>[mage_hero] ended the story and looked at me with an expectant, girlish grin. It was some moments before I realized she was waiting for my laughter.<N><N>What a strange and new reaction it was for me. The [mage_hero] of my mind elicited only fear or pity. Her portrait was either that of a grim and terrible warlord, even in her personable moments expressing a humor drenched in blood, voiced with the laughter of the fanatic, or else the pained and broken child, a helpless object on which to pour out all my self-righteous pity.<N><N>How grave my misconceptions are, which seek to condense the human soul to a simple object, pertinent only in its relation to me.
$ENTRY_JOURNAL_EVILINSIDE_TITLE	
$ENTRY_JOURNAL_EVILINSIDE_LEFT_0_00	День 27 - Зло внутри
$ENTRY_JOURNAL_EVILINSIDE_LEFT_0_10	Selinadt said in his Second Letter to King Vekalimon, <LQ>When men embrace the evil inside themselves, there can be no victors.<RQ><N><N>It is a bitter lesson, to be reminded of one's own failings. I had believed myself to be a true and ardent follower of Selinadt (a pride that I see now as itself a grave fault.) But surely, I reasoned, one such as I – steeped in verses from childhood, regular patron of the Temple – could consider herself on the righteous path? Despite this, I secretly held throughout my life the delusion that evil was something purely external. First it was the Quaid, architects of all the pain and misery I ever saw throughout my early life. While I read daily about the evil in my own heart, I secretly told myself that none of it could compare to the evil of the armies of the East, murderers and ravagers, men who had made themselves animals. All around me the lamentation of widows, the weeping of orphans, the cries of crippled veterans, all the keening of the city was made by my selfish mind into words of affirmation.
$ENTRY_JOURNAL_EVILINSIDE_RIGHT_0_00	<LQ>No evil I harbor,<RQ> I said in my heart, <LQ>Can be equal to this.<RQ><N><N>Even in this current adventure, which has served to disabuse me of many misconceptions, I maintained this fantasy of purity. No matter the secret thoughts of my heart, I could point to Ozimal or Zelemir and say <LQ>there is the true evil.<RQ><N><N>The way of Selinadt, in usual circuitous faction, has showed to me the grievous folly of my secret beliefs. Here in the belly of this dead city, clutched in the hand of what had once been a knight of Ash, I found a scroll. In the flowering calligraphy of a skillful hand were written the following words:
$ENTRY_JOURNAL_EVILINSIDE_RIGHT_0_10	 
$ENTRY_JOURNAL_EVILINSIDE_RIGHT_0_20	My dearest Master Elder,<N><N>In response to your excommunication, I would like to clarify that I have only ever acted in complete moral adherence to the tenants of our faith. You proclaim that the decimation of the prisoners under my care violates the responsibility of my position and my duty before the Unmoved Mover, but I assure you that the
$ENTRY_JOURNAL_EVILINSIDE_LEFT_1_00	opposite is true.<N><N>You remember, no doubt, when the enemy came against the city of Terna. Seeking to terrify the rest of Ash into submission, they swore that no quarter would be offered to the beleaguered defenders. On that black day when the city fell, we saw that oath to be true. But the enemy was not content with the massacre of the garrison and turned their fury on the populace, disregarding age, youth, and sex in their senseless rage. By the day's end, thirty thousand men, women, and children lay slaughtered. Terna was nothing but ashes, populated by scarcely enough souls to recount the horror of what was done there.<N><N>For this reason is my every tenth prisoner burned alive. Until thirty thousand die by my hand, the immolations shall continue, for the edification of the prisoners and the achievement of true balance. This is my solemn oath by the very gold of the Fountain, and not even the threats of a misguided cleric shall keep me from honoring it.<N><N>– General Keznimon Kalredos
$ENTRY_JOURNAL_EVILINSIDE_RIGHT_1_00	I knew this man. I – I see, as if lit by lightning, the great darkness that lurks in every soul. More than any other, I see it in my own. How easy it would be to embrace corruption rather than fight it. There is a sweet and familiar taste difficult to describe – have I lived so long with hate that I have grown to love it? I look at the horror on the page before me and I see the vilest sin. But how easy it would have been to commit. How sweet it would have felt to drink deeply from that secret stream in my heart, to inflict the pain and loss, to feel my soul dance with the dark joy of revenge. I think of [mage_hero] weeping in her tent – my evil, inflicted by my modest means. What would I have done with true power?<N><N>When men embrace the evil inside themselves, there can be no victors.
$ENTRY_JOURNAL_MARKOSSTORY_TITLE	
$ENTRY_JOURNAL_MARKOSSTORY_LEFT_0_00	День 27 - История [knight_hero_pos]
$ENTRY_JOURNAL_MARKOSSTORY_LEFT_0_10	To Lady [mcguffin_hero] Livbar from [knight_hero] Kashantir, Knight of the Host of Ash.<N><N>You asked me, some time ago, how it was I anticipated the danger hidden within the strange armor you discovered. As you correctly guessed, I do have a previous experience with an assassin similarly outfitted. While I rebuffed your curiosity at the time, I have had some days to think on the matter, and have decided to relate to you my experience.<N><N>This is not a story I divulge frequently, nor, if I can help it, think on.<N><N>It was a grim time. The plague would not come for another two years. In those days, it seemed, nothing could stop the Quaid war machine. The Eastern provinces were stained red with the blood of their people, and incursions had begun to break into even the heart of Ash.
$ENTRY_JOURNAL_MARKOSSTORY_RIGHT_0_00	My father was dead. My brothers were dead. I came forward, the eldest living male of the house of Kashantir, to fight. There were many like me, boys of noble birth who had spent their whole lives training but never yet spilled mansblood. Below us were boys younger still: commoners, peddlers, farmer's sons fresh from the fields, all summoned to give their lives for Ash.<N><N>It was a sign of the kingdom's desperation, I suppose, that such a delicate task was given to us.<N><N>Spies had brought news of a Quaid general making camp with his advance party, the foremost point of the fire worshipers' claw sunk into the heart of Ash. His guards were few, the spies said, the time to strike was now.<N><N>Our commander was ill prepared for such an action. The bulk of his troops were untested recruits, my age or younger, and his Nomad auxiliaries were deserting at a steady pace. He had no reserves, no veterans to call on, and scarcely enough gold to field more than a handful of mercenaries.
$ENTRY_JOURNAL_MARKOSSTORY_LEFT_1_00	He found a single man.<N><N>I had heard stories of such Carcassians, assassins bred from centuries of war between the Northern city states, men who valued murder itself more than the gold they were paid to commit it. I had always dismissed them as mere soldier's tales.<N><N>Looking at the man, I began to wonder if I had not misjudged.<N><N>He had no hair, as far as I could see, not on his face, nor his brow, nor his pate, nor the backs of his hands. I had never seen any living thing so still. He did not speak, but occasionally, and with no provocation, he would laugh, and when he did the teeth that showed were all midnight black. The men called him the Shade Drinker.<N><N>Our orders were simple: deliver the Carcassian to the enemy camp, and provide whatever assistance he might require in his task.<N><N>The weather was against us. A thick fog had descended during the night, and in the predawn darkness we
$ENTRY_JOURNAL_MARKOSSTORY_RIGHT_1_00	quickly lost our way. Unwilling to call out, lest we betray ourselves to the enemy, our small number was quickly separated. With rising dread, I realized I was alone in the mist.<N><N>I wandered for a great time, stumbling in my blindness, terrified that every step would discover me to the enemy. Presently I came upon a form in the mist. He was a Quaid guard, dead, red with his own blood. He had no eyelids.<N><N>I had stumbled into the enemy camp, and I was not alone.<N><N>Ahead of me, crouched between two tents, was another figure. I could not make out the man's features, but I reasoned by his stance that he too was an intruder. Creeping to the man's location, I reached out to touch his shoulder and alert him of my presence. Without turning, he caught my arm.<N><N>Cracking a black-toothed grin so wide it seemed to split his face in half, the Shade Drinker pointed at the tent in
$ENTRY_JOURNAL_MARKOSSTORY_LEFT_2_00	front of us. Its flap was embroidered with the Imperial crest of Quaid. Its guard was already dead.<N><N>Still holding my arm, the Carcassian entered the general's tent, drawing me after him. The general lay on a cot at the far end, surrounded by maps and scrolls and other accoutrements of command. Even lying down, I could tell he was a giant of a man, head and shoulders taller than I, and larger still than the slender Carcassian. Releasing me, the Shade Drinker crept to the general's foot. From some unseen sheath, he produced a small knife. He held it over his head for a moment, and it seemed to me time hung still. With a sudden jerk, he brought the knife down into the sleeping Quaidman.<N><N>The general sprang to his feet with a gasp. The knife still protruding from his ribs, he seized the Carcassian by the shoulders and hurled the smaller man across the tent. Drawing his sword from where it lay next to his cot, the Quaidman closed the distance between them with a single step. Fearing for my companion's life, I drew my sword and made ready to strike the advancing giant. My blow was checked by the strange sound of the Carcassian's laughter.
$ENTRY_JOURNAL_MARKOSSTORY_RIGHT_2_00	He lay, sprawled where the general had tossed him, black teeth shining in grotesque mirth. The giant's demeanor changed. His sword fell from his trembling hands. Like a crumbling tower, he collapsed, his great body wracked by convulsions.<N><N>With a wordless cry, the Carcassian was on him, straddling the dying man as he pried out his knife. I watched in the fear as the assassin reached out both his hands and began to make ablutions with the Quaidman's last ragged breaths, scooping them up and over his head and pouring them out as if they were water.<N><N>As the general's wheezing turned to silence, the Carcassian ended his ritual. He turned and saw me where I stood, still holding my undelivered blow. He made another black-toothed grin at me and peeled back the cloth on his shoulder to reveal a row of barbs, loaded with the venom that had taken his victim's life.<N><N>Taking my wrist again, he led me out of the tent, to the edge of the camp. He paused for a moment, hunched
$ENTRY_JOURNAL_MARKOSSTORY_LEFT_3_00	over in the mist and darkness, and I could hear him scratching something. Then, with a smile almost paternal, he handed me his knife. In the worn leather of the grip were carved strange characters. I looked up, and he was flanked by another four figures, clad and black-toothed smiling as he was. As one, they stepped backwards, into the mist and out of view.<N><N>Our commander choked to death in his sleep several weeks later, and the story spread throughout all the men that it was the Shade Drinker come back for his payment.<N><N>Years later, I met another soldier educated in some of the languages of the Carcassians. I showed him the knife, and he translated the characters for me. They said <LQ>Many lives to you, boy.<RQ>
$ENTRY_JOURNAL_DREAM3_TITLE	
$ENTRY_JOURNAL_DREAM3_LEFT_0_00	День 29 - Третий cон
$ENTRY_JOURNAL_DREAM3_LEFT_0_10	Вчера мне снова снился сон.<N>Я стояла в пустынном месте. Передо мной стоял гигантский кристалл, возвышающийся на сто футов в небо. Я плакала. Слезы бежали по моему телу, сквозь мои украшения и амулеты, и падали на землю. Они ползли по пыльной земле к кристаллу, и я поняла, что это уже не слезы, а ручейки крови.<N>У моих ног лежало множество трупов - мужчины, женщины и дети. Мои руки были покрыты их кровью. Я повернулась и увидела толпу позади себя, запачканную, как и я, в крови. Они ждали моей речи.<N>Я подняла красные руки к небу и закричала со всей силы.
$ENTRY_JOURNAL_DREAM3_RIGHT_0_00	Войско воскричало. Это было слово, которое я никогда раньше не слышала, но я сразу поняла его значение. Слово означало кровь. Крик был настолько сильный, что задрожала земля.
$ENTRY_JOURNAL_SLEEP_AND_MADNESS_TITLE	
$ENTRY_JOURNAL_SLEEP_AND_MADNESS_LEFT_0_00	День 30 - Сон и безумие
$ENTRY_JOURNAL_SLEEP_AND_MADNESS_LEFT_0_10	I woke myself this time, such was the intensity with which I had been speaking in my troubled sleep. The sound of the words has fled my mind, but the meaning lingers still, stranger and greater than any previous experience:
$ENTRY_JOURNAL_SLEEP_AND_MADNESS_LEFT_0_20	And yet and yet and yet<N>for all that great and crimson price<N>you left me<N>and sought another life in another place<N>as if you could cease to be a god<N><N>I was alone<N>I was the prisoner and madman<N>and you the Queen of dust<N>the Queen of devils<N>who could have been gods<N><N>Or so I thought<N>as I sat and ate my mind
$ENTRY_JOURNAL_EMPRESS_TITLE	
$ENTRY_JOURNAL_EMPRESS_LEFT_0_00	День 32 - Императица
$ENTRY_JOURNAL_EMPRESS_LEFT_0_10	I must express some disquiet with the ghost town in which we find ourselves visitors. While the various necessities a company such as ours has have been met by the same assortment of merchants and tradesmen found in every settlement of the Pit, the people here feel unsound. They are Quaid, mostly, and carry themselves with such a quiet fervor I find myself secretly cataloging escapes whenever one of their number addresses me.<N><N>[knight_hero], especially, seems agitated. He has spoken very little about his time in the war, but I can tell their speech and dress brings back evil memories to his mind. He no longer jokes as is his usual wont, but instead paces to and fro, fidgeting to keep his hands away from the grip of his sword.<N><N>Even the rangers and other mercenaries who work for whatever scraps the town can give them seem distrustful of their wards.
$ENTRY_JOURNAL_EMPRESS_RIGHT_0_00	Everywhere is found great stockpiles of the explosive crystals. Despite these numerous reserves, the Quaid populace continues mining, eager to feed a war machine that no longer exists.<N><N>All of this was disquieting enough, but then [mage_hero] entered the village.<N><N>The last of the royal line, child of the Cosmic Flame. Wherever she went, hungry eyes followed. Within moments, the entire village had quietly gathered, huddled in their doorways, ravenous for whatever scraps of purpose she would drop.<N><N>Of a sudden, a man broke from the ranks of the crowd. He was clad in rags, and foam flecked his wild blond beard. With a cry that was half scream, half laughter, he hurled himself at her feet, groveling in the mud, clutching at the hem of her cloak.<N><N>It was as if he had broken some invisible barrier. All at once, the populace descended upon [mage_hero],
$ENTRY_JOURNAL_EMPRESS_LEFT_1_00	trampling one another just to reach out and grab hold of her clothing. I saw an old man bawling like a child as he rolled in the dust, clutching to his chest a handful of her golden hair.<N><N>I tried to make my way towards her, but the crowd repulsed me. For a fleeting moment, my eyes met [mage_hero_pos]. They contained a look of such sheer terror as I have never before seen. She disappeared into the grasping hands of the crowd. Men held aloft strips they had torn from her cloak.<N><N>I was summoning up my strength to draw her with me into the halfway place, when a word of command shook the entire crowd. The rabble fell silent. Many of them trembled.<N><N>[mage_hero] stood atop the roof of one of the village hovels. Her hair writhed wildly in the wind. The tatters of her cloak billowed like the sail of a warship. A small trail of blood ran down her forehead.
$ENTRY_JOURNAL_EMPRESS_RIGHT_1_00	With a voice stronger than any I could imagine her small body capable of, she roared in Quaid. The people prostrated themselves. It seemed to me as if an entire host joined her words.
$ENTRY_JOURNAL_EMPRESS_RIGHT_1_10	<LQ>I am [mage_hero] Lan Laxmi! I am the flame that rises from the ashes!<RQ>
$ENTRY_JOURNAL_EMPRESS_RIGHT_1_20	She bellowed in Quaid, and Ash, and Nomad. The crowd retreated, bowing, not daring to turn their backs to their Empress. Slowly, men came forward to drop offerings at her feet, knives and axes, homespun cloth, the best of their meager possessions. This continued until nightfall.<N><N>The stockpile of crystals has almost doubled since our arrival.
$ENTRY_JOURNAL_BLACKROBES_TITLE	
$ENTRY_JOURNAL_BLACKROBES_LEFT_0_00	День 33 - Черная мантия
$ENTRY_JOURNAL_BLACKROBES_LEFT_0_10	[berserker_hero] has begun gathering the bloodsoaked robes of the fallen cultists for some project I prefer to know nothing of. It is strange to see the faces behind the masks, though they be twisted with their sudden transformation into revenant. They are mutilated, many of them, with what I can only assume are self-inflicted wounds. Despite all this, one can still see the men they once were. At one time, they would not have seemed out of place in the company of Nomads.<N><N>[mage_hero] is strangely joyed to have faced them, as if to fight the same enemy as her grandfather is to share in that hero's glory. The cultists, as she explained to me, were once the greatest threat to the Quaid Empire. United under the banner of a central matriarchy, the madmen were a kingdom in their own right, launching full-scale invasions to feed their never-ending appetite for sacrificial victims. Generations of Quaid fought them to a standstill, but it was not until [mage_hero_pos] grandfather that the Empire was able to go on the offensive. His victories were swift and brutal; apparently, after
$ENTRY_JOURNAL_BLACKROBES_RIGHT_0_00	generations of success, the cultists had become victims of their own degeneracy. The once powerful institution of matriarch had given way to a disorganized ruling class of high priests, each eager for his own power more than the good of the whole. Without the centralized authority of the <LQ>Queen of Many Devils<RQ> (as the Quaid termed the office), the cultists were unable to provide a unified resistance, and fell under the might of the Quaid offensive.<N><N>Until the coming of the plague years, [mage_hero] and her people had believed the blood-cultists all but exterminated. Now, in this time of chaos, it seems the madmen have returned, fueled by a power new and dark. The timing is no coincidence. Eztli-Tenoch has found his minions, men who willingly sacrifice their humanity for his sake.<N><N>[ranger_hero] called them the <LQ>tribes anathema,<RQ> which, coupled with their appearance, leads me to wonder if these men were not once Nomads such as she. What would have persuaded them to take on the life they now have (or had), my mind cannot fathom.
$ENTRY_JOURNAL_BLACKROBES_LEFT_1_00	[ranger_hero] remains reticent on the subject. Beyond her initial, almost giddy statements, given in the immediate aftermath of the battle, she has said nothing more. Apparently, it is one thing to celebrate a victory, and another entirely to indulge the <LQ>obnoxious curiosity<RQ> of a foreigner. Perhaps my inquisitiveness is thoughtless. When she believes no one looking, I see [ranger_hero] fingering the fox idol around her neck, her eyes flitting nervously amongst the fallen forms of our new enemies.<N><N>That the Geka, and a young [ranger_hero] with them, had some grim dealings with these madmen in the past seems a certainty.<N><N>For once, I feel it is I who have been crass and flippant.
$ENTRY_JOURNAL_BLACKROBES_LEFT_1_10	I cannot help but think back to [ranger_hero_pos] secret prayer to be delivered from <LQ>those set apart,<RQ> and her near suicidal debt to the sons of Krast.
$ENTRY_JOURNAL_BLACKROBES_RIGHT_1_00	Ночь 33 – Дополнение
$ENTRY_JOURNAL_BLACKROBES_RIGHT_1_10	My mind is drawn, repeatedly, to the words I heard the blood-mad speak, dark charms in a dark tongue. There is a sickly familiarity. They are no strangers to my lips, in the deep hours of the night, when my mind is not my own.<N><N>These blood drenched utterances are not the only thing of which I feel a secret knowledge. Here, in the fierce light of a waxing moon, I see things as I could not have in the brightness of day. I know these black robes, these gore-smeared masks, and the many devils who wore them.<N><N>I have commanded them in my dreams.
$ENTRY_JOURNAL_DREAM4_TITLE	
$ENTRY_JOURNAL_DREAM4_LEFT_0_00	День 33 – Четвертый сон
$ENTRY_JOURNAL_DREAM4_LEFT_0_10	The dreams, or rather the dream, singular, which stretches through my nights in one continuous narrative, comes to me now with greater frequency and intensity. I almost fear to close my eyes each night; it seems when wrapped in sleep my mind is not my own.<N><N>I stood in a dark and desolate place. The sun had set and would not rise. I wept, beseeching the sky, but in my secret thoughts I knew the sun would never shine again.<N><N>The great assembly of people that stood all about me began wailing and giving offerings, pleading with what they did not understand. They cut themselves and each other and lashed out at their surroundings, as if mindless destruction could call back the light that had left them. In the darkness, their eyes were blind to all but violence. It was just as I had taught them.<N><N>I fled my creation. The cries of the mad faded into the dark horizon.  I ran on in darkness, many
$ENTRY_JOURNAL_DREAM4_RIGHT_0_00	long ages it seemed, waiting for time to end. But time did not end. It surged out into the black, stretching from unseen horizon to unseen horizon and myriad in between.<N><N>I cannot tell you how many ages passed like this – when I think on it, I am amazed that a single night was able to contain what would overflow many lifetimes. I filled the infinity with thoughts of all I had lost and all I had taken – my tears were venom, my mind a worthy victim. The cold of the darkness froze my tears to my body. I ran still, but there was no escape. What I fled was myself.<N><N>Finally, after many long ages I saw – I cannot call it a light, for that would compare it to the light which I had lost. It was simply a lessening of the darkness. But I had spent so long in the deep black, deprived of all sensation save my own grief, that the presence seemed escape. I turned and saw before me a small candle, meager and dim, fluttering in the cold night wind. Still weeping, I came close and watched as it tried to warm me.<N><N>It was not a candle, but a man, small and gray. I watched as he set out the dusty baubles of his courtship,
$ENTRY_JOURNAL_DREAM4_LEFT_1_00	the best his kingdom of cobwebs had to offer. I looked at him and I felt nothing. In that moment the nothingness in my heart was the most blissful reprieve – to have the churning, anguished storm of my mind replaced with a void… It was more than I could ever hope for or deserve. To feel nothing was the most joyous fantasy… I embraced oblivion.<N><N>From that embrace there came a bitter joy. I drew my hands back and found they each held a small flame.<N><N>I wept again. What a birthright they had been robbed of, these small lights of mine. They should have been stars.<N><N>I took the two pieces of my heart, the twin boys with golden skin and hair, like mine, the color of starlight. I clasped them to my chest as they cried out for the father they should have had, the father they could never know. Here they were, curiosities in a lonely kingdom, children of hunger.<N><N>The darkness grew darker still.
$ENTRY_JOURNAL_DREAM4_RIGHT_1_00	In my weeping, I had extinguished the candle.<N><N>I woke, my lips mouthing strange words I could not recognize – names I dare not think on.
$ENTRY_JOURNAL_DREAM4_TITLE	
$ENTRY_JOURNAL_STAHP_LEFT_0_00	День 34 - Держись подальше от моего дневника
$ENTRY_JOURNAL_STAHP_LEFT_0_10	As I walk through these newly exhumed ruins, relics of the past malevolently thrust into the present, I cannot help but think on the
$ENTRY_JOURNAL_STAHP_LEFT_0_20	MIND-BLOWINGLY SENSUAL ALLURE OF [berserker_hero_pos_up] RIPPLING MUSCULATURE.<N><N>KAHN AND KARISSA PREY UPON MY MIND, THEIR RHYTHMIC UNDULATIONS HAUNTING MY DREAMS.<N><N>I HAD THOUGHT MYSELF CAPTIVATED BY [knight_hero_pos_up] MUSTACHE, BUT I SEE NOW HOW HIS WEAKLY, ARMORED FORM PALES IN COMPARISON TO THE GLISTENING ABDOMINALS OF A REAL MAN.<N><N>TO STAND IN THE SAME ROOM AS [berserker_hero_up], TO SCENT HIS RUGGED MUSK, BRINGS ON THE MADNESS.
$ENTRY_JOURNAL_STAHP_RIGHT_0_00	IT IS CALLED THE [berserker_hero_up] FEVER.<N><N>THERE IS NO CURE.<N><N>INDEED, I THINK NIGHTLY ON THE WOES OF MY AFFLICTION AND
$ENTRY_JOURNAL_STAHP_RIGHT_0_10	wonder how on earth [berserker_hero] got so skilled at writing at a full sprint.<N><N>I also wonder how I'm going to bend the ladle back into serviceable shape.
$ENTRY_JOURNAL_DREAM5_TITLE	
$ENTRY_JOURNAL_DREAM5_LEFT_0_00	День 34 – Пятый сон
$ENTRY_JOURNAL_DREAM5_LEFT_0_10	It seems a regular occurrence now to awaken in the quiet hours of the night, strange words on my lips, my mind full of dark thoughts not my own.<N><N>I creep past [ranger_hero], where she lies sleeping with one hand clasped around her fox idol, the other on the hilt of her dagger, and feverishly scratch my quill on parchment, unsure of the words until they appear on page.
$ENTRY_JOURNAL_DREAM5_LEFT_0_20	How I longed to see them<N>those lights that should have been mine<N>ignorant of their birthright<N>and I think<N>how golden they would be<N>if they could only taste<N>the corruption of my godhood<N>and yet and yet and yet<N>the light inside me knows<N>I would be their ruin<N>as I was yours
$ENTRY_JOURNAL_DREAM6_TITLE	
$ENTRY_JOURNAL_DREAM6_LEFT_0_00	День 35 – Шестой сон
$ENTRY_JOURNAL_DREAM6_LEFT_0_10	It feels as if every night sleep eludes me, and the paltry scraps I do grasp are filled with the lives and thoughts of others. More voiceless words, riddling my weary mind.
$ENTRY_JOURNAL_DREAM6_LEFT_0_20	The god voice called<N>and you shook off the gray dust<N>cast away the tawdry charms of mortal men<N>and came running to me<N>bearing in your arms a dyad of salvations<N><N>If you asked me I would give it<N>and end the world<N>or end myself
$ENTRY_JOURNAL_DREAM6_LEFT_0_30	Who speaks through my lips? Who lives through my dreams?<N><N>I ask the question and do not wish the answer.
$ENTRY_JOURNAL_THRONE_ROOM_TITLE	
$ENTRY_JOURNAL_THRONE_ROOM_LEFT_0_00	День 35 - Трон Эзтли
$ENTRY_JOURNAL_THRONE_ROOM_LEFT_0_10	[berserker_hero] уселся на трон, пока я это пишу. Трон Эзтли-Теноха.<N>Этот акт с первого взгляда выглядел непристойным. Но почему? Какое уважение приносит управление злом? Этот золотой человек – не более чем хулиган, прикрывающийся божественностью. Есть что-то глубоко трогательное в таком виде зла. Это похоже на тот же самообман мнимых великих людей. Посмотрите на это место: весь дворец посвящен укреплению самостоятельно созданного образа. Посмотрите на меня, во мне кричит истинное лицо власти. Эзтли-Тенох бог, бессильный в своей кристаллической тюрьме.<N>Но есть и другая сторона меня, которая понимает. Та сторона, которая находилась в зале, которая отличалась божественностью. Я сидела рядом с собой и судила толпу. Я чувствовала свое божественное призвание.
$ENTRY_JOURNAL_THRONE_ROOM_RIGHT_0_00	Возможно, этот привкус преследует меня в снах и управляет моим презрением. Я видела, кто он на самом деле, и кем он себя считает.
$ENTRY_JOURNAL_EVNI_TITLE	
$ENTRY_JOURNAL_EVNI_LEFT_0_00	День 36 - Энви
$ENTRY_JOURNAL_EVNI_LEFT_0_10	Against all sense and logic and reason, I have purchased [berserker_hero] his <LQ>true love.<RQ> I shall never forgive myself.<N><N>This can be said of [berserker_hero]: he is not one of those capricious men who, upon obtaining the object of their desire, immediately grow tired of it.<N><N>Evni has become a full member of our company. <LQ>She<RQ> has a reserved place at meals. And a spot in our councils. And a host of opinions, conveniently translated by [berserker_hero], who <LQ>speaks fluent sword.<RQ><N><N>She – and I swear by the memory of my parents that this is no fabrication or embellishment – has her own bed into which [berserker_hero] tucks her at night, and over which – again, I insert no fantasies here – he sings soothing lullabies. Decapitation is a recurring theme.<N><N>
$ENTRY_JOURNAL_EVNI_RIGHT_0_00	[ranger_hero], for her part, has grown even more abrasive than usual. During our noonday meal, [berserker_hero] became temporarily distracted attempting to catch a passing insect in between his flexing <LQ>pectorals of doom.<RQ> [ranger_hero], seated nearby and believing herself unobserved, reached out and upended [berserker_hero_pos] bowl of gruel over the sword. [berserker_hero] wailed and beat his breast (which had, incidentally, successfully crushed the insect), thinking his own clumsiness the cause for Evni's misfortune. I caught [ranger_hero_pos] eye and held it just long enough to let her know her wickedness had not gone unmarked. She actually bared her teeth at me.<N><N>ADDENDUM:<N><N>I accidentally exacted a strange revenge, I think, later in the day. Evni was resting in the shade as [berserker_hero] collected flowers with which to construct a bower for her <LQ>midafternoon nap.<RQ> As I walked past, I stumbled upon [ranger_hero]. She was crouched over the sword. As I drew closer, I began to make out the words that she was hissing in a hoarse whisper: <LQ>You are nothing to him. He will forget about you. You will be gone and I –<RQ>
$ENTRY_JOURNAL_EVNI_LEFT_1_00	I cleared my throat, and [ranger_hero] jerked upright. Her eyes were the size of silver platters. Her face had achieved a tone of crimson I did not believe possible for any living creature.<N><N>She stammered for a moment, and, unable to produce some suitably distracting insult, pulled her cloak over her face and fled.<N><N>I count that moment as one of the greatest achievements of my life.
$ENTRY_JOURNAL_PEACE_TITLE	
$ENTRY_JOURNAL_PEACE_LEFT_0_00	День 38 - Мир?
$ENTRY_JOURNAL_PEACE_LEFT_0_10	What a strange and exotic feeling it is to be hounded by no enemy; the only thing that hastens our journey is our own desire to reach the exit.<N><N>And now, with the last foe fallen, I stand the only mortal to ever know the secret of dragon fire. [mage_hero] looks at me with a strange envy. She bears the curse of hell. Now I, in her eyes, have received the gift of heaven.<N><N>I end this entry with a somewhat rueful realization:<N><N>For the first time since the genesis of my plague-born abilities, I am capable of performing the oft-requested act of <LQ>melting someone's face off.<RQ>
$ENTRY_JOURNAL_PEACE_LEFT_0_20	MY FACE MELTED OFF YEARS AGO THAT'S WHY GREW THIS TERRIBLE MUSTACHE TO HIDE MY SHAME ALSO I AM [knight_hero_up] UNDER THE MUSTACHE MY FACE LOOKS LIKE A BUTT AND NOT AN AMAZING BASTION OF POWER AND GLORY LIKE KHAN AND KARISSA IT'S MORE LIKE A SAGGY OLD FLA
$ENTRY_JOURNAL_PEACE_RIGHT_0_00	The lack of enemies does not necessitate a lack of violence.
$ENTRY_JOURNAL_DREAM7_TITLE	
$ENTRY_JOURNAL_DREAM7_LEFT_0_00	День 38 - Прощальный сон
$ENTRY_JOURNAL_DREAM7_LEFT_0_10	My sleep seems easier now, since the strange events that transpired in the treasure room. I have only woken once, for any reason other than the ordinary.<N><N>The night was mild, and we slept with our tent flaps open. I awoke to find the full moon shining brightly through this breach, its light so intense I felt warmed by its presence.<N><N>The sight elicited a response in me I have difficulty describing. I was both pained and elated. In the fervor of the moment, I began speaking.<N><N>The strange and foreign words that sprung to my lips have escaped my mind, but their meaning lingers in their wake.
$ENTRY_JOURNAL_DREAM7_LEFT_0_20	Have you come have you come have you come<N>with the secret wishes of my divided heart<N>to eclipse my darkness<N>or set it free
$ENTRY_JOURNAL_ANTIAZRA_TITLE	
$ENTRY_JOURNAL_ANTIAZRA_LEFT_0_00	День 37 - Тлетл-Мезтли
$ENTRY_JOURNAL_ANTIAZRA_LEFT_0_10	Мне совершенно непонятно то, что произошло в сокровищнице.<N>Я видела собственную смерть. Или, по крайней мере, своей сущности. Тлетл-Мезтли, огненная луна.<N>Странно смотреть на кого-то и говорить: <LQ>Я была этим человеком.<RQ> Но я была. Мощь, потеря, возмездие. Я жила, по крайней мере частично, ее интересами. Теперь, я свидетель жертвы, которая разрушила ее.
$ENTRY_JOURNAL_ESCAPE_TITLE	
$ENTRY_JOURNAL_ESCAPE_LEFT_0_00	День 39 - Побег?
$ENTRY_JOURNAL_ESCAPE_LEFT_0_10	Зелемир вернулся. Он принес с собой коварное предложение: наша свобода или спасение мира. Ценой каких-то тысяч жизней. Еще одна капля в бушующем океане крови.<N>[dragon_hero] вне себя. У [mage_hero] почти пена изо рта пошла.<N>Вот наше спасение!<N>Каждый выбор чреват опасностью: выступив против Зелемира, я рискую своей жизнью и жизнями всех, кто пал прежде, чем Эзтли-Тенох вырвался на свободу. Я рискую судьбой мира! Но ради этого плана, я рискну своей душой.<N>Жаль, что я не смогла умереть в Эше. Я хочу, чтобы все были избавлены от этого выбора.
$ENTRY_JOURNAL_FOLLOWING_ZELEMIR_TITLE	
$ENTRY_JOURNAL_FOLLOWING_ZELEMIR_LEFT_0_00	День 40 - За Зелемиром
$ENTRY_JOURNAL_FOLLOWING_ZELEMIR_LEFT_0_10	Я больше не могу называть решение Зелемира безумным. Это хорошо аргументированная, хорошо продуманная работа мастера стратегии, объясняемая страшным проклятием.<N>И это отвратительно.<N>Тот, кто с помощью хаоса борется с убийством невинных людей, предает правое дело.<N>Я сражалась с ним однажды. Я буду делать это столько раз, сколько смогу защищать этих людей. Пока не умру.
$ENTRY_JOURNAL_EPILOGUE_TITLE	
$ENTRY_JOURNAL_EPILOGUE_LEFT_0_00	Эпилог
$ENTRY_JOURNAL_EPILOGUE_LEFT_0_10	Какое странное чувство, стоять и говорить: <LQ>Теперь никто не пытается меня убить.<RQ><N>Я все еще не уверена, что верю в это. Я все еще жду кровожадную овцу, разносящую стены библиотеки. Пока я видела только мышь, которая быстро исчезла после применения трактата Полимона о правильном функционировании растений.<N>[knight_hero] постоянно появляется в библиотеке. В прошлом месяце, он хотел видеть фактически каждый военный трактат, который попадался мне на глаза, и насытив свой аппетит, переключился на все, что я могла снять с полок. Кажется, в последний раз он изучал руководство по разведению хорьков, которое я клянусь, что он выбрал наугад, а затем в течение всего визита разговаривал со мной, а не читал. Я знала, что с ним что-то не так.<N>
$ENTRY_JOURNAL_EPILOGUE_RIGHT_0_00	Но все равно приятно с кем-то поговорить, пока заполняешь полки. Столько книг было сожжено в качестве топлива во время чумы, что библиотека была уничтожена. Полки пустовали словно скелет без плоти, когда я прибыла. <N>[knight_hero] пожертвовал несколько книг, приобретенных у торговцев кочевников, а вчера я получила таинственную посылку: <LQ>ДЛЯ [mcguffin_hero_up] И ЕЕ СКУЧНОЙ РАБОТЫ КОТОРАЯ ГОРАЗДО ХУЖЕ ЧЕМ МОЯ А Я ЗАНИМАЮСЬ УБИЙСТВАМИ<RQ><N>Внутри было несколько невероятно редких западных текстов, возрастом не менее трех веков, а также куча грубо нарисованных рисунков с надписью <LQ>Я<RQ>, на которых изображены убийства чудовищ. Все это будет сохранено для потомков в отремонтированном восточном крыле, наряду с этой записью, как только она будет закончена.<N>Я часто задаюсь вопросом, как поживают мои старые товарищи.
$ENTRY_JOURNAL_EPILOGUE_LEFT_1_00	Прошло всего два месяца, но я уверена, что и за эти два месяца у [berserker_hero] и [ranger_hero] были сотни новых приключений.<N>Я немного слышала о [mage_hero], хотя то и дело кочевники-торговцы упоминают о <LQ>безумной повелительнице руин,<RQ>  так что можно считать, что она преуспевает в своем завоевании.<N>Иногда я боюсь за нее - с чумой исчезнут и загробники, империя Куэйдов станет желаемой территорией для всех потенциальных военачальников и королей разбойников, не говоря уже о королевствах на севере. Тем не менее, если кто-то и может бороться за мир и побеждать с улыбкой, то это только [mage_hero].<N>[healer_hero] вернулся в свой монастырь. Иногда я получаю письма, в которых подробно описывается медленное преображение преисподней. Торговцы, путешественники и паломники постепенно прокладывают пути, хотя на затягивание ран
$ENTRY_JOURNAL_EPILOGUE_RIGHT_1_00	уйдет много времени. Я могу принять приглашение и погостить у него в следующем месяце. Город восстанавливается, и с ним приходит обыденная суета городской жизни, от которой я больше не восторге.<N>Мои глаза жаждут видеть новые земли и далекий горизонт. Возможно, во мне скрывается авантюрист. Я не сомневаюсь, что [knight_hero] и его охранники будут сопровождать меня, таким образом, наше путешествие пройдет в безопасности, а если я уговорю его спеть, в дороге мы не соскучимся.<N>Я полагала, что [dragon_hero] покинула мир <LQ>смертных,<RQ> но теперь не уверена. На прошлой неделе связка книг с золотым переплетом оказалась на крыше библиотеки. Нужен опытный альпинист, чтобы поднять такой большой вес на такую высоту. Хочется верить, что наш таинственный благодетель умел летать, что, разумеется, значит, что некий самопровозглашенный бог нашел друга для воспитания детей.
$ENTRY_JOURNAL_EPILOGUE_LEFT_2_00	Мне нравится эта мысль, поэтому я буду в нее верить.<N>Странно говорить с людьми, которые не состояли в нашей небольшой группе. Некоторые, которым я даже начала доверять, или насмехались над моими утверждениями или уже были испорчены сильно преувеличенными историями возвращающихся беженцев.<N>Сегодня утром двое детей остановили меня на улице и умоляли расплавить лицо хулигану, который издевался над ними. Только и знают, что плавить лица. Строгим взглядом я заставила его сбежать домой, чтобы сменить штаны, так как это намного лучше, чем общаться со мной с расплавленным лицом. Бывало другие, подбегают ко мне на улице, просят залечить свои мозоли, благословить их ослов, наложить проклятие на раздражающих их соседей, список можно продолжать.<N>Возможно, именно поэтому я так рада видеть [knight_hero], входящего в библиотеку.
$ENTRY_JOURNAL_EPILOGUE_RIGHT_2_00	Мы никогда не говорим о наших прошлых приключениях, но есть одно общее понимание того, чем я никогда не буду делиться с теми, кто не был членом нашей компании. Интересно, увидим ли мы когда-нибудь друг друга снова? <N>-[mcguffin_hero] Яльки Ливбар
$ENTRY_JOURNAL_EPILOGUE_RIGHT_2_10	ИНТЕРЕСНО ТЫ КОГДА-НИБУДЬ НАУЧИШЬСЯ ПРЯТАТЬ ЭТОТ ДНЕВНИК ПОЛУЧШЕ ХА-ХА СКОРЕЕ ВСЕГО НИКОГДА ПОТОМУ ЧТО Я КЛАССНЫЙ А ЕЩЕ МЕНЯ ЗОВУТ [knight_hero_up] И Я ВООБЩЕ НЕ КЛАССНЫЙ МНЕ НРАВИТСЯ НОСИТЬ КРАСИВЫЕ ЦВЕТЫ В ВОЛОСАХ И ТАНЦЕВАТЬ В МОЕЙ ПРЕКРАСНОЙ ФИОЛЕТОВОЙ ЮБКЕ НАПЕВАЯ ЛА-ЛА-ЛА!<N>А ТЕПЕРЬ СЕРЬЕЗНО НАСЧЕТ [knight_hero_up]. НЕУЖЕЛИ МНЕ ПРИДЕТСЯ ЭТО СКАЗАТЬ ЗА ТЕБЯ? ТЫ ПОЛНЫЙ ПРИДУР
$ENTRY_JOURNAL_EPILOGUE_RIGHT_2_20	<N><N>Я сохранила половник.
$ENTRY_JOURNAL_EPILOGUE_LEFT_3_00	Дополнение
$ENTRY_JOURNAL_EPILOGUE_LEFT_3_10	I have, in the intervening months since our strange and tumultuous victory, had a single dream – an echo, I suppose, of the dark powers that once ruled my sleeping mind.<N><N>I was covered in the dust of long travels, my small body haggard from some great and terrible journey that lay behind me.<N><N>I passed through the great blue gates of my home, and into the embrace of the one who was like myself.<N><N>Into his ear I whispered my grim news.<N><N>Mother had come home.<N><N>I held in my childish hands her desiccated heart.
$ENTRY_JOURNAL_INDEX_2_LEFT_10	@<LQ>пластинчатая кольчуга<RQ>@
$ENTRY_JOURNAL_INDEX_2_LEFT_20	@A Note on Dimensions@
$ENTRY_JOURNAL_INDEX_2_LEFT_30	@Act Intro Quotes@
$ENTRY_JOURNAL_INDEX_2_LEFT_40	@Berserkers and Proper Scabbard Placement@
$ENTRY_JOURNAL_INDEX_2_LEFT_50	@Boss Revenant@
$ENTRY_JOURNAL_INDEX_2_LEFT_60	@Chieftan's Tunic and the World Tree@
$ENTRY_JOURNAL_INDEX_2_LEFT_70	@Cut Characters: the Paladin and the Protector@
$ENTRY_JOURNAL_INDEX_2_LEFT_80	@Eye of the Flame@
$ENTRY_JOURNAL_INDEX_2_LEFT_90	@Eztli Tenoch's Right Hand@
$ENTRY_JOURNAL_INDEX_2_LEFT_100	@Gedemon Dalavbar, Master of Archers@
$ENTRY_JOURNAL_INDEX_2_LEFT_110	@Introduction@
$ENTRY_JOURNAL_INDEX_2_LEFT_120	@James' favorite sandwich recipe of all time@
$ENTRY_JOURNAL_INDEX_2_LEFT_130	@Lord Warden's Harness@
$ENTRY_JOURNAL_INDEX_2_LEFT_140	@Markos' Mustache@
$ENTRY_JOURNAL_INDEX_2_LEFT_150	@Markos' Name@
$ENTRY_JOURNAL_INDEX_2_LEFT_160	@Markos' Skirt@
$ENTRY_JOURNAL_INDEX_2_LEFT_170	@Markos' Spell and the Book of Five Rings@
$ENTRY_JOURNAL_INDEX_2_LEFT_180	@Meet the Berserker: deleted scene@
$ENTRY_JOURNAL_INDEX_2_LEFT_190	@Names and Languages@
$ENTRY_JOURNAL_INDEX_2_LEFT_200	@Naming Evil@
$ENTRY_JOURNAL_INDEX_2_LEFT_210	@Nomad Spiritualism@
$ENTRY_JOURNAL_INDEX_2_LEFT_220	@The End@
$ENTRY_JOURNAL_INDEX_2_LEFT_230	@Scars@
$ENTRY_JOURNAL_INDEX_2_LEFT_240	@Slak the Librarian@
$ENTRY_JOURNAL_INDEX_2_LEFT_250	@Story Inspirations@
$ENTRY_JOURNAL_INDEX_2_LEFT_260	@Strength of Wocolan@
$ENTRY_JOURNAL_INDEX_2_LEFT_270	@The Blood Mad Tribes@
$ENTRY_JOURNAL_INDEX_2_LEFT_280	@The Northern City States@
$ENTRY_JOURNAL_INDEX_2_LEFT_290	@The Quaid Imperial Fire Cult@
$ENTRY_JOURNAL_INDEX_2_LEFT_300	@The Selini@
$ENTRY_JOURNAL_INDEX_2_LEFT_310	@The Temple of Ash@
$ENTRY_JOURNAL_INDEX_2_LEFT_320	@Warrior Monk's Habit@
$ENTRY_JOURNAL_INDEX_2_LEFT_330	@Zelemir's Name@
$ENTRY_JOURNAL2_INTRODUCTION_TITLE	
$ENTRY_JOURNAL2_INTRODUCTION_LEFT_00	Предисловие
$ENTRY_JOURNAL2_INTRODUCTION_LEFT_10	Hey everybody! This here is our top secret behind-the-scenes journal filled with all kinds of cool top secret behind-the-scenes information, like what was going through my head when I wrote specific parts the story (usually things like <LQ>when was the last time I saw the sun?<RQ> and <LQ>why hasn't Hugh Jackman responded to any of my letters requesting to be his best friend?<RQ> but also sometimes interesting story things people like you might want to read about like <LQ>Wrenna's facial scar is from when she was captured during the war and tried to cut her own tongue out rather than reveal secrets under torture<RQ> and <LQ>I'm the writer now and I can have as many run-on parenthetical statements as I want! Ha ha ha ha ha ha!<RQ> (Seriously, it's like a Russian nesting doll in here.))<N><N>Oh right, I should probably introduce myself. I'm James <LQ>Devilishly Handsome Lead Writer<RQ> Cavin. I, as you can tell from the incredibly accurate middle name that my parents gave me at birth, wrote the story to Defender's Quest: Valley of the Forgotten. I should also
$ENTRY_JOURNAL2_INTRODUCTION_RIGHT_0_00	credit Lars <LQ>Not As Handsome As James But Still Pretty Handsome I Mean in a Totally Platonic Way<RQ> Doucet, who wrote some of the item and enemy flavor text when he wasn't busy programming and stuff. (Man, our parents showed an incredible amount of foresight when they were filling out our birth certificates.)<N><N>Anyways, this behind-the-scenes journal will have all sorts of cool background information, world building notes, rejected ideas, etc. It'll be like getting a glimpse into the wild and wonderful creative process that gave birth to the story of Valley of the Forgotten, except with less eating out of garbage cans and crying yourself to sleep at night. What a wonderful journey we will take together!<N><N>Also, Hugh (can I call you Hugh?), if you're out there, did you get my birthday party invite? Trust me, only total squares aren't going to show up. All of my stuffed animals will be there!
$ENTRY_JOURNAL2_INTRODUCTION_LEFT_1_00	
$ENTRY_JOURNAL2_INTRODUCTION_RIGHT_1_00	
$ENTRY_JOURNAL2_PLATEMAIL_TITLE	
$ENTRY_JOURNAL2_PLATEMAIL_LEFT_00	<LQ>пластинчатая кольчуга<RQ>
$ENTRY_JOURNAL2_PLATEMAIL_LEFT_10	A lot of people like to throw around the term <LQ>plate mail.<RQ> When it appeared in Defender's Quest as the name for some of our heavy armor items, I immediately stopped what I was doing (staring inappropriately at German longsword fencing manuscripts) and leapt into action. You see, <LQ>plate mail<RQ> is a stupid and redundant term that should never be attached anything of any value whatsoever. But… If there's <LQ>chain mail,<RQ> then plate armor would be, like, <LQ>plate mail,<RQ> right? WRONG!<N><N>The word <LQ>mail<RQ> (or <LQ>maille,<RQ> if you're feeling fancy), comes from the medieval French word for <LQ>chain.<RQ> The phrase <LQ>chain mail<RQ> is a redundancy the didn't pop up until the 19th century. Once <LQ>chain mail<RQ> entered the popular vocabulary, people lost the original meaning of the <LQ>mail<RQ> part and kind of filled in that it just meant <LQ>like armor or something I guess.<RQ> They then started sticking it on the end of everything that should've just been called armor.
$ENTRY_JOURNAL2_PLATEMAIL_RIGHT_0_00	While I'm already alienating everyone, can we talk about putting spikes on everything? What are you going to do, hug people to death? What happens if you want to raise your arm more than 30° and suddenly your 11 inch shoulder spikes are going through your head? How are you supposed to move and fight in something that impales its wearer in any position other than <LQ>dramatic box art<RQ> stance?<N><N>Hey, where did everyone go?
$ENTRY_JOURNAL2_PLATEMAIL_LEFT_1_00	
$ENTRY_JOURNAL2_PLATEMAIL_RIGHT_1_00	
$ENTRY_JOURNAL2_DIMENSIONS_TITLE	
$ENTRY_JOURNAL2_DIMENSIONS_LEFT_00	A Note on Dimensions
$ENTRY_JOURNAL2_DIMENSIONS_LEFT_10	For those of you that are interested in the nature of the <LQ>halfway world,<RQ> here's a description of how dimensions function from one of our internal design documents:<N><N>Reality is made up of many different layers. What we perceive is the combination of a fraction of each <LQ>dimension<RQ> or <LQ>realm.<RQ> Color, taste, touch, smell, etc. are all tiny glimpses into their own dimension. Only the tip of the iceberg intersects with the world. But with intense concentration, one can separate the layers and fully experience a dimension in its entirety. The <LQ>realm<RQ> we will be dealing with the most is the <LQ>shadow<RQ> realm, as it is called by the characters. The shadow realm is the dimension of spirit – something like the platonic ideal, but for each object in existence. Every living thing is animated by an invisible force that we only barely experience, but in the shadow realm this spiritual force can be fully experienced and interacted with. As the healer explains it:
$ENTRY_JOURNAL2_DIMENSIONS_RIGHT_0_00	HEALER: Each of your senses only gives you the slightest hint of what is really there.<N><N>MCGUFFIN: I see.<N><N>HEALER: Reality is made up of layers –<N><N>BERSERKER: Like a cake?<N><N>HEALER: ...Yes...like a cake. These layers make up the world that we experience –<N><N>BERSRERKER: What kind of cake?<N><N>MCGUFFIN: A reality cake, now shut up!<N><N>BERSERKER: Mmmm...reality cake.<N><N>
$ENTRY_JOURNAL2_DIMENSIONS_LEFT_1_00	
$ENTRY_JOURNAL2_DIMENSIONS_RIGHT_1_00	
$ENTRY_JOURNAL2_ACTQUOTES_TITLE	
$ENTRY_JOURNAL2_ACTQUOTES_LEFT_00	Act Intro Quotes
$ENTRY_JOURNAL2_ACTQUOTES_LEFT_10	Some of my favorite things to write were the little bits of flavor text that opened each act of the story. They really let me experiment with other voices and give the player little glimpses into the larger world that the story was set in. When it came to start act seven, I actually came up with three different quotes and then picked a favorite to use in the game. Here are the two that didn't make the cut:<N><N><LQ>When faced with a decision, the selfish man thinks on a multitude of outcomes, weighing which option will yield him the best return.  The true man thinks only of which will serve the Flame.<RQ><N>- From the Book of Seven Wisdoms on the Path of the Blade<N><N><LQ>I look at the faces of our Northern mercenaries and I see the despair of a man who has gambled and lost.  We shall all die, but I shall die for my home, for my family, for the King and the Temple.  They shall die for a paltry sum of gold.<RQ><N>- Unknown defender, Siege of Karedon's Pass
$ENTRY_JOURNAL2_ACTQUOTES_RIGHT_0_00	The one that finally made it into the game is this:<N><N><LQ>It is said that men fear death.  In my experience, what men truly fear is the uncertainty of death.  In all that ordeal, when death was the only conceivable outcome, I was possessed by an unassailable calm I have never felt before or since.  It was only when the chance of survival appeared that I felt the true grip of terror.<RQ><N>- from the Memoirs of Gedemon Dalavbar, Master of Archers, being a History of his Adventures and Exploits in Service to the Ash King<N><N>This quote was highly inspired by a passage from Shadow of the Torturer, by Gene Wolfe, which I began reading as I was finishing work on Defender's Quest. (I didn't realize this inspiration until long after I finish writing the piece.) It's an incredibly strange, often disturbing book, which I would not recommend to younger readers. However, for mature audiences who are interested in taking a journey to a new and alien place, the book captures a sense of otherness in its world and values rarely found in modern fiction.<N><N>Speaking of inspirations, the idea of each act having an
$ENTRY_JOURNAL2_ACTQUOTES_LEFT_1_00	introductory bit of flavor text was taken from Thief: The Dark Projekt, one of my favorite games of all time. I don't think I've ever played anything else that had such a lavishly imagined, nuanced, and hauntingly beautiful setting. Master thief Garrett silently slipping through the shadows of The City, amidst grinding industrial machines and occult horrors, passing unseen through the warring factions of magic and reason is an image that will stay with me for the rest of my life. Sometimes I cry when I think about it. Although, that may have more to do with all the paint I ate as a kid...
$ENTRY_JOURNAL2_ACTQUOTES_RIGHT_1_00	
$ENTRY_JOURNAL2_BERSERKERS_TITLE	
$ENTRY_JOURNAL2_BERSERKERS_LEFT_00	Berserkers and Proper Scabbard Placement
$ENTRY_JOURNAL2_BERSERKERS_LEFT_10	Boy, it sure looks cool when a killer swordsman keeps his awesome sword on a scabbard on his back instead of on his side like a normal person! So cool, in fact, that I initially designed the Berserkers to look like this. Fortunately, my sublimated spirit of neurotic historical obsession materialize in front of me, slapped me in the face with a hand clad in 100% authentic riveted mail, and pointed out that keeping your sword on your back is the dumbest thing anyone could ever do ever.<N><N>But Link! And Geralt! And ninjas!<N><N>To which the spirit of neurotic historical obsession says:<N><N>Your back is a great place to keep things if you just want to carry them around. For instance, backpacks.<N><N>However, if you want to be able to draw a weapon you will discover that it is impossible to do so from your back. Go ahead, try it out. It's a Herculean effort to pull
$ENTRY_JOURNAL2_BERSERKERS_RIGHT_0_00	out anything of any length from a sheath. (One of the Roman emperors that I'm too lazy to look up at the moment – Hadrian, I think? – actually bragged in one of his writings that London was such a subjugated city his troops could walk through the streets with their weapons on their backs. Because… if there was danger of you getting attacked… you'd want to have your weapons where you could actually reach them.)<N><N>Next time you see some movie where some super cool dude keeps his sword on his back (or better yet, two swords), watch closely when he draws it. You'll notice the film always conveniently cuts – he gets a couple inches out of the scabbard (with the appropriate metal-on-metal shing noise that by the way would only ever happened if something was scratching the crap out of your blade) and then magically it cuts to him with the sword all the way out. This is because the in between part is anatomically impossible – you can't draw anything longer than your arm from your back. At least, not without dislocating something.<N><N>Now, there are some people who are so obsessed with
$ENTRY_JOURNAL2_BERSERKERS_LEFT_1_00	the coolness of drawing things from your back that they've designed special sheaths that exist only to do this. They're this weird kind of half scabbard sort of thing and they look stupid and they are stupid only stupid people use them and they still won't work as well as drawing it from your side. (A lot of them actually put a big metal ring right at the top, so you do get that metal-on-metal shing noise… You know, because this big metal ring is grinding the edge off of your sword.)<N><N>Anyways, the point is people are obsessed with how <LQ>cool<RQ> it looks to draw your sword from your back even though it will never, ever – even if you designed some sort of super sheath with this express purpose in mind – work like drawing it from your side like a normal person.<N><N>Fortunately, I corrected my grave error, and now all of our Berserkers use correct, physiologically possible sheath placement. Then I spent two hours watching German Longsword Fencing videos on YouTube and weeping for my sins.
$ENTRY_JOURNAL2_BERSERKERS_RIGHT_1_00	PS: You'll notice, in 3-D games where characters keep a sword on their backs, that the sword magically clips through the sheath rather than being drawn through the mouth of it.<N><N>PPS: some Napoleonic and the Victorian military sabers feature metal sheaths with a metal spring in the mouth that presses against the blade to keep it snugly in place, so when drawn they do actually create that metal-on-metal shing noise that the movies love so much. This spring also wears on the blade, so if you find still extant sabers of this variety, they will oftentimes have significant blade wear where the spring has rubbed against them every single time they're drawn. So yes, that cool shing noise does come from something, however it's very limited, and still bad for the swords long-term. Now if you'll excuse me, I have to go flog myself while reading sword and buckler fencing manuals.
$ENTRY_JOURNAL2_BOSSREVENANT_TITLE	
$ENTRY_JOURNAL2_BOSSREVENANT_LEFT_00	Boss Revenant
$ENTRY_JOURNAL2_BOSSREVENANT_LEFT_10	For those of you who are curious about our boss revenant, here's an explanation from one of our internal design documents:<N><N>Some revenant may be more powerful than others, depending on how much spiritual focus the wizard is giving that particular pawn. Furthermore, some <LQ>shells<RQ> are more conducive than others. For instance, a powerful necromancer could inhabit the corpses of squirrels. And while an army of zombie squirrels would be pretty hilarious, squirrels do not have the same depth of spiritual existence that humans do – less of the their being is in the shadow realm. Basically, the bigger a void left by a soul, the more room there is for the wizard to fill it with his own spiritual focus (ideally as soon as the thing dies – as a corpse rots, so does its spiritual dimensions, so the older a corpse gets, the less it can do). This carries over to people as well. Not everyone has as much room for the wizard to work in. Shallow vessels can only carry a small amount of his spirit, and won't allow him to do things that require more energy
$ENTRY_JOURNAL2_BOSSREVENANT_RIGHT_0_00	than they can hold. On the other hand, some people have significantly more spiritual depth and allow him a lot more room to work in – the newer a corpse is, the more spiritual void is left for him to fill.
$ENTRY_JOURNAL2_BOSSREVENANT_LEFT_1_00	
$ENTRY_JOURNAL2_BOSSREVENANT_RIGHT_1_00	
$ENTRY_JOURNAL2_CHIEFTANSTUNIC_TITLE	
$ENTRY_JOURNAL2_CHIEFTANSTUNIC_LEFT_00	Chieftan's Tunic and the World Tree
$ENTRY_JOURNAL2_CHIEFTANSTUNIC_LEFT_10	The twisting roots of the World Tree that decorate the Chieftain's Tunic was part of my many efforts to imply a deeper culture and folklore to our various factions, in this case the Nomads.<N><N>A lot of real-world cultures have the concept of a World Tree, but I was inspired specifically by a very strange bit of Greek folklore I read about which involved some Balkan goblins called Kallikantzaroi. The Kallikantzaroi spend the entire year underground, sawing at the roots of the World Tree in hopes of causing it (and therefore the world) to collapse. The Kallikantzaroi are just jackasses like that, I guess. Anyways, the only time they stop trying to kill the world is on Christmas, which arrives just as they are about to saw all the way through the World Tree. Starting on Christmas, they get to come up to the surface and run around peeing in people's beer, stealing candy from babies, sticking your toothbrush in the toilet, and generally being ass-clowns of the highest caliber. All their fun ends on the day of
$ENTRY_JOURNAL2_CHIEFTANSTUNIC_RIGHT_0_00	Epiphany, when they are banished back down into the earth. They arrive to discover that the joke is in fact on them and the World Tree has healed entirely from all of their sawing. This happens every single year, because the Kallikantzaroi aren't just ass-hats, they're incredibly stupid ass-hats. (I like to imagine that the World Tree went and peed in all of their beer while they were gone.)<N><N>Oh, and if you want to protect your beer, baby-candy, and toothbrushes from the Kallikantzaroi, all you have to do is put a colander out on your porch. Kallikantzaroi can only count as high as the number two – since three, being the number of the Trinity, is a holy number, if one of the Kallikantzaroi says it out loud, they will immediately die. So if you stick a colander on your porch, those punk ass Kallikantzaroi will stay up all night trying to count all of the holes in it but always losing count after the number two. Then you just get up first thing in the morning, bust out your trusty .45, cap those tragically math-obsessed fools in their collective keister, put the bodies down the garbage disposal, and enjoy urine-free beer for the rest of the holiday season. At least, that's how I imagine it going down.
$ENTRY_JOURNAL2_CHIEFTANSTUNIC_LEFT_1_00	
$ENTRY_JOURNAL2_CHIEFTANSTUNIC_RIGHT_1_00	
$ENTRY_JOURNAL2_CUTCHARS_TITLE	
$ENTRY_JOURNAL2_CUTCHARS_LEFT_00	Cut Characters: the Paladin and the Protector
$ENTRY_JOURNAL2_CUTCHARS_LEFT_10	We were originally going to have an even larger party roster, but had to cut characters in order to keep things at a more manageable size. Among the guys that ended up on the chopping block were the Paladin and the Protector.<N><N>The Protector was going to be a heavily defensive <LQ>tank<RQ> type unit who carried a massive shield. His whole shtick was that he could shield, not just himself, but also nearby allies. So when a defender next to him would have normally gotten hit, the Defender would zap in and block the shot with his shield. Story wise, if I remember correctly, the Protector was going to be part of an elite fanatical military unit from Ash that believed it had a moral obligation to defend any land on which one of its members had shed blood. Elements of the Protector were recycled for Markos the Knight, although the more fanatical <LQ>Our blood! The blood of patriots!<RQ> aspects were left on the cutting room floor.
$ENTRY_JOURNAL2_CUTCHARS_RIGHT_0_00	The Paladin also had a lot of overlap with the Knight, and was similarly axed. This is actually the class that Wrenna was originally going to be – the <LQ>fanatical and warlike enemy princess turned reluctant ally<RQ> seemed a perfect fit for someone with a sword. When this class ultimately got cut, I decided the enemy princess character was too good to not use somewhere, and the Ice Mage we all know and love was born.<N><N>While we're on the subject of classes that got changed, the Dragon was originally going to be the Dragon Rider. This absurdly overpowered unit would've been a dragon with an archer riding on its back. As is, Archers are one of the most overpowered classes in the game, so the Dragon Rider was scaled back to a plain old Dragon. I think Niru appreciates it.
$ENTRY_JOURNAL2_CUTCHARS_LEFT_1_00	
$ENTRY_JOURNAL2_CUTCHARS_RIGHT_1_00	
$ENTRY_JOURNAL2_EYEOFFLAME_TITLE	
$ENTRY_JOURNAL2_EYEOFFLAME_LEFT_00	Eye of the Flame
$ENTRY_JOURNAL2_EYEOFFLAME_LEFT_10	The description for this item was inspired by the Anglo-Saxon poem <LQ>The Ruin,<RQ> an elegiac piece pondering the ruins of a long dead Roman city. The poem is only found in one manuscript, which is so severely damaged that the end of the poem trails off into broken phrases and words. One of the last understandable bits of text translates to <LQ>It is a kingly thing...<RQ><N><N>If you've never read it, I would highly recommend picking up copy, spending a decade mastering the Anglo-Saxon language, and reading it in the original. Or I suppose you could just find one of the bajillion translations available, but then you won't be able to feel morally superior to people you meet at parties and alienate everyone and spend the rest of the night sitting in the corner drinking by yourself and muttering Anglo-Saxon profanities at everyone and then getting thrown out because Anglo-Saxon profanities are pretty much identical to modern English profanities.
$ENTRY_JOURNAL2_EYEOFFLAME_RIGHT_0_00	
$ENTRY_JOURNAL2_EYEOFFLAME_LEFT_1_00	
$ENTRY_JOURNAL2_EYEOFFLAME_RIGHT_1_00	
$ENTRY_JOURNAL2_RIGHTHAND_TITLE	
$ENTRY_JOURNAL2_RIGHTHAND_LEFT_00	Eztli Tenoch's Right Hand
$ENTRY_JOURNAL2_RIGHTHAND_LEFT_10	When I originally wrote Eztli Tenoch's Right Hand into the story, I meant <LQ>right hand<RQ> in the same way that a top general would be <LQ>the King's right hand<RQ> – purely a figure of speech. Eztli Tenoch's Right Hand was just going to be a particularly massive and scary revenant that ran around acting as Eztli's best servant.<N><N>Somewhere down the pipeline, things got taken a little more literally, resulting in the terrifying giant hand sprite currently in the game. Loath to redo any art, I just went and added a few explanatory lines to the dialogue. This miscommunication actually made for one of the more memorable boss encounters in the game! (Also, Lars wrote the flavor text for Right Hand, so the <LQ>sinister<RQ> pun is entirely not my fault.)
$ENTRY_JOURNAL2_RIGHTHAND_RIGHT_0_00	
$ENTRY_JOURNAL2_RIGHTHAND_LEFT_1_00	
$ENTRY_JOURNAL2_RIGHTHAND_RIGHT_1_00	
$ENTRY_JOURNAL2_MASTEROFARCHERS_TITLE	
$ENTRY_JOURNAL2_MASTEROFARCHERS_LEFT_00	Gedemon Dalavbar, Master of Archers
$ENTRY_JOURNAL2_MASTEROFARCHERS_LEFT_10	Gedemon Dalavbar, whose quote ornaments one of our Act intros, is one of the many dudes who would've worn the Master of Archers armor.<N><N>I briefly entertained the idea of writing the entire book of his adventures before deciding that that kind of attention to detail would make me go insane.<N><N>Who knows, someday...<N><N>(Of course, Klest Kada, Nomad adventurer, would have to get his own story too.)
$ENTRY_JOURNAL2_MASTEROFARCHERS_RIGHT_0_00	
$ENTRY_JOURNAL2_MASTEROFARCHERS_LEFT_1_00	
$ENTRY_JOURNAL2_MASTEROFARCHERS_RIGHT_1_00	
$ENTRY_JOURNAL2_SANDWICH_TITLE	
$ENTRY_JOURNAL2_SANDWICH_LEFT_00	James' favorite sandwich recipe of all time
$ENTRY_JOURNAL2_SANDWICH_LEFT_10	Boy, all of this behind-the-scenes writing has worked up my appetite. Are you guys hungry? I'm hungry. Let's address that issue.<N><N>You will need:<N><N>Sausage<N>Eggs<N>Bread<N>Tomatoes<N>Sauerkraut<N>Mustard<N>Yogurt (unsweetened and unflavored, because you're not a pansy)<N>Hot sauce (I prefer Louisiana style, but you can branch out into other things if you're some kind of social deviant or communist)
$ENTRY_JOURNAL2_SANDWICH_RIGHT_0_00	Step 1:<N>Murder some animal (preferably an awesome animal, like a shark), grind up its corpse, and then stuff its corpse into its own intestinal lining. Alternatively, I suppose you could just go buy some sausage, but where's the fun in that?<N><N>Step 2:<N>Slice the sausage length-wise into thin strips.<N><N>Step 3:<N>Fry these sausage strips in a pan, making sure to get both sides nice and crispy, but not overdone.<N><N>Step 4:<N>Fry the eggs (as many as you think you can conceivably fit into a sandwich – I usually do 2, but don't let that stop you) in the left over fat from the sausage.<N><N>Step 5:<N>That bread is looking a little bit healthy compared to the rest of this. Fry that sucker in the remaining sausage grease! You can add more grease as needed. The
$ENTRY_JOURNAL2_SANDWICH_LEFT_1_00	important thing is that your bread has been transformed from something that might remotely contain some health benefits into a crispy, grease-soaked impending heart attack. Remember, if a meal doesn't fill you with regret, you're doing it wrong.<N><N>Step 6:<N>Now for the sauce! Combine roughly equal parts mustard and yogurt in a bowl, or some other convenient dish, such as the hollowed out skulls of your enemies. Add hot sauce to taste and stir until everything is evenly mixed. If you still have leftover sausage grease in the pan, this is a good place to put it.<N><N>Step 7:<N>Time to assemble the sandwich! Liberally spread the sauce on both pieces of bread. Now stack all of your ingredients in no particular order: fried eggs, fried sausage strips, sauerkraut, sliced tomato, accidentally severed fingers, etc. The resulting monument to your awesomeness should be five or more inches tall.
$ENTRY_JOURNAL2_SANDWICH_RIGHT_1_00	Step 8:<N>Devour. Since all of our ingredients are dripping with grease, the sandwich tends to get soggy over time. Saving this guy isn't an option – eat him all now! No mercy! No prisoners! No leftovers! Democracy is at stake!<N><N>Step 9:<N>Regret.
$ENTRY_JOURNAL2_LORDWARDEN_TITLE	
$ENTRY_JOURNAL2_LORDWARDEN_LEFT_00	Lord Warden's Harness
$ENTRY_JOURNAL2_LORDWARDEN_LEFT_10	Originally, the Lord Warden was going to be a major character in the story. In my very first drafts, he was the primary antagonist. Secretly already corrupted by the plague, he would've used his position of authority within the Ash kingdom to surreptitiously work for the plague and its creator. He was eventually replaced by Zelemir, who had a far more interesting and complex set of motivations. However, I really liked the title and position of Lord Warden, so he got reincarnated as a suit of armor. Hey, at least his name is in the game! (A lot more than can be said for our other cut characters).
$ENTRY_JOURNAL2_LORDWARDEN_RIGHT_0_00	
$ENTRY_JOURNAL2_LORDWARDEN_LEFT_1_00	
$ENTRY_JOURNAL2_LORDWARDEN_RIGHT_1_00	
$ENTRY_JOURNAL2_MARKOS_MUSTACHE_TITLE	
$ENTRY_JOURNAL2_MARKOS_MUSTACHE_LEFT_00	Markos' Mustache
$ENTRY_JOURNAL2_MARKOS_MUSTACHE_LEFT_10	Markos' massive mutton chops came into being because his original goatee made people think he looked <LQ>too much like a used car salesman.<RQ><N><N>His current face-plumage was inspired by Union general Ambrose Everett Burnside (father of the sideburn) and Motörhead front man Lemmy Kilmister (father of playing music so metal that if he moved in next door to you your lawn would die). Rock on, dude. Rock on.<N><N>It's even more impressive when you realize that the only thing he has to trim it with is his his sword...
$ENTRY_JOURNAL2_MARKOS_MUSTACHE_RIGHT_0_00	
$ENTRY_JOURNAL2_MARKOS_MUSTACHE_LEFT_1_00	
$ENTRY_JOURNAL2_MARKOS_MUSTACHE_RIGHT_1_00	
$ENTRY_JOURNAL2_MARKOS_NAME_TITLE	
$ENTRY_JOURNAL2_MARKOS_NAME_LEFT_00	Markos' Name
$ENTRY_JOURNAL2_MARKOS_NAME_LEFT_10	Markos' name actually comes from a very weird story a good friend of mine was told by one of his professors at St. Andrews. The professor, in his much younger days, had once gone on a tour of Europe. While in France, he visited one of the many medieval cathedrals available to the public. He was so entranced by the structure that he decided it would be a good idea to slip out of his tour group and hide so that, after everyone left and the cathedral closed, he could sneak around and look at everything without some pesky tour guide telling him where he could and couldn't go.<N><N>His plan worked, and as soon as the cathedral had shut down for the day, he slipped out of his hiding spot and began perusing. It was around this point that he noticed a pair of feet poking out from behind a tapestry. As it turned out, he was not the only one with a grand idea of secretly admiring medieval architecture. The person behind the tapestry turned out to be one of the young women from his same tour group, and the two of them began exploring the cathedral together.
$ENTRY_JOURNAL2_MARKOS_NAME_RIGHT_0_00	The two of them, distracted talking with each other, did not notice the arrival of a third-party until he asked them if they would like a <LQ>secret tour.<RQ> The man, who identified himself as Markos, had wild hair, an untrimmed beard, and long fingernails. He apparently made a regular habit of hiding in cathedrals until they closed and then exploring them at night, and was full of all kinds of behind-the-scenes information, even going so far as an impromptu performance on the church organ. It was around this point that he explained that many medieval Christian cathedrals were actually built on older pagan sites, and that oftentimes these pagan sites still existed below the later structure. This was actually his primary interest in cathedrals, as he was a druid. After some time spent exploring the back of the church, he successfully located an important looking hatch in the floor that opened into the catacomb that ran underneath the cathedral. Apparently seeing nothing wrong with following a strange man into a subterranean death chamber, the two tourists joined Markos underground, where they found the remnants of the pagan tomb that the church had been built on top of. After playing with the skulls a little bit, Markos bid them a good night, and everyone went their separate
$ENTRY_JOURNAL2_MARKOS_NAME_LEFT_1_00	ways. The future professor and the young lady eventually got married. Markos, I like to believe, is living in a grotto under a cathedral somewhere, painting himself blue.<N><N>I liked the character so much, I decided I had to work the name Markos into something at some point.
$ENTRY_JOURNAL2_MARKOS_NAME_RIGHT_1_00	
$ENTRY_JOURNAL2_MARKOS_SKIRT_TITLE	
$ENTRY_JOURNAL2_MARKOS_SKIRT_LEFT_00	Markos' Skirt
$ENTRY_JOURNAL2_MARKOS_SKIRT_LEFT_10	For those of you that are interested in such things, the <LQ>skirt<RQ> on Markos' armor is made up of leather straps called pturges. The more you know!<N><N>You may recognize them from the uniforms of Greek and Roman soldiers – including them in the Markos' armor was part of my effort to give Ash a Byzantine/Mediterranean vibe.
$ENTRY_JOURNAL2_MARKOS_SKIRT_RIGHT_0_00	
$ENTRY_JOURNAL2_MARKOS_SKIRT_LEFT_1_00	
$ENTRY_JOURNAL2_MARKOS_SKIRT_RIGHT_1_00	
$ENTRY_JOURNAL2_MARKOS_SPELL_TITLE	
$ENTRY_JOURNAL2_MARKOS_SPELL_LEFT_00	Markos' Spell and the Book of Five Rings
$ENTRY_JOURNAL2_MARKOS_SPELL_LEFT_10	Strike not with strength of arm, but strength of spirit, and so, with mind and body as one, throw your enemy from you.
$ENTRY_JOURNAL2_MARKOS_SPELL_LEFT_20	Markos' <LQ>spell<RQ> is inspired by the language of The Book of Five Rings, a fascinating samurai treatise on swordsmanship and tactics written around 1645. The author, Miyamoto Musashi, is one of the most famous samurai duelists of all time. He's also the inspiration for a bunch of super rad Toshiro Mifune movies, which I highly recommend to anyone who likes watching Toshiro Mifune slice up jillions of dudes in glorious 50s Technicolor. (Toshiro Mifune would also totally get an invite to my birthday party except he, you know, died when I was 11.)
$ENTRY_JOURNAL2_MARKOS_SPELL_RIGHT_0_00	
$ENTRY_JOURNAL2_MARKOS_SPELL_LEFT_1_00	
$ENTRY_JOURNAL2_MARKOS_SPELL_RIGHT_1_00	
$ENTRY_JOURNAL2_MEET_BERSERKER_TITLE	
$ENTRY_JOURNAL2_MEET_BERSERKER_LEFT_00	Meet the Berserker:<N>deleted scene
$ENTRY_JOURNAL2_MEET_BERSERKER_LEFT_10	Originally, the player didn't get Slak until after the first battle. This first battle was fought with nothing but Azra's lightning spell – in the end, we found that this confused people and players began thinking that the focus of the game was on using spells rather than defenders.<N><N>We made some quick rewrites and plunked Slak into the first battle and players stopped getting confused! For those of you that are interested to see how the game originally would've introduced Slak, here's the old cut scene:<N><N>AZRA:<N>(Dazed)<N>    <LQ>God... what the hell was that?<RQ><N><N>AZRA:<N>(Puzzled)<N>    <LQ>How long have I been laying here?<RQ>
$ENTRY_JOURNAL2_MEET_BERSERKER_RIGHT_0_00	(Enter SLAK)<N><N>SLAK:<N>(Excited)<N>    <LQ>That was amazing!<RQ><N><N>AZRA:<N>(Puzzled)<N>    <LQ>What?<RQ><N><N>SLAK:<N>(Excited)<N>    <LQ>You just killed like 20 Revenant!<RQ><N><N>AZRA:<N>(Puzzled)<N>    <LQ>Revenant?<RQ><N><N>SLAK:<N>(Conversational)<N>    <LQ>You know, monsters, zombies, dead-heads, shambling horrors, reanimated corpses that wonder around eating people: Revenant.<RQ>
$ENTRY_JOURNAL2_MEET_BERSERKER_LEFT_1_00	SLAK:<N>(Excited)<N>    <LQ>It was AWESOME!<RQ><N><N>AZRA:<N>(Puzzled)<N>    <LQ>Listen, I have no idea what you're talking about. All I know is that I was very sick-<RQ><N><N>SLAK:<N>(Conversational)<N>    <LQ>-And they threw you in here to die.<RQ><N><N>AZRA<N>(Puzzled)<N>    <LQ>Yeah.<RQ><N><N>SLAK:<N>(Impersonating)<N>    <LQ>And then the zombies were all like 'Oh, we're going to eat you.'<RQ><N><N>SLAK:<N>(Crazy)
$ENTRY_JOURNAL2_MEET_BERSERKER_RIGHT_1_00	<LQ>And then you were like 'I don't think so, scum-suckers! Prepare to eat hot tasty electric death!'<RQ><N><N>SLAK:<N>(Cowering)<N>    <LQ>And then they were like 'Ah God! Please don't fry us with your awesome electric death powers! AHHH! The pain! It burns! IT BURNS WITH THE SEETHING FURY OF A THOUSAND DYING SUNS!'<RQ><N><N>SLAK:<N>(Disappointed)<N>    <LQ>And then I was like 'Damn, guess I won't be stealing her shoes.'<RQ><N><N>AZRA:<N>(Annoyed)<N>    <LQ>...<RQ><N><N>SLAK:<N>(Conversational)<N>    <LQ>Forget I said that last part.<RQ>
$ENTRY_JOURNAL2_MEET_BERSERKER_LEFT_2_00	AZRA:<N>(Annoyed)<N>    <LQ>Listen, as much as I appreciate your theatrical performances, I have absolutely no idea what I'm doing here, so if you don't mind -<RQ><N><N>SLAK:<N>(Friendly)<N>    <LQ>Well, lucky for you baby, you just happened to have stumbled upon the best tour guide in the entire Pit!<RQ><N><N>AZRA:<N>(Annoyed)<N>    <LQ>Tour guide?<RQ><N><N>SLAK:<N>(Friendly)<N>    <LQ>Listen, there's all kinds of dangers here for a complete neophyte such as yourself. Revenant, ganglords, bandits...you won't survive for five seconds on your own. But for the cheap, cheap price of absolutely free, I'll show you the ropes of surviving in this god-forsaken dump.<RQ>
$ENTRY_JOURNAL2_MEET_BERSERKER_RIGHT_2_00	AZRA:<N>(Puzzled)<N>    <LQ>Free?<RQ><N><N>SLAK:<N>(Friendly)<N>    <LQ>Of course. Just out of the goodness of my incredibly sexy and well muscled heart with absolutely no strings attached involving the use of your amazing powers for the accumulation of personal wealth.<RQ><N><N>SLAK:<N>(Announcing)<N>    <LQ>First stop, the Great Treasure Trove of Ozimal Kaz!<RQ>
$ENTRY_JOURNAL2_NAMES_LANG_TITLE	
$ENTRY_JOURNAL2_NAMES_LANG_LEFT_00	Names and Languages
$ENTRY_JOURNAL2_NAMES_LANG_LEFT_10	A lot of people have commented on the strange and unusual names the game generates for generic units that the player recruits in towns. These names were part of an effort to play up the differences between the three primary cultures: Ash, Quaid, and Nomad.<N><N>You'll notice that certain names crop up with certain physical characteristics. This is because the game has a list of physical characteristics for each civilization as well as a list of culture-specific names – when the player clicks to recruit a character, the game first randomly picks one of the three cultures for the recruit to come from and then picks a random name and physical characteristics from that culture's lists. For all three of you that are interested in such things, here's our old naming guide:
$ENTRY_JOURNAL2_NAMES_LANG_LEFT_20	This here is our name bucket for the generic characters. The names are divided according to cultures. Feel free to add any that you think of. The general rule of thumb for names is as follows:
$ENTRY_JOURNAL2_NAMES_LANG_RIGHT_0_00	Ash names: lots of Z's and V's, strong voiced continuous consonants and an overall Mediterranean flavor. Male names often end in -mon/man, -ir or -al, female names tend to end in -a or -i and sometimes <LQ>-vni<RQ>. Common sound combinations include <LQ>vn<RQ> and <LQ>zr<RQ><N><N>Ash appearances:<N><N>Olive and sometimes African tone skin<N><N>Black, brown, sometimes dirty-blond, occasionally red hair<N><N>Brown, Hazel, Blue eye color.<N><N>    Overall, a kind of combination Mediterranean/Greek/Germanic/Arab flavor. Ash has the most range in its appearances as it's intermarried the most with surrounding peoples.<N><N>Nomad names: Strong short syllable names with prominent ending non-continuous consonants. Female names tend to end in -a. K features prominently, as
$ENTRY_JOURNAL2_NAMES_LANG_LEFT_1_00	well as sounds like <LQ>sk<RQ> and <LQ>st<RQ> and is the only language to use the sound J.<N><N>Nomad appearances:<N><N>Light brown skin<N>Green, blue, hazel eye color<N>Dark, light, and medium red-brown, sometimes black hair<N><N>    Overall, a kind of combination Romani/Afghan flavor. Having a small population that mostly marries within itself means that unusual genes, such as red hair and green eyes, tend to show up more often. Quaid names - lots of W's and L's, taking inspiration from Welsh and Hawaiian without being obviously one or the other (mostly because I was looking for letters that the Ash names weren't using prominently and L and W seemed to be it.) There's also a dash of Anglo-Saxon influence. Quaid uses the letter C rather than K, and often uses Y as a rounded I. Female names tend to end in -a and often <LQ>-nna.<RQ>
$ENTRY_JOURNAL2_NAMES_LANG_RIGHT_1_00	Quaid appearances:<N><N>Very fair skin<N>Either very dark, or very light hair (true blacks and true towheaded blonds with very little in between). Blond is somewhat rare in the common populace, but more prevalent in the Imperial Family.<N>Black (i.e. super dark brown), dark brown, gray eyes.<N><N>    Overall, a kind of combination Welsh/Norse/Far Eastern flavor.<N><N>Ash Names:<N><N>Zir<N>Kered<N>Kolos<N>Teluman<N>Gozal<N>Gozra (female)<N>Sivnah (female)<N>Zamena (female)<N>Hektamon<N>Devdi (female)
$ENTRY_JOURNAL2_NAMES_LANG_LEFT_2_00	Tavida (female)<N>Yoavna (female)<N>Kesmir<N>Vasmon<N>Zenimon<N>Kastal<N>Kavni (female)<N>Bazan<N>Evni (female)<N>Rostal<N>Kezal<N>Tezra (female)<N>Zinak<N>Restavni (female)<N>Sedemon<N>Zerevna (female)<N>Ezran<N>Tanos<N>Yevkani (female)<N>Keznimon<N>Ayimi (female)<N>Admon<N>Azakal<N>Bakaza
$ENTRY_JOURNAL2_NAMES_LANG_RIGHT_2_00	Kevnimi (female)<N><N>Nomad Names:<N><N>Senna (female)<N>Koat<N>Kem<N>Raska (female)<N>Saja (Female)<N>Tulk<N>Rendt<N>Senga (female)<N>Jast<N>Pak<N>Tanna (female)<N>Dank<N>Serk<N>Drask<N>Sotta (female)<N>Leska (female)<N>Joata (female)<N>Saj<N>Het<N>Tetch
$ENTRY_JOURNAL2_NAMES_LANG_LEFT_3_00	Nesk<N>Dysta (female)<N>Skod<N>Senji (female)<N>Klest<N>Zekka (female)<N>Kask<N>Droat<N>Jek<N>Jekka (female)<N>Kaji (female)<N>Plosk<N>Skent<N>Foska (female)<N>Fytt<N>Zesk<N>Sajesh<N><N><N>Quaid Names:<N><N>Lawan<N>Sawul<N>Wassa
$ENTRY_JOURNAL2_NAMES_LANG_RIGHT_3_00	Aluwo<N>Sanna (female)<N>Wocolan<N>Celu<N>Laclanna (female)<N>Walucella (female)<N>Xeowan<N>Xeowanna (female)<N>Wastan<N>Luwella (female)<N>Lumenna (female)<N>Stawan<N>Wacali (female)<N>Neorxennawanga (female)<N>Centawal<N>Solowan<N>Cyleth<N>Wulacal<N>Cedmal<N>Lanna (female)<N>Hylla (female)<N>Hywada (female)<N>Walacanna (female)<N>Cullad
$ENTRY_JOURNAL2_NAMES_LANG_LEFT_4_00	Cuwain<N>Cella (female)<N>Celuwanna (female)<N>Celuwon<N>Cylehal<N>Awan<N>Alenna (female)<N>Awucella (female)<N>Awucan<N>Iowan<N>Ittella (female)<N>Walla<N>Lacan
$ENTRY_JOURNAL2_NAMINGEVIL_TITLE	
$ENTRY_JOURNAL2_NAMINGEVIL_LEFT_00	Naming Evil
$ENTRY_JOURNAL2_NAMINGEVIL_LEFT_10	When it came time to name our big bad, I wanted to find a naming convention that would make him seem significantly foreign compared to the rest of our characters and places. Complicating this was the fact that we had three prominent civilizations that I was already trying to make feel very distinct.<N><N>I ended up going with Nahuatl (Aztec) names, since the language was significantly distanced from the other real-world languages that we were using as inspirations (Greek and Arabic for the Ash, Welsh/Hawaiian/Anglo-Saxon for the Quaid, faux Finnish and Afghan for the Nomads).<N><N>In retrospect, the mixing of real-world names, like Azra and Zelemir, with completely made-up gobbledygook, like Ketta and Bakal, is a little bit strange (although quite true to our JRPG roots, I suppose.)<N><N>It also means that our entire story can be summed up as, to quote Lars, <LQ>one continuous chase scene with an Aztec god buried at the end.<RQ>
$ENTRY_JOURNAL2_NAMINGEVIL_RIGHT_0_00	
$ENTRY_JOURNAL2_NAMINGEVIL_LEFT_1_00	
$ENTRY_JOURNAL2_NAMINGEVIL_RIGHT_1_00	
$ENTRY_JOURNAL2_NOMADSPIRIT_TITLE	
$ENTRY_JOURNAL2_NOMADSPIRIT_LEFT_00	Nomad Spiritualism
$ENTRY_JOURNAL2_NOMADSPIRIT_LEFT_10	Originally, the Nomads practiced a tribal based polytheism. Each tribe has its own gods (and among many tribes, each individual family has a subset of lesser household demi-gods) represented by idols. These gods are there to serve the tribe's interests, but must also be honored and served in return. Infighting and feuds are very common among the different tribes, as the constantly moving nomads often encroach on one another's turf, or take to rustling or raiding. The tribal gods serve as standards in these fights. For a tribe to lose its idols is the ultimate disgrace, and (unless the tribe can regain the idols through warfare) generally signals the end of that tribe's existence. A tribe without its gods is considered the lowest of the low, and shunned from trading and other meetings.<N><N>Each individual Nomad is also given a personal idol at birth, which is believed to be a servant of the tribe's gods. These servant spirits act as the individual’s guide and guardian through life. At a Nomad's death, the personal idol is buried with its owner in order to guarantee safe passage to Paradise. For a Nomad to lose
$ENTRY_JOURNAL2_NOMADSPIRIT_RIGHT_0_00	their personal idol is a catastrophic event. Without its guardian spirit to lead the way, the Nomad's ghost is doomed to spend many ages looking for the path to Paradise.<N>    Prolonged exposure to the Ash Kingdom through trade, etc. has led to many of the tribes picking up the teachings of the Temple of Ash. Only a handful have been willing to fully abandon the old ways and completely join the Temple of Ash. The majority attempt to reconcile Ash's deity with their own. This muddling of the faith has created a lot of religious animosity from the Temple of Ash, adding to the general prejudice against the Nomads in the Ash Kingdom.
$ENTRY_JOURNAL2_NOMADSPIRIT_LEFT_1_00	
$ENTRY_JOURNAL2_NOMADSPIRIT_RIGHT_1_00	
$ENTRY_JOURNAL2_SCARS_TITLE	
$ENTRY_JOURNAL2_SCARS_LEFT_00	Scars
$ENTRY_JOURNAL2_SCARS_LEFT_10	We don't delve into it much in the story, but Wrenna's facial scars come from when she was captured during the war between Ash and the Quaid. Fearing that she could reveal secrets under torture, she attempted to cut out her own tongue to prevent herself from betraying her country. Originally, these scars were a little bit more noticeable, but we decided that it made her look a little bit too much like the Joker, so we toned them down.<N><N>While Wrenna is the only character with a specific story associated with their scars, we tried to make most of the survivors in the pit noticeably scarred in one way or another. Not only did this help reinforce the idea of the pit as a place of danger and constant violence, but it also helped single Azra out as the <LQ>fresh meat.<RQ> Being a relatively new addition to the pit, Azra just hasn't had time to get all of the old battle scars that everyone else has.
$ENTRY_JOURNAL2_SCARS_RIGHT_0_00	
$ENTRY_JOURNAL2_SCARS_LEFT_1_00	
$ENTRY_JOURNAL2_SCARS_RIGHT_1_00	
$ENTRY_JOURNAL2_SLAKLIBRARIAN_TITLE	
$ENTRY_JOURNAL2_SLAKLIBRARIAN_LEFT_00	Slak the Librarian
$ENTRY_JOURNAL2_SLAKLIBRARIAN_LEFT_10	Did you know that originally Slak, not Azra, was going to be the librarian of the group?<N><N>From Slak's original bio:
$ENTRY_JOURNAL2_SLAKLIBRARIAN_LEFT_20	Occupation: Prior to incarceration he was a Librarian, from a long line of librarians in the Capitol.  Now he's a professional adventurer and mercenary for the various factions in the Pit.<N><N>Education: Highly educated, favorite subjects are history and epic literature.  Hates applied sciences like mathematics.<N>
$ENTRY_JOURNAL2_SLAKLIBRARIAN_LEFT_30	Eventually, that background got switched over to Azra, who became the possibly-slightly-neurotic, ladle-wielding librarian we all know and love. Slak became... something entirely different.
$ENTRY_JOURNAL2_SLAKLIBRARIAN_RIGHT_0_00	
$ENTRY_JOURNAL2_SLAKLIBRARIAN_LEFT_1_00	
$ENTRY_JOURNAL2_SLAKLIBRARIAN_RIGHT_1_00	
$ENTRY_JOURNAL2_STORYINSPIRE_TITLE	
$ENTRY_JOURNAL2_STORYINSPIRE_LEFT_00	Story Inspirations
$ENTRY_JOURNAL2_STORYINSPIRE_LEFT_10	A fellow English major once asked me what the literary inspirations for the story of Valley of the Forgotten were. For the other two of you that would be interested in these things, here's the top three things that were on my mind when I was writing:<N><N>The plague colony concept actually came from one of Rudyard Kipling's short stories, The Strange Ride of Morrowbie Jukes. I read it when I was 11 or 12 and the idea of a naturally shaped prison full of people that had <LQ>died<RQ> but recovered has stuck with me ever since. There's this very strong sense of a plague society that inspired some of the details in the Pit. (For instance, the fact that there are no horses. One of the first things that happens to Morrowbie is that his horse is killed and eaten - although he gets a share of the meat, so it's not all bad.)<N><N>Beyond that, a lot of the cultural flavor came from Byzantine historical records. Much of the Selini culture is based on the writings of the early desert fathers and
$ENTRY_JOURNAL2_STORYINSPIRE_RIGHT_0_00	other early Eastern Christians.<N><N>And just to round out my history lit nerdom, a HUGE inspiration was Anglo-Saxon literature. I had just taken an Old English course when I started working on Defender's Quest and the language and culture were a gigantic inspiration for almost everything. The very pensive, elegiac tone seemed perfect for our kind of Medieval post-apocalypse setting. I highly recommend checking out The Ruin, if you're at all interested in that sort of thing; it's short and really encapsulates the kind of memento mori vibe of Anglo-Saxon literature.<N><N>Of course, there's a ton of stuff beyond that, but those three were probably the biggest influence on the setting. Well, those and a healthy dose of my favorite humor writers.
$ENTRY_JOURNAL2_STORYINSPIRE_LEFT_1_00	
$ENTRY_JOURNAL2_STORYINSPIRE_RIGHT_1_00	
$ENTRY_JOURNAL2_WOCOLAN_TITLE	
$ENTRY_JOURNAL2_WOCOLAN_LEFT_00	Strength of Wocolan
$ENTRY_JOURNAL2_WOCOLAN_LEFT_10	The description of <LQ>Wocolan crushing a bear's head with his hands<RQ> that adorns this heavy armor was an attempt to hint at a larger Quaid mythology. <LQ>Below, his children Wastan and Wacella drink the blood running from the bear's mouth in order to survive the family's grueling march into exile.<RQ> We never go into it in further detail, but the story of Wocolan and his children is part of the creation of the Quaid religion, as well as the establishment of the Empire. In the course of his exile, Wocolan would be chosen by the Cosmic Flame and given the strength, not just to survive his ordeal, but become the founding patriarch of all of Quaid.<N><N>I tried to make it extra weird, to capture that legitimate old world mythology feel. Anytime you want something to feel properly <LQ>ancient religion,<RQ> just make someone eat something slightly disturbing. (Or I suppose you could go all ancient Egypt on everything, but that would've crossed our self-imposed PG-13 limitation.)
$ENTRY_JOURNAL2_WOCOLAN_RIGHT_0_00	
$ENTRY_JOURNAL2_WOCOLAN_LEFT_1_00	
$ENTRY_JOURNAL2_WOCOLAN_RIGHT_1_00	
$ENTRY_JOURNAL2_BLOODMAD_TITLE	
$ENTRY_JOURNAL2_BLOODMAD_LEFT_00	The Blood Mad Tribes
$ENTRY_JOURNAL2_BLOODMAD_LEFT_10	The Nomads are actually the scattered remnants of an ancient civilization that was once part of Eztli-Tenoch's domain.  When Eztli-Tenoch was defeated most of them scattered, becoming the tribal, nomadic, polytheistic people that we are familiar with.  But some of them remained loyal to their defeated <LQ>god,<RQ> and, under the leadership of their mysterious Queen, grew into a shamanistic death cult dedicated to freeing Eztli-Tenoch from his prison.  These tribes surrounded the areas around Eztli's prison and set about breaking the blood seal in the only way they knew how: killing anyone they could get their hands on and painting the Great Stone with their blood, hoping that one day, they would manage to nab the right people.  People learned very quickly to avoid these areas, so the Blood Cults spread out, eventually into the territory of the Quaid Empire.  Obviously, having everyone on your highways ritualistically murdered isn't good for business, and certainly not good for the glory of the Cosmic Flame, so the Quaid Empire waged several wars of eradication against the cults (these are the ones that Wrenna refers to).
$ENTRY_JOURNAL2_BLOODMAD_RIGHT_0_00	The cults are scattered but still a vague threat.  With the disappearance of their Queen centuries ago, the cults began to lose much of the reasoning behind their actions to complicated ritual. Most blood cults no longer orbit the actual Great Stone, and instead worship and sacrifice to smaller replicas of it.  However, with Eztli Tenoch being somewhat freed from his prison, he has reached out to his long lost children.  The shamans of the blood cults have heard his call, and are all leading their people back into the Pit, back to the Great Stone prison of their god.<N><N>The cultists maintain a poisonous diet (the same poisons Zelemir used on Ozimal) and a crazed mania that they believe to be filled with the spirit of their master. This poisonous diet allows them to transform themselves into revenant as needed. (Eztli-Tenoch's Right Hand is a shaman, or perhaps a group of shamans, that sacrifice themselves to become the hideously twisted instrument of their master's will).<N><N>Ketta's Tribe, the Geka, were massacred by the Blood Cultists when she was in her early tweens, which is why she has few tribal affiliations and why she would
$ENTRY_JOURNAL2_BLOODMAD_LEFT_1_00	recognize them.<N><N>A big shout out to Lars for having the idea of Zelemir poisoning Ozimal.  Without that, the Blood-mad Tribes would never have occurred to me. (Originally, Ozimal was going to get turned into a revenant after Zelemir brutally shanked him to death on screen, but my Tarantino-esque bloodbath was vetoed in favor of some offscreen poisoning. Incidentally, Eyepatch Spear Guy, who has inexplicably attracted a small fan club, was also supposed to die in the melee.)<N>
$ENTRY_JOURNAL2_BLOODMAD_RIGHT_1_00	
$ENTRY_JOURNAL2_CITYSTATES_TITLE	
$ENTRY_JOURNAL2_CITYSTATES_LEFT_00	The Northern City States
$ENTRY_JOURNAL2_CITYSTATES_LEFT_10	While writing all of this expanded story content for the HD release, I stumbled across an old design notebook. Apparently, at some point in the past I decided that the Northern City States that the game makes occasional references to were called the Carcassians. I thought this was pretty cool sounding, so I went back to the game and started sticking it in different places. Thrilled that this crusty design notebook was somehow a magical portal into the land of not actually having to do new work, I continued reading. Apparently the Ice Mage is a dude named Laz who makes clocks. Also, the last page is a <LQ>to do<RQ> list that reads as follows:<N><N>1. Clean out garage<N>2. Call plumber about leaky faucet<N>3. Win lottery, marry Finnish supermodel/Princess, move to private Caribbean island, build castle, have 2.5 children<N><N>In case you're wondering, the garage is still trashed.
$ENTRY_JOURNAL2_CITYSTATES_RIGHT_0_00	
$ENTRY_JOURNAL2_CITYSTATES_LEFT_1_00	
$ENTRY_JOURNAL2_CITYSTATES_RIGHT_1_00	
$ENTRY_JOURNAL2_FIRECULT_TITLE	
$ENTRY_JOURNAL2_FIRECULT_LEFT_00	The Quaid Imperial Fire Cult
$ENTRY_JOURNAL2_FIRECULT_LEFT_10	The Quaid Empire is one of the older cultures in the world, and its religion is also ancient, though it has slowly borrowed aspects of neighboring religions over the years. All in all, the Imperial Cult is a fairly sophisticated monotheistic religion centered around fire worship.<N><N>The Imperial family is seen to be the chosen children of the Cosmic Flame. By bringing glory to the Quaid Empire the children earn the right to join their progenitor in the afterlife. The names of Imperial family members who have brought glory to the Empire in some way are recorded on a great stone wall in the Imperial Palace Complex – this functions as something of a ritualistic passport, signifying that they have the right to proceed to the afterlife. Those that have failed to bring glory to the Empire in some way during their lifetime are stricken from all historical records and their body is buried rather than cremated – an incredible dishonor, since cremation is the only way to join the Cosmic Flame.
$ENTRY_JOURNAL2_FIRECULT_RIGHT_0_00	This means that while the Aristocracy enjoys a good deal of benefits over the common populace, they have a great deal of expectations placed on them.<N><N>Many Emperors have been overthrown and murdered by their subjects because they were seen to be ignoring their duties. The war with Ash served as a great chance for several generations of Emperors to <LQ>bring honor to the Empire<RQ> quite easily through warfare.
$ENTRY_JOURNAL2_FIRECULT_LEFT_1_00	
$ENTRY_JOURNAL2_FIRECULT_RIGHT_1_00	
$ENTRY_JOURNAL2_SELINI_TITLE	
$ENTRY_JOURNAL2_SELINI_LEFT_00	The Selini
$ENTRY_JOURNAL2_SELINI_LEFT_10	Sects or schools of thought are common throughout the practitioners of the Temple of Ash. The Selini is a monastic sect of the Temple of Ash focused on emulating the life of the religion’s founder, Selinadt, by restoring balance to the world around them. This is done both through personal asceticism and by ministering to the world around them. The majority of the Selini Monasteries act as hospitals and sanctuaries in war torn or otherwise unstable (unbalanced) areas.
$ENTRY_JOURNAL2_SELINI_RIGHT_0_00	
$ENTRY_JOURNAL2_SELINI_LEFT_1_00	
$ENTRY_JOURNAL2_SELINI_RIGHT_1_00	
$ENTRY_JOURNAL2_ASHTEMPLE_TITLE	
$ENTRY_JOURNAL2_ASHTEMPLE_LEFT_00	The Temple of Ash
$ENTRY_JOURNAL2_ASHTEMPLE_LEFT_10	The Temple of Ash is a monotheistic-based monarchical religious philosophy centered on balance and community. The world is seen as a great machine, functioning under the impetus of the Unmoved Mover, the creator who sets everything in motion. The role of the individual is to serve their purpose as a part of the greater machine, being in balance with their place in the world around them. Evil is seen as the failure to do so, or imbalance. (This place is dictated by social structure – great emphasis is placed on the chain of command or chain of being.) The center of the religion is the physical High Temple, which was once the school of the founding philosopher. Water is a key element in Temple rituals, the hydrological cycle being an example of an element in balance with its purpose in the great machine. After death, those who have fulfilled their purpose within the Earthly Machine are taken by the Unmoved Mover and made part of the Celestial Machine, the perfected version of the earth.<N>The Temple of Ash was founded by Selinadt, an exiled philosopher from one of the distant northern
$ENTRY_JOURNAL2_ASHTEMPLE_RIGHT_0_00	independent city states. Banished from his homeland through the machinations of his political rivals, Selinadt wandered south, offering his services to various local rulers as an advisor. The King of Ash took him in after he defeated the king's wisemen in a riddle competition. After the conversion of the King of Ash, Selinadt's religious philosophy became widely popular throughout the region.<N><N>Since the King of Ash was the very first convert, each of his successors is seen as the caretaker of the Temple. The religion is practiced throughout the smaller neighboring kingdoms, but the High Temple at Ash is its center. For this reason, Ash is understood to be completely neutral in the wars that break out amongst its neighbors. In the few occasions that one of its neighbors has threatened it, the others have joined together against it to defend the Temple. This neutrality has allowed Ash to grow as a robust trading center, increasing its power and influence greatly. With the threat of the Quaid Empire, Ash's smaller neighboring kingdoms have united as a defacto federation, making Ash a sizable, albeit fractured empire.
$ENTRY_JOURNAL2_ASHTEMPLE_LEFT_1_00	
$ENTRY_JOURNAL2_ASHTEMPLE_RIGHT_1_00	
$ENTRY_JOURNAL2_WARRIORMONK_TITLE	
$ENTRY_JOURNAL2_WARRIORMONK_LEFT_00	The 9th Branch of the Selini, House Militant, Defenders of Truth and Order
$ENTRY_JOURNAL2_WARRIORMONK_LEFT_10	One of the major inspirations for the Ash religion – and especially the Selini like Bakal – was Eastern Christianity. As I was writing, I began to grow worried that the inspiration was a little too obvious. I desperately wanted to avoid cutting and pasting a real world religion wholesale into a fantasy universe, rather than creating a fantasy religion that felt like an organic part of its world.<N><N>I started looking for places where the Ash philosophy would deviate from my inspirations, how values would've evolved unique to this setting, etc. One of the things that immediately sprung out to me was pacifism. Eastern Christianity, while still allowing for some low level of necessary violence, has an incredibly pacifistic vibe. Clergy are banned from killing for any reason – even self-defense. (Self-defense is also frowned at among laymen.) Priests must be able to officiate a
$ENTRY_JOURNAL2_WARRIORMONK_RIGHT_0_00	<LQ>bloodless sacrifice<RQ> when performing the Liturgy, the central focus of church life. (In fact, if a clergyman is involved in an accidental death – say a fatal car accident – he can never serve again.)<N> This seemed like an element that wouldn't necessarily work with the Selini philosophy that I created so far. It would be entirely conceivable, given the Ash religion's focus on order, that violence could actually be seen, at points of absolute necessity, as being a sacred duty. Sometimes, a broken part must be removed before it damages the rest of the machine. Who would be better equipped to carry out this task than warrior Selini? While the Selini would only view violence as a final resort, there would be no taboo against clergy or monks being its dispensers, as the religion I'd created had none of the <LQ>bloodless sacrifice<RQ> at its centerpiece that Eastern Christianity did.<N><N>And that's how we got warrior monks, which didn't even really figure in the game, but hey, they're there in the background. (There are many chapters of Selini, and only some of them are of the <LQ>House Militant.<RQ> Bakal is from a far more pacifistic chapter.) With warrior
$ENTRY_JOURNAL2_WARRIORMONK_LEFT_1_00	monks, a caste-based chain of being governing its social order, a very Deist feeling Unmoved Mover, hydrological rituals, etc., I began to feel confident that the Ash Temple was becoming its own thing, rather than a rehash of real world religions.
$ENTRY_JOURNAL2_WARRIORMONK_RIGHT_1_00	
$ENTRY_JOURNAL2_ZELEMIR_NAME_TITLE	
$ENTRY_JOURNAL2_ZELEMIR_NAME_LEFT_00	Zelemir's Name
$ENTRY_JOURNAL2_ZELEMIR_NAME_LEFT_10	I picked this name for two reasons: 1) it starts with Z, which is awesome, and 2) it means <LQ>Desire for Peace<RQ> in Old Slavic. Interestingly, the word for <LQ>peace<RQ> (<LQ>mir<RQ>) is also the word for <LQ>world.<RQ> An alternate interpretation of his name would be <LQ>Desire for the World.<RQ> I thought this was an interesting dichotomy that really fit our conflicted villain.
$ENTRY_JOURNAL2_ZELEMIR_NAME_RIGHT_0_00	
$ENTRY_JOURNAL2_ZELEMIR_NAME_LEFT_1_00	
$ENTRY_JOURNAL2_ZELEMIR_NAME_RIGHT_1_00	
$ENTRY_JOURNAL2_OUTRO_TITLE	
$ENTRY_JOURNAL2_OUTRO_LEFT_00	The End
$ENTRY_JOURNAL2_OUTRO_LEFT_10	What's that, it's the end of the behind-the-scenes Journal?<N><N>What a wild ride it has been! We've laughed, we've cried, we've transcended to higher planes of existence and glimpsed untold truths! I feel like we've bonded. Like, I think of you all as my siblings now, although with less stealing my toys and dumping thumbtacks in my bed which had flannel sheets almost exactly the same color as the thumbtacks and my mom wouldn't let me run them through the washer because she thought of thumbtacks would tear it up so I spent all winter sleeping in dirty, thumbtack-mined bedding… Vlad.<N><N>Anyways, it's been an adventure! I hope you enjoyed this glimpse into the wild and terrifying creation process that gave birth to Defender's Quest: Valley of the Forgotten (minus all of the crying myself to sleep at night while drinking mouthwash and watching Spanish-language infomercials on the neighbors' stolen cable).<N>
$ENTRY_JOURNAL2_OUTRO_RIGHT_0_00	I'll see you all again in Defender's Quest 2!<N><N>What, that's a thing?<N><N>Yes it is! And it's going to be freaking awesome!<N><N>You should go buy it right now!<N><N>PS: You missed one heckuva birthday party, Hugh. Somebody brought some mouthwash and things got off the hook.<N><N>PPS: In case you were wondering, the phrase "neighbors' stolen cable" means that the neighbors stole the cable, rather than me stealing from them. I have standards. I simply watch their cable through their back window with a pair of binoculars.
$ENTRY_JOURNAL2_OUTRO_LEFT_1_00	
$ENTRY_JOURNAL2_OUTRO_RIGHT_1_00	
$ENTRY_JOURNAL_END	END