flag	content
$ENTRY_JOURNAL_INDEX_TITLE	ÍNDICE
$ENTRY_JOURNAL2_INDEX_TITLE	SECRETO
$ENTRY_JOURNAL_INDEX_LEFT_00	Entradas del diario
$ENTRY_JOURNAL_INDEX_LEFT_10	Día 1: @¿Dónde estoy?@
$ENTRY_JOURNAL_INDEX_LEFT_20	Noche 1: @[berserker_hero]@
$ENTRY_JOURNAL_INDEX_LEFT_30	Día 3: @Apéndice@
$ENTRY_JOURNAL_INDEX_LEFT_40	Noche 3: @Apéndice@
$ENTRY_JOURNAL_INDEX_LEFT_50	Día 3: @Prisión@
$ENTRY_JOURNAL_INDEX_LEFT_60	Día 4: @El Mundo Intermedio@
$ENTRY_JOURNAL_INDEX_LEFT_61	Día 4: @Tiene estudios@
$ENTRY_JOURNAL_INDEX_LEFT_62	Día 4: @Teneduría de libros@
$ENTRY_JOURNAL_INDEX_LEFT_70	Día 5: @[ranger_hero]@
$ENTRY_JOURNAL_INDEX_LEFT_80	Día 8: @Apéndice@
$ENTRY_JOURNAL_INDEX_LEFT_90	Noche 7: @La destrucción de Karsk@
$ENTRY_JOURNAL_INDEX_LEFT_100	Día 8: @Laksos@
$ENTRY_JOURNAL_INDEX_LEFT_101	Día 9: @Viajes@
$ENTRY_JOURNAL_INDEX_LEFT_110	Día 10: @[mcguffin_hero]@
$ENTRY_JOURNAL_INDEX_LEFT_120	Día 10: @La muerte de Ozimal@
$ENTRY_JOURNAL_INDEX_LEFT_130	Noche 10: @El Monasterio@
$ENTRY_JOURNAL_INDEX_LEFT_140	Día 11: @[healer_hero]@
$ENTRY_JOURNAL_INDEX_LEFT_141	Día 11: @Un manuscrito carcásico@
$ENTRY_JOURNAL_INDEX_LEFT_150	Día 13: @[mage_hero]@
$ENTRY_JOURNAL_INDEX_LEFT_160	Día 14: @Nómadas@
$ENTRY_JOURNAL_INDEX_LEFT_170	Día 15: @Un sueño extraño@
$ENTRY_JOURNAL_INDEX_LEFT_171	Noche 15: @Palabras extrañas@
$ENTRY_JOURNAL_INDEX_RIGHT_01	Día 16: @Palabras aterradoras de labios con cicatrices@
$ENTRY_JOURNAL_INDEX_RIGHT_00	Día 17: @Joya del desierto@
$ENTRY_JOURNAL_INDEX_RIGHT_02	Noche 17: @El zorro@
$ENTRY_JOURNAL_INDEX_RIGHT_10	Día 18: @[knight_hero]@
$ENTRY_JOURNAL_INDEX_RIGHT_20	Día 19: @Carta de [knight_hero]@
$ENTRY_JOURNAL_INDEX_RIGHT_30	Noche 19: @Mi respuesta: Borrador 1@
$ENTRY_JOURNAL_INDEX_RIGHT_40	Día 20: @Respuesta de [knight_hero]@
$ENTRY_JOURNAL_INDEX_RIGHT_50	Día 21: @Carta de <LQ>[knight_hero_up]<RQ>@
$ENTRY_JOURNAL_INDEX_RIGHT_60	Noche 21: @A/A: [berserker_hero]@
$ENTRY_JOURNAL_INDEX_RIGHT_70	Noche 22: @[dragon_hero]@
$ENTRY_JOURNAL_INDEX_RIGHT_71	Día 23: @Discurso@
$ENTRY_JOURNAL_INDEX_RIGHT_72	Día 24: @Asesino@
$ENTRY_JOURNAL_INDEX_RIGHT_73	Día 24: @La muerte de una superoveja@
$ENTRY_JOURNAL_INDEX_RIGHT_80	Noche 24: @Apéndice@
$ENTRY_JOURNAL_INDEX_RIGHT_81	Día 25: @Galimatías@
$ENTRY_JOURNAL_INDEX_RIGHT_90	Día 25: @Segundo sueño@
$ENTRY_JOURNAL_INDEX_RIGHT_91	Día 26: @La historia de [mage_hero]@
$ENTRY_JOURNAL_INDEX_RIGHT_92	Día 27: @La maldad interior@
$ENTRY_JOURNAL_INDEX_RIGHT_93	Día 27: @La historia de [knight_hero]@
$ENTRY_JOURNAL_INDEX_RIGHT_100	Día 28: @La muerte del hombre de rojo@
$ENTRY_JOURNAL_INDEX_RIGHT_110	Día 29: @Tercer sueño@
$ENTRY_JOURNAL_INDEX_RIGHT_117	Día 30: @Sueño y locura@
$ENTRY_JOURNAL_INDEX_RIGHT_111	Día 32: @La Emperatriz@
$ENTRY_JOURNAL_INDEX_RIGHT_112	Día 33: @Los Túnicas Negras@
$ENTRY_JOURNAL_INDEX_RIGHT_113	Día 33: @Cuarto sueño@
$ENTRY_JOURNAL_INDEX_RIGHT_114	Día 34: @no vuelvas a poner las zarpas en mi diario@
$ENTRY_JOURNAL_INDEX_RIGHT_115	Día 34: @Quinto sueño@
$ENTRY_JOURNAL_INDEX_RIGHT_116	Día 35: @Sexto sueño@
$ENTRY_JOURNAL_INDEX_RIGHT_120	Día 35: @El trono de Eztli@
$ENTRY_JOURNAL_INDEX_RIGHT_121	Día 36: @Evni@
$ENTRY_JOURNAL_INDEX_RIGHT_130	Día 37: @Tletl-Meztli@
$ENTRY_JOURNAL_INDEX_RIGHT_131	Día 38: @¿Paz?@
$ENTRY_JOURNAL_INDEX_RIGHT_132	Día 38: @Sueño de despedida@
$ENTRY_JOURNAL_INDEX_RIGHT_140	Día 39: @La elección@
$ENTRY_JOURNAL_INDEX_RIGHT_150	Día 40: @Siguiendo a Zelemir@
$ENTRY_JOURNAL_INDEX_RIGHT_160	@Epílogo@
$ENTRY_JOURNAL_INDEX_RIGHT_170	@Apéndice@
$ENTRY_JOURNAL_INTRO_TITLE	
$ENTRY_JOURNAL_INTRO_LEFT_00	Día 1 - ¿Dónde estoy?
$ENTRY_JOURNAL_INTRO_LEFT_10	Puede que haya perdido el juicio, sin embargo, debo intentar plasmar por escrito los acontecimientos que estoy presenciando. El lector podrá sacar sus propias conclusiones: solo contaré los hechos tal y como los percibe mi mente febril.<N><N>Sé que contraje la peste que asola nuestra hermosa capital. También sé que, al igual que a las otras víctimas que hubo, me llevaron fuera de la ciudad y me arrojaron al Foso. A partir de ese momento he pasado por una serie de sucesos tan extraños y aterradores que todavía me pregunto si estoy despierta o soñando.<N><N>Cuando la fiebre se apoderó de mi cuerpo, me vi en un lugar oscuro, frente a otra víctima.
$ENTRY_JOURNAL_INTRO_RIGHT_00	Entonces apareció un espléndido trono y un hombre como ningún otro que hubiese visto sentado en él. Todo su ser al completo era dorado. Al principio pensé que debía ser una estatua, pero al momento pronunció una orden. Su voz también era dorada y el filo de sus palabras restallaba con la potencia de un trueno. Era una lengua que jamás había escuchado o leído en toda la Gran Biblioteca de Ash, pero mi cuerpo obedeció su orden. Mis venas se tensaron como si la sangre fuera a brotar de mi cuerpo y deseara unirse a él. El corazón se me desboca solo de pensarlo.<N><N>-[mcguffin_hero] Livbar
$ENTRY_JOURNAL_SLAK_TITLE	
$ENTRY_JOURNAL_SLAK_LEFT_0_00	Noche 1 - [berserker_hero]
$ENTRY_JOURNAL_SLAK_LEFT_0_10	Cuando escribo sobre [berserker_hero], siento que debo dejar a un lado el solemne lenguaje de la capital y adoptar una lengua vernácula más adecuada al sujeto.<N><N>[berserker_hero] es un tonto del culo. Es como un culo que también es tonto.<N><N>Lo que le falta de intelecto le sobra de hedor. Si dos montones de estiércol quemado pudieran aparearse y engendrar prole, su pútrida descendencia se estremecería frente a la pestilencia que emana de las axilas descubiertas de [berserker_hero]. De hecho, los cadáveres resucitados que nos persiguen son todo un perfume exquisito en comparación.<N><N>Pero [berserker_hero] es más que una cara bonita. También demuestra una personalidad más que encantadora que solo podría describir como <LQ>loco de remate<RQ>.<N><N>Ayer discutió durante quince minutos con una piedra contra la que se había golpeado el dedo del pie. Y perdió.
$ENTRY_JOURNAL_SLAK_RIGHT_0_00	Realmente es una bendición viajar con tales compañías.
$ENTRY_JOURNAL_SLAK_RIGHT_0_10	Día 3 - Apéndice
$ENTRY_JOURNAL_SLAK_RIGHT_0_20	Siendo objetiva, también debo admitir que es el hombre más valiente que he conocido. Todo su cuerpo es un entramado de cicatrices de guerra, aunque en cierto modo me siento menos impresionada cuando pienso en que se niega a llevar ningún tipo de prenda o armadura sobre el torso. En resumidas cuentas: es a la vez un bufón insoportable y un guerrero sorprendentemente competente, y no tengo más remedio que estar contenta de que esté conmigo.
$ENTRY_JOURNAL_SLAK_RIGHT_0_30	<N>OHHHH YO TAMBIEN TE QUIERO! BESITO<N><N><N><N><N><N><N><N>YO NO DUERMO SIMPLEMENTE ME TUMBO BOCA ABAJO PARA FORTALECER MIS GLUTEOS
$ENTRY_JOURNAL_SLAK_RIGHT_0_40	<N>¡Parece que también sabe leer y escribir! ¿Cómo demonios tiene estudios este espécimen sediento de sangre?<N>P. D.: Si vuelves a robarme el diario otra vez, te descalabraré mientras duermes.
$ENTRY_JOURNAL_SLAK_LEFT_1_00	Noche 3 - segundo apéndice
$ENTRY_JOURNAL_SLAK_LEFT_1_10	Vale, para que conste, [berserker_hero] duerme desnudo. Cualquier intento de venganza tendrá lugar durante el día a partir de ahora.<N><N>Y sí, hay cicatrices incluso por debajo de la cintura.<N><N><N><N><N>Te odio.
$ENTRY_JOURNAL_SLAK_LEFT_1_20	<N>QUÉ TE PENSABAS QUE KHAN Y CHARISSA NO IBAN A LUCHAR TAMBIEN?
$ENTRY_JOURNAL_PRISON_TITLE	
$ENTRY_JOURNAL_PRISON_LEFT_0_00	Día 3 - Prisión
$ENTRY_JOURNAL_PRISON_LEFT_0_10	Hace tres días habría dicho que este Foso es una prisión.  Ahora me doy cuenta de que incluso en el infierno siempre puede haber algo peor.<N><N>El hombre que nos retiene se hace llamar Ozimal Kaz.  Es un ser cruel, mezquino y odioso.  Cómo un compatriota ha podido convertirse en alguien tan retorcido es algo que escapa a mi entendimiento.  Esperaría esto de los quaidís, que se han dedicado a perfeccionar su crueldad sobre las provincias del este durante las dos últimas décadas.  Incluso los jefes tribales nómadas más despiadados controlarían su ira sangrienta mejor que este degenerado.<N><N>¡Y a juzgar por su acento, es de la mismísima capital!  ¡Este monstruo creció a la sombra del propio Templo!
$ENTRY_JOURNAL_PRISON_RIGHT_0_00	Me encuentro con los otros prisioneros que ha retenido: bandidos y forajidos, hombres, mujeres, niños, ashianos, nómadas, quaidís, todos esperando a morir a manos de este hombre.  Día y noche escuchamos los quejidos continuos de los zombis encerrados, una cacofonía ensordecedora interrumpida solamente por los gritos agonizantes de su última víctima.<N><N>Y heme aquí, ¡incapaz de actuar!  Ojalá estuviera en el coliseo con estas desdichadas víctimas, al menos tendrían la posibilidad de luchar.  A pesar de su bravuconería, Ozimal duda ante la idea de <LQ>ejecutarme<RQ> por segunda vez.  Puede que Ozimal tema perder demasiados zombis cautivos; no debe ser fácil capturarlos o mantenerlos, y parece que para sus viles fines necesita tener controlados a sus vasallos.
$ENTRY_JOURNAL_PRISON_LEFT_1_00	Las palabras de mi misterioso aliado resuenan constantemente en mi cabeza.  Ozimal desea mostrarle mis habilidades a un <LQ>hombre de rojo<RQ>.  ¿Quién es este hombre de rojo?  ¿Y quién es este misterioso desconocido tan decidido a salvarme?  ¿Por qué soy tan importante?  Solo estoy segura de algo entre esta marea de preguntas: hasta ahora solo he practicado la violencia contra aquellos que ya estaban muertos, pero si logro ponerle las manos encima a Ozimal, esta política estará sujeta a cambio.
$ENTRY_JOURNAL_HALFWAY_WORLD_TITLE	
$ENTRY_JOURNAL_HALFWAY_WORLD_LEFT_0_00	Día 4 - El Mundo Intermedio
$ENTRY_JOURNAL_HALFWAY_WORLD_LEFT_0_10	<LQ>Mundo Intermedio<RQ> es lo mejor que logro encontrar entre mis débiles palabras para describir el lugar en el que me encuentro y al que llevo a los demás.<N><N>En una ocasión, cuando era muy pequeña, casi me ahogo nadando en los bajíos del Kevel.  Es la única experiencia semejante que se me ocurre.  El mismo pánico, la misma agonía jadeante cuando mi corazón intenta escapar de mi pecho.  Pero en esta ocasión la mano de mi padre no me arrastrará hasta un lugar seguro.  No hay orilla a la que aferrarse, solo el instante de la muerte que se prolonga una eternidad.<N><N>La explicación sobre cómo llego a este lugar está más allá de mi entendimiento.  Lo único que sé es que voy allí cuando es necesario.  Una vez allí puedo sentir a mis compañeros, no puedo verlos, pero soy consciente de ellos como si fueran partes de mi cuerpo a las que no necesito ver.  Simplemente sé que están allí y los llamo con la fuerza que tengo.  Esta fuerza es menuda, y ejercito estos poderes con la debilidad de un bebé que mueve su cuerpo, pero es suficiente para salvar la vida.
$ENTRY_JOURNAL_HALFWAY_WORLD_RIGHT_0_00	Aunque aborrezco hacer este viaje al aterrador mundo intermedio, definitivamente es mejor que el destino al que tendría que enfrentarme sin él.
$ENTRY_JOURNAL_AN_EDUCATION_TITLE	
$ENTRY_JOURNAL_AN_EDUCATION_LEFT_0_00	Día 4 - Tiene estudios
$ENTRY_JOURNAL_AN_EDUCATION_LEFT_0_10	Hoy mismo, con la mente todavía dando vueltas por el aturdimiento de nuestra última victoria, encontré un trozo de pergamino en el suelo. Ansiosa por reponer mis propias existencias, que por desgracia son limitadas, me abalancé sobre la página abandonada. Enseguida aprecié su gran calidad, algo que me sorprendió. Aunque los bordes y los pliegues denotaban el deterioro de haber viajado por el Foso, su grosor y su inmaculada tonalidad de color crema no podían esconder la riqueza de donde procedía. Sin duda no se trataba del borrador de un escriba.<N>En ese momento vi el sello del Lord Regente. Mis ojos ávidos llegaron a la primera línea:
$ENTRY_JOURNAL_AN_EDUCATION_LEFT_0_20	<N><LQ>Tú, descarriada escoria deambulante que apenas merece ser considerada mi hijo,<RQ>
$ENTRY_JOURNAL_AN_EDUCATION_LEFT_0_30	Inundada por lo que Zenimon el Sabio definió como <LQ>dicha por la calamidad del prójimo<RQ>, seguí leyendo con una curiosidad vergonzante:
$ENTRY_JOURNAL_AN_EDUCATION_LEFT_0_40	<LQ>No puedo expresar mi ira con palabras. Vashtal me ha informado de que tras su llegada a las tierras carcásicas,
$ENTRY_JOURNAL_AN_EDUCATION_RIGHT_0_00	descubrió que no estabas asistiendo a la Universidad tal y como te ordené en aras de tu mejora y seguridad, sino que se encontró a un bárbaro nómada de la plebe estudiando por ti y suplantando tu nombre. Este infame bárbaro confirmó que había recibido como pago una cantidad de oro nada desdeñable por cursar los estudios en tu lugar, mientras que tú, sin duda, vagabundeabas por las tierras salvajes en busca de – <RQ>
$ENTRY_JOURNAL_AN_EDUCATION_RIGHT_0_10	El resto del texto es un misterio para mí; justo en el punto en el que la narrativa se ponía especialmente interesante, [berserker_hero] me arrancó la página de las manos, la apretó hasta formar una bola y se la comió mientras me gritaba a la cara <LQ>¡Sabe a mentiras! ¡A mentiras y a oveja muerta! ¡Pero sobre todo a mentiras!<RQ>. Su aliento deja mucho que desear.<N><N>Después le lanzó una piedra a [ranger_hero] y los dos se enzarzaron en una pelea a manotazos que duró media hora.
$ENTRY_JOURNAL_BOOKKEEPING_TITLE	
$ENTRY_JOURNAL_BOOKKEEPING_LEFT_0_00	Día 4 - Teneduría de libros
$ENTRY_JOURNAL_BOOKKEEPING_LEFT_0_10	Tras liberar a los últimos prisioneros de la patética guarida de Ozimal, debo confesar, avergonzada, que disfruté sobremanera al saquear los cuarteles personales de esa escoria. Los pocos guardias que quedaban huyeron al contemplar nuestra victoria contra los zombis entrenados, con lo que dejaron las cámaras del mezquino tirano listas para el pillaje. Nos hicimos con todo lo que podíamos cargar de su alacena privada: salchichas, aceite y una importante cuota de quesos que nos ayudará en el viaje. Me habría gustado incendiar el resto, pero temía que el humo resultante desvelara nuestra posición y azuzara la vuelta del villano y su ejército. Parecía como si [berserker_hero] pudiera percibir mi frustración, así que él mismo se dispuso a <LQ>profanar<RQ> los alimentos que quedaban. Después siguió con la profanación de la cama, gran parte del suelo y algunas paredes. No fue un acto que alguien de mi condición o sexo debería aprobar, pero me resulta difícil no sonreír cuando pienso en el desagradable hallazgo que le espera a Ozimal cuando vuelva.<N><N>Parece ser que [berserker_hero] bebe una cantidad de agua sorprendente.
$ENTRY_JOURNAL_BOOKKEEPING_RIGHT_0_00	Desafortunadamente, mi júbilo fue breve. En el púlpito de Ozimal encontré (justo antes de la <LQ>profanación<RQ>) varios retazos de pergamino que conformaban la teneduría de libros de su imperio. Al repasarlos ahora puedo ver expuestas, de la forma más objetiva posible, las cifras de los tributos recaudados, los castigos impuestos, los esclavos apresados... Escribe sobre las vidas humanas como si solo se tratara de jamones ahumados que tiene que guardar en su alacena un comerciante ocupado.<N><N>Hay un manuscrito en particular que no puedo borrar de mi mente.
$ENTRY_JOURNAL_BOOKKEEPING_RIGHT_0_10	<N><LQ>Se necesita:<N><N>* Para el Coleccionista Rojo – supervivientes de apariencia o capacidades inusuales.<N>* Para el hombre de Quaid – mujer joven, quaidí, rubia, con cicatrices en el rostro, es posible que esté con los Selini. Se busca muerta. Deberá acreditarse con pruebas.<N>*Para el vendedor de esclavos – chicas nómadas, guapas. Se pagará más por las jóvenes.
$ENTRY_JOURNAL_BOOKKEEPING_LEFT_1_00	*Para el contacto de Ash – prueba de la muerte del Lord Guardián.<N>*Para el Filósofo de la Universidad – carne conservada de los infectados, talismanes de calavera, amuletos relacionados.<N>*Para los Túnicas Negras – supervivientes ashianos, mejor si acaban de llegar.<N>*Para el Carcásico – niño, rasgos nómadas, pelo blanco, posiblemente viajando acompañado de otro idéntico. Se busca muerto. Deberá acreditarse con pruebas<RQ>.
$ENTRY_JOURNAL_BOOKKEEPING_LEFT_1_10	<N>Ver mi propio destino, que en su momento parecía fantástico a la par que horrible, en una lista de fechorías planeadas es una experiencia que me devuelve a la realidad. Creía que la miseria que me había tocado vivir era una excepción. Ahora veo que tales cosas son simplemente las operaciones diarias de la ruin empresa de Ozimal.<N><N>Creo que lo más triste de todo es darse cuenta de que muchos de estos crímenes se iban a cometer por
$ENTRY_JOURNAL_BOOKKEEPING_RIGHT_1_00	mandato de personas que no se encontraban en el Foso. ¿Acaso hay algo que este terrible lugar pudiera ofrecer al mundo exterior?<N><N>Ciertamente vivimos tiempos oscuros si los hombres van al infierno en busca de nuevos demonios.
$ENTRY_JOURNAL_KETTA_TITLE	
$ENTRY_JOURNAL_KETTA_LEFT_0_00	Día 5 - [ranger_hero]
$ENTRY_JOURNAL_KETTA_LEFT_0_10	Creo que lo que más me gusta de [ranger_hero] es que huele como las cabras.<N><N>O sea, es una elección difícil con todas sus otras bellas cualidades como inmadurez descontrolada, comentarios desdeñosos constantes, sarcasmo propio de mentecatos, una afición por los robos mezquinos y hábitos alimenticios espantosos, pero cuando compartes una tienda con alguien, el acre aroma a cabra es lo que realmente te seduce.<N><N>Algunas noches la brisa sopla en la parte del campamento de los hombres, trayendo en sus etéreos brazos el inconfundible aroma de [berserker_hero]. La mezcla de aromas resultante solo puede describirse como divina. Estas noches son las que me deparan el mejor reposo, ya que mi cuerpo elige la inconsciencia en vez de intentar comprender los estímulos aromáticos a los que mis sentidos se enfrentan.
$ENTRY_JOURNAL_KETTA_RIGHT_0_00	Día 8 - Apéndice
$ENTRY_JOURNAL_KETTA_RIGHT_0_10	Anoche, [ranger_hero] me despertó gritando en idioma nómada. En un primer momento pensé que quizás estaba soñando con la destrucción que acabábamos de presenciar; unas imágenes que también siguen acechando mi mente despierta. Sin embargo, tras evocar mi escaso dominio del idioma nómada, me di cuenta de que su grito se podría traducir como <LQ>Mujer de cuestionable moral, ¡él será mío!<RQ> Tras haber emitido este mensaje ciertamente confuso, me arrancó un mechón enorme de pelo, lo metió bajo su almohada e inmediatamente se quedó dormida.<N><N>[ranger_hero] se ha mostrado irreconociblemente arrepentida, hasta el punto de enseñarme cómo trenzar pelo de caballo en mi propio cabello para disimular el trasquilón. Asegura que no tiene ni idea qué tipo de sueño provocó su arrebato. Yo todavía me mantengo escéptica.
$ENTRY_JOURNAL_AZRA_BY_SLAK_TITLE	
$ENTRY_JOURNAL_AZRA_BY_SLAK_LEFT_0_00	Día 10 - ¡[mcguffin_hero] es tonta!
$ENTRY_JOURNAL_AZRA_BY_SLAK_LEFT_0_10	ASI QUE PENSABAS QUE SOLO PORQUE NO PUEDO LEER TU ESTUPIDO LENGUAJE TAN SOFISTICADO NO ME IBA A ENTERAR DE LO QUE HAS ESTADO ESCRIBIENDO SOBRE MI?<N><N>BUENO, PUES SABES QUE, PRINCESA? VAMOS A ESCRIBIR UNA ENTRADA EN EL DIARIO SOBRE TI!<N><N>QUE PODRIA DECIR SOBRE [mcguffin_hero_up]? QUE SU CARA ES TAN DELGADA QUE PARECE UN PEZ? Y SU CUELLO ES TAN TAN TAN DEMASIADO LARGO PARA SU CUERPO.<N><N>Y SUS OREJAS PARECEN ALBARICOQUES MARCHITOS. Y SU PELO ES ESTÚPIDO Y PAJIZO. Y SU HIGIENE PERSONAL NO ES NI MUCHO MENOS TAN PERFECTA COMO CREE.
$ENTRY_JOURNAL_AZRA_BY_SLAK_RIGHT_0_00	QUE TE PARECE, TONTAINA? SUPONGO QUE AHORA SE QUIENES SON MIS AMIGOS DE VERDAD.<N><N><N><N>ATENTAMENTE<N><N>[ranger_hero_up] A LA QUE LE GUSTA COMER CACA EH [berserker_hero_up] POR QUE ESTAS TARDANDO TANTO EN ESCRIBIR MI NOMBRE?
$ENTRY_JOURNAL_KARSK_BURNED_TITLE	
$ENTRY_JOURNAL_KARSK_BURNED_LEFT_0_00	Noche 7 - La destrucción de Karsk
$ENTRY_JOURNAL_KARSK_BURNED_LEFT_0_10	La muerte no es algo desconocido para mí. Los últimos nueve meses en los que la peste asoló la capital me despojaron de cualquier ignorancia infantil que hubiera podido tener debido a mi posición privilegiada. Pero nunca antes había visto una destrucción tan violenta. Incluso las piras con cadáveres al otro lado de las puertas del Templo palidecerían en comparación. <N><N>No tengo palabras.<N><N>Ahora comprendo la naturaleza de nuestro enemigo.
$ENTRY_JOURNAL_LAKSOS_TITLE	
$ENTRY_JOURNAL_LAKSOS_LEFT_0_00	Día 8 - Laksos
$ENTRY_JOURNAL_LAKSOS_LEFT_0_10	Durante nuestra estancia en Laksos, presenciamos un extraño ritual nómada. En la tribu de los Karada, una pequeña comunidad que se mantiene unida, nació un niño del jefe de la tribu. Los padres presentaron al niño frente a dos enormes ídolos de madera. <N><N>El jefe mostró un pequeño bloque de madera que depositó en la cabeza de cada ídolo y después en la cabeza del niño. Después sacó un pequeño cuchillo y talló el bloque, dejando que las virutas cayeran sobre la cara del pequeño. Una vez hubo terminado, enhebró la talla en un tendón de animal y lo colocó en el cuello del niño. <N><N>Hubo un grito desgarrador y los miembros de la tribu, todos a una, empezaron a bailar, corear y celebrar al estilo tradicional nómada. No fui capaz de apreciar lo que el jefe había tallado.
$ENTRY_JOURNAL_LAKSOS_RIGHT_0_00	Después le pregunté a [ranger_hero] lo que significaba ese ritual y me mostró un pequeño zorro de madera que colgaba de su cuello. Me dijo que su espíritu era el sirviente de los dioses de su tribu, que le había sido concedido al nacer como guardián y guía y que la enterrarían con él tras su muerte para garantizarle un viaje seguro al paraíso. De igual modo que el Creador otorgaba dioses tribales a las tribus, los espíritus personales se otorgaban a cada miembro de la tribu tras su nacimiento. <N><N>Le pregunté a [ranger_hero] que si perder un ídolo personal era tan horrible para una persona como lo es la pérdida de los ídolos tribales de la tribu. Ella me sonrió y me mostró siete ídolos que había cogido de sus enemigos, mientras me explicaba que ahora sus almas tardarían siglos en encontrar el paraíso. Le pregunté si no le preocupaba haberle hecho tal cosa a sus compañeros nómadas y me miró con los ojos entornados, tras lo cual me preguntó que si no me preocupaba que mis orejas fueran demasiado grandes para mi cara y después se alejó cantando algo sobre comer lenguas de cabra. Un día de estos voy a pegarle una pedrada.
$ENTRY_JOURNAL_JOURNEYS_TITLE	
$ENTRY_JOURNAL_JOURNEYS_LEFT_0_00	Día 9 - Viajes
$ENTRY_JOURNAL_JOURNEYS_LEFT_0_10	Cada vez domino más el arte de caminar y escribir a la vez. No hay mucho más que hacer mientras viajamos, excepto escuchar la interminable cháchara de mis compañeros o pensar en el terrible misterio del enemigo que nos persigue, dos actividades de las que agradecería distraerme de tanto en tanto. Y de ahí este diario.<N><N>Nunca me he considerado una viajera; he pasado mis 23 años de vida en la capital y sus alrededores. Mi infantil espíritu viajero se satisfacía con las palabras escritas.<N><N>En esos momentos ociosos de ensoñación en los que contemplaba fantasías de viajes, siempre pensé que sería en pos de nuestros hermanos del oeste. Qué interesante sería seguir a los peregrinos del Templo en su viaje de regreso a casa, hombres de las montañas, morenos como los nómadas, y tras ellos hombres aún más morenos, gente de los mares, todos unidos por el camino de Selinadt. Siete reinos unidos por la verdad de la Fuente.<N><N>Si buscaba el miedo y la emoción de las tierras bárbaras,
$ENTRY_JOURNAL_JOURNEYS_RIGHT_0_00	solo tenía que mirar el gran mapa de los viajes de Kezmir Zentbar expuesto en la pared del ala norte de la Biblioteca. Desde allí mis ojos ávidos podían viajar al norte, al reino de los carcásicos, a los que nos referimos como a un conjunto, pero que son tantos y tan variados que Gozal el Sabio afirmó que las gentes de cualquiera de sus tres ciudades estado eran tan diferentes como Ash, Quaid y Nomadia. Y más allá estaban las tierras más inhóspitas de todas, los terrores fantásticos de las costas desconocidas y la gran montaña en la que Kezmir grabó la leyenda <LQ>Aquí moran los devoradores de la luna<RQ>.<N><N>Mi viaje es deprimente en comparación; me encuentro a las afueras de Ash y todo lo que me resultaba familiar se ha vuelto gris y funesto.
$ENTRY_JOURNAL_OZIMAL_DEAD_TITLE	
$ENTRY_JOURNAL_OZIMAL_DEAD_LEFT_0_00	Día 10 - La muerte de Ozimal
$ENTRY_JOURNAL_OZIMAL_DEAD_LEFT_0_10	Pensaba que la muerte de Ozimal me haría sentir un poco mejor.  No ha sido así.<N><N>Simplemente era otro cadáver más con ojos vidriosos que se arrastraba, rendido a la voluntad de nuestro enemigo; había sido un peón incluso antes de su muerte.  El mundo se ha librado de un hombre malvado y retorcido.  Pero aquí, en el Foso, ¿acaso le importa a alguien?
$ENTRY_JOURNAL_MONASTERY_TITLE	
$ENTRY_JOURNAL_MONASTERY_LEFT_0_00	Noche 10 - El Monasterio
$ENTRY_JOURNAL_MONASTERY_LEFT_0_10	Supongo que debo haber sido una ilusa al esperar que hubiera algo en el Foso parecido a un hogar, pero todavía me impresiona ver el monasterio Selini aquí.  Es una estructura imponente y ominosa que tiene más de fortaleza que de templo.  Comprendo que tales precauciones son necesarias, pero me resulta difícil asimilarlo comparado con la Fuente del Templo en la que crecí, en la que incluso los guardias llevan armas romas por temor a sembrar el caos y la destrucción en un lugar de paz.<N><N>Mojar las manos en la Fuente era una sensación reconfortante, con la certeza de que estaba en el mismo lugar que todos los creyentes que por allí pasaron, hasta el mismísimo Selinadt.  Era una humilde servidora, y lo único que me separaba de reyes y profetas era el tiempo.<N><N><LQ>Al igual que el agua se alza como bruma sobre el valle, cae como nieve sobre las montañas y desciende por los ríos hasta el mar, cada hombre, nacido de la misma esencia, debe servir
$ENTRY_JOURNAL_MONASTERY_RIGHT_0_00	en las distintas tareas de su época y así alcanzar la armonía de la Máquina Celestial<RQ>.<N><N>Me pregunto qué tarea me espera en este anárquico y terrible lugar, en el que la paz y la sabiduría no son más que fantasías lejanas.<N><N>La fortaleza del templo ofrece consuelo, al parecer.  ¿Acaso no cumplen estos monjes con su cometido?  Estas imponentes murallas defensivas no son más que las adaptaciones que permiten servir al espíritu de Selinadt en este despiadado lugar.<N><N>Como dijo el gran hombre, <LQ>La verdad siempre es la verdad, no importa en qué lengua esté escrita<RQ>. Estas defensas solo son la lengua que se habla en el Foso; la verdad de su interior sigue siendo la verdad.
$ENTRY_JOURNAL_BAKAL_TITLE	
$ENTRY_JOURNAL_BAKAL_LEFT_0_00	Día 11 - Anciano [healer_hero]
$ENTRY_JOURNAL_BAKAL_LEFT_0_10	El anciano reverendo [healer_hero] es un oasis de cordura en este desierto de caos.  Aunque la premura de nuestras huidas deja poco tiempo para conversar, las parcas palabras que puedo intercambiar con él me ayudan a animarme.<N><N>Ojalá pudiera ofrecerle lo mismo.  Parece que lo atormenta cierta angustia interna.  Puedo percibirlo de vez en cuando, borboteando bajo su tranquilo rostro monacal.  Es demasiado obvio que fue un soldado: las cicatrices, los modales y los gestos denotan una vida de guerrero.  <N><N>En el monasterio, me di cuenta de que no pertenece al sacerdocio, aunque todos los que le conocen lo llaman anciano reverendo.  De hecho, no ostenta una posición de autoridad, al menos no de manera oficial.  Con todo, los demás le piden consejo a menudo y le siguen como si fuera un superior.  El mismísimo Lord Abbot no parecía más que un discípulo.
$ENTRY_JOURNAL_BAKAL_RIGHT_0_00	Nuestra aventura parece alterar e inspirar a [healer_hero], como si su alma estuviera de alguna manera pendiendo de un hilo.  Ahora entiendo porque [ranger_hero] le teme.  A menudo veo en sus ojos una determinación que rivaliza con la de nuestro perseguidor.  Rezo porque [healer_hero] algún día pueda hallar en su vida la paz que ofrece a los demás.
$ENTRY_JOURNAL_MANUSCRIPT_TITLE	
$ENTRY_JOURNAL_MANUSCRIPT_LEFT_0_00	Día 11 – Un manuscrito carcásico
$ENTRY_JOURNAL_MANUSCRIPT_LEFT_0_10	<N>Una vez despejada toda amenaza, el río de la parte exterior del Capitolio de [healer_hero] nos ha procurado un gran botín. Tras haber terminado con los zombis, [berserker_hero] dedicó el resto del día a despoblar salvajemente lo que quedaba en el río. Aunque el banquete resultante de pescado asado ha calmado mi estómago, uno de los cadáveres de los zombis hace que mi mente siga despierta.<N><N>Entre todas las repugnantes hordas que purgamos en el río, había un cuerpo que destacaba del resto. Tiempo atrás había sido un heraldo de bastante importancia, a juzgar por la calidad de sus ropajes, y el curioso patrón y corte de su atavío me hace pensar que procedía de una de las numerosas ciudades estado del norte. Aunque el resto de su guarnición estaba demasiado podrida por la humedad y no se podía aprovechar, en el cinto llevaba una funda estanca de piel encerada. En su interior descubrí una pieza de pergamino todavía legible.<N><N>El contenido corrobora mi teoría respecto al origen del hombre. Parece que el texto está escrito en uno de los
$ENTRY_JOURNAL_MANUSCRIPT_RIGHT_0_00	muchos idiomas norteños que desgraciadamente no conozco (mi propia especialización es la lengua de Ash, tanto antigua como moderna, y los dialectos de la gente de los alrededores, especialmente de nuestros hermanos del oeste).<N>Quizás el hecho de que mi mente todavía disfrute con estos acertijos, aun estando rodeada de muerte y dolor, sea síntoma de una gran falta de ética. Para mí es un gran consuelo, aunque también se trate de un gran egoísmo, no atender al oscuro y sangriento mundo en el que se ha convertido mi vida y dedicar por completo mi energía a descifrar un manuscrito misterioso. Si cierro los ojos casi puedo sentir que estoy de vuelta en la Biblioteca. A pesar de desconocer el idioma, ya he sido capaz de sonsacar algunos detalles por mi cuenta. Puedo ver repetido varias veces lo que parece ser un grupo de glifos utilizados en el idioma nómada (una lengua de la que, a riesgo de sonar presuntuosa respecto a mi pericia lingüística, debo admitir que poseo un leve dominio). A grandes rasgos se podría traducir por <LQ>mujer ornamentada<RQ> o <LQ>Reina<RQ> (tal y como he visto que se usa en algunos textos), aunque quizás <LQ>Mujer de Muchos Símbolos<RQ> estaría más próximo al significado literal. La disposición del texto que lo rodea
$ENTRY_JOURNAL_MANUSCRIPT_LEFT_1_00	 me hace sospechar que este préstamo del nómada puede ser un nombre propio, posiblemente el del autor del manuscrito, o quizás el del destinatario.<N><N>Hasta aquí llegan las averiguaciones que he podido hacer yo sola. Podría pedirle ayuda a [healer_hero]; según he podido saber, posee un manejo nada desdeñable de varias de las lenguas carcásicas.<N><N>APÉNDICE:<N><N>Es cierto que [healer_hero] domina estos conocimientos tal y como dijeron los demás monjes. A pesar del enigmático dialecto, fue capaz de presentarme una traducción de la primera línea del texto en un corto espacio de tiempo<N><N><LQ>Vuelve conmigo, amada mía.<RQ> Los siguientes avances fueron significativamente más lentos, y la interpretación resultante no era ni mucho menos completa, pero empezó a dibujarse un panorama extraño. La segunda línea, <LQ>Y con nuestros hijos que sollozan<RQ>, indica que la relación entre el autor y la destinataria era mucho más profunda que un mero lío amoroso.
$ENTRY_JOURNAL_MANUSCRIPT_RIGHT_1_00	A partir de ahí, [healer_hero] me dice que el idioma se torna cada vez más difícil, y las pocas palabras que puede entender parecen un sinsentido que le hacen dudar de su veracidad. <LQ>¿De qué voz dispongo yo para desafiar la que estás escuchando ahora?<RQ> es la única otra declaración completa que [healer_hero] puede descifrar. El resto del texto es un misterio que no logramos desvelar, excepto unas pocas excepciones; una palabra cuyo significado podría ser, según [healer_hero], <LQ>gris<RQ> o <LQ>polvo<RQ>, varias repeticiones de la frase <LQ>vuelves a la sangre<RQ> y muchas ocurrencias del nombre propio que descubrí en un primer momento.<N><N>Al escucharme decir el nombre en voz alta, [ranger_hero] ha corregido mi interpretación del préstamo nómada. En el noreste (de donde parece proceder el manuscrito), la palabra para <LQ>símbolo<RQ> tiene ciertas connotaciones diferentes. Según [ranger_hero], la traducción más precisa de la frase sería <LQ>Mujer de Muchos Amuletos Místicos<RQ>. Por desgracia, las cualidades mágicas de la mujer no aportan nueva información para desentrañar el texto. Solo puedo decir que, como mínimo, había cautivado el corazón del autor. A juzgar por la evidente alta alcurnia de su mensajero, este rey carcásico (me atrevería a decir) no reparó en gastos a la hora de pedir el retorno de su
$ENTRY_JOURNAL_MANUSCRIPT_LEFT_2_00	impredecible mujer de muchos amuletos místicos. ¿Hizo caso de las súplicas de su marido y sus hijos? ¿Llegó siquiera a recibir el mensaje? Dudo que este misterio se conozca jamás.
$ENTRY_JOURNAL_WRENNA_TITLE	
$ENTRY_JOURNAL_WRENNA_LEFT_0_00	Día 13 - [mage_hero_fu]
$ENTRY_JOURNAL_WRENNA_LEFT_0_10	La descripción de Polimon de la realeza quaidí no es una exageración. [mage_hero] es realmente <LQ>más pálida que la luna y dos veces más distante<RQ>. Si yo tuviera que describirla, añadiría que es <LQ>cuatro veces más lunática<RQ>. Nunca había visto a nadie alternar tantos estados de locura a tal velocidad. Incluso la insensatez de [berserker_hero] es más constante. [mage_hero] es como un mar furioso: en un instante se vuelve endiabladamente astuta y de repente pasa a ser totalmente ingenua. A menudo sus acciones parecen una estratagema bien orquestada, y justo cuando creo que se confirman mis sospechas, se apodera de ella una peligrosa locura infantil a la que ningún ser racional osaría enfrentarse. <N><N>A veces creo ver a una chica como yo tras esa locura: asustada, sola y con un poder horrible que no desea. Me pregunto si ella también puede verlo.
$ENTRY_JOURNAL_NOMADS_TITLE	
$ENTRY_JOURNAL_NOMADS_LEFT_0_00	Día 14 - Nómadas
$ENTRY_JOURNAL_NOMADS_LEFT_0_10	Ha sido muy interesante ver en persona a las tribus nómadas, los habitantes indígenas que viven en las estepas y las montañas entre las ciudades de Ash y del Imperio Quaid. Kantimal Polimon, durante su gran travesía hacia el este, documentó más de cien tribus diferentes, aunque creo que muchas de estas han desaparecido tras los estragos de la guerra. En el Foso he conocido a miembros de veintisiete* tribus distintas, pero es imposible saber cuántas han sobrevivido en el mundo exterior.<N><N>Como su propio nombre indica, las tribus viven como nómadas, pastoreando cabras y caballos en las estepas. Este estilo de vida no existe en el Foso, donde la protección hace que sean necesarias unas defensas permanentes.
$ENTRY_JOURNAL_NOMADS_LEFT_0_20	 
$ENTRY_JOURNAL_NOMADS_LEFT_0_30	*Menos de la mitad funcionan como únicas ahora.
$ENTRY_JOURNAL_NOMADS_RIGHT_0_00	Las tribus crean poblados como Karsk, en los que malviven gracias a las cabras y a una agricultura rudimentaria. <N><N>Los nómadas solitarios (aquellos cuya tribu ha sido destruida o se ha disuelto) encuentran cobijo en los asentamientos más cosmopolitas como Laksos, o se convierten en cazadores o mercenarios, llevando misivas y sirviendo de escoltas para los comerciantes de las ciudades del Foso.
$ENTRY_JOURNAL_DREAM1_TITLE	
$ENTRY_JOURNAL_DREAM1_LEFT_0_00	Día 15 - Un sueño extraño
$ENTRY_JOURNAL_DREAM1_LEFT_0_10	Hacía mucho que no tenía un sueño.  La aterradora sensación del mundo intermedio parece dominar mi espíritu tan fuertemente que incluso en mis sueños no siento nada salvo sus ecos.  No obstante, anoche, por primera vez desde las visiones febriles de mi enfermedad, soñé de nuevo.<N><N>El sueño era tan intenso que fue como traer a mi mente todos los horrores de todo lo que he contemplado.  De hecho, parecía como si todas las experiencias de mis 23 años se desvanecieran en su presencia.  <N><N>Me encontraba en una galería elevada.  No era yo misma.  Tenía los brazos morenos y torneados, cubiertos de extraños símbolos y rodeados con bandas doradas.  Mi vestido era una aglomeración de joyas, tantas y tan valiosas que la riqueza de toda una nación palidecería ante el dobladillo de mi prenda.
$ENTRY_JOURNAL_DREAM1_RIGHT_0_00	La gigantesca luna flotaba baja en el cielo teñida de un rojo ardiente.  Podía estirarme y acariciarla con la punta de los dedos.<N><N>Una voz me llamó y me giré.  Había un hombre a mi lado en la galería.  Era alto, mucho más alto que cualquier otro hombre que hubiera visto.  Su barba y su cabello eran largos y oscuros como la noche, ornamentados con anillos de oro.  Su presencia hacía que el mundo se encogiera bajo la oscuridad.<N><N>Su mirada azabache se cruzó con la mía, y supe que éramos uno.  Atraje la luna de fuego hacia nosotros y la dividí.<N><N>Me desperté temblando, apretando la mano contra el corazón como si todavía sostuviese esa luna roja.  Me sobrecogió un anhelo tan grande que no pude contener el llanto.  En ese momento, habría hecho cualquier cosa por volver al sueño.
$ENTRY_JOURNAL_DREAM1A_TITLE	
$ENTRY_JOURNAL_DREAM1A_LEFT_0_00	Noche 15 - Palabras extrañas
$ENTRY_JOURNAL_DREAM1A_LEFT_0_10	A pesar de los tumultuosos acontecimientos del día, [ranger_hero] ha seguido con su imperturbable y repulsiva actitud. Comimos y nos retiramos a los pequeños cuarteles que el hospital nos ofreció como si no hubiera ocurrido nada en absoluto. O eso me pareció en ese momento. Durante la noche, me desperté de la forma más extraña. [ranger_hero] se encontraba allí con la mano tendida hacia mi boca. <LQ>Estabas hablando<RQ>, explicó, mientras se retiraba hasta su jergón. Le pregunté que qué había dicho en sueños, pero simplemente sacudió la cabeza. <LQ>No lo entendía<RQ>, dijo. Sus ojos dejaron ver un miedo que nunca antes había visto en ella. Tras unos largos instantes, cuando creyó que me había vuelto a dormir, empezó a susurrar unas palabras. Solo pude desvelar una mínima parte de sus mudas súplicas, pero una frase nómada llegó hasta mis oídos. Básicamente se traduce como <LQ>Defiéndeme de los extraviados<RQ>.<N><N>Cuando los susurros cesaron y estaba segura de que se había dormido de nuevo, cogí mi diario y empecé a escribir esta entrada bajo la luz titilante del fuego.
$ENTRY_JOURNAL_DREAM1A_RIGHT_0_00	Solo tengo vagas impresiones de las palabras pronunciadas por mis labios inconscientes; sonidos inconexos, extraños y desconocidos. Mientras trataba de retrotraer mi mente a ese estado previo, un recuerdo súbito me asaltó; no las sílabas que había enunciado, sino el significado que intentaban comunicar.<N><N>Empecé a escribir febrilmente, preocupada por que todo se desvaneciera si me detenía a intentar comprender mi pensamiento.<N>A pesar de no ser idónea, he terminado mi transcripción. No sé qué pensar.
$ENTRY_JOURNAL_DREAM1A_RIGHT_0_10	Soy una tormenta<N><N>atrapada y devorándose a sí misma,<N><N>se me ha privado de la muerte,<N><N>el dios que llevo dentro clava sus garras.
$ENTRY_JOURNAL_FEARSOME_WORDS_TITLE	
$ENTRY_JOURNAL_FEARSOME_WORDS_LEFT_0_00	Día 16 – Palabras aterradoras de labios con cicatrices
$ENTRY_JOURNAL_FEARSOME_WORDS_LEFT_0_10	Al viajar con la realeza quaidí me doy cuenta de que mi curiosidad es más poderosa que mi aprensión, para bien o para mal. En cuanto a lo que ella respecta, [mage_hero] me responde alegremente a la mayoría de las preguntas. Siempre las planteo con cierto nerviosismo; no hay forma de saber qué pregunta se encontrará con una sonrisa angelical y qué otra desencadenará su aterradora cólera.<N>Sus estados de humor varían constantemente, y las transiciones entre ellos son erráticas. Dudo que, incluso con años de práctica, pueda ser capaz de prever qué se esconde tras sus ojos grisáceos como la tormenta. En ocasiones, cuando observo su rostro juvenil, a mi mente le cuesta asociarlo con la letanía de atrocidades que su pueblo cometió. Pero otras veces aprecio en la mueca de desdén de sus labios marcados una obsesión fanática capaz de llevar a cabo esos horrores y más.<N><N>Entre el pánico y el caos previo a nuestra última batalla, mientras me preparaba para saltar de este mundo hacia
$ENTRY_JOURNAL_FEARSOME_WORDS_RIGHT_0_00	ese lugar intermedio, mi mente alborotada quedó petrificada por una visión penetrante. [mage_hero] permaneció con la cabeza gacha. Apretó el báculo entre las manos hasta que sus nudillos se tornaron blancos, destellantes en comparación con el apagado tono marfil de su piel. Tenía los ojos cerrados firmemente con la intensidad de alguien que cree que el mundo exterior puede ser forzado a desaparecer con su propia fuerza de voluntad. Sus labios articularon extrañas palabras quaidís una y otra vez hasta que el ritmo de su voz la envolvió como una marea embravecida. Su cuerpo se estremecía. Solo la contemplé una mínima fracción de segundo, pero me pareció vislumbrar la eternidad, como si esta extraña mujer pálida fuera a seguir susurrando su furia hasta el fin de los tiempos y más allá.<N><N>Después del combate, le pregunté qué era lo que estaba diciendo. Pensó unos instantes y sorprendentemente tradujo las palabras al ashiano de forma muy competente:
$ENTRY_JOURNAL_FEARSOME_WORDS_RIGHT_0_10	<N><N>¡Llama, guíame!<N>¡Llama, devórame!<N>¡Reduce mi endeble corazón a cenizas<N>y sustitúyelo con tu voluntad!
$ENTRY_JOURNAL_FEARSOME_WORDS_LEFT_1_00	Tras pronunciar las últimas palabras temblaba por completo. Me observó contemplar su pose temblorosa y se disculpó tímidamente, mientras me explicaba que la <LQ>Cólera Divina<RQ> la había invadido de nuevo.<N><N>Mis pensamientos vuelven una y otra vez a la imagen de su cuerpo agitado en los estertores de la <LQ>Cólera Divina<RQ>, unas palabras aterradoras de unos labios llenos de cicatrices. ¿Qué pasará cuando nos adentremos en estas ruinas quaidís? Tengo dudas de si la tempestad que hay en la mente de [mage_hero] podrá capear el hecho de avanzar entre los esqueletos muertos de su Imperio.
$ENTRY_JOURNAL_FEARSOME_WORDS_TITLE	
$ENTRY_JOURNAL_DESERT_FORTRESS_TITLE	
$ENTRY_JOURNAL_DESERT_FORTRESS_LEFT_0_00	Día 17 - Joya del desierto
$ENTRY_JOURNAL_DESERT_FORTRESS_LEFT_0_10	A menudo me preguntaba cómo serían los hogares de nuestros enemigos del Este. La guerra parecía un terror intangible en la capital, cuya única información provenía de los nefastos informes de pérdidas diarias y los lamentos de los numerosos veteranos tullidos que mendigaban por las calles. <N><N>Tras una vida de terror sin identificar, contemplar una verdadera ciudad quaidí es una experiencia extraña. Me asombra la belleza y la ingeniosidad de su diseño, pero su familiaridad me impacta más que ninguna otra cosa. <N><N>Puedo observar todos los detalles que definen la vida en la ciudad: los gastados adoquines de los caminos trillados, el monumento distorsionado por el vandalismo de varias generaciones de jóvenes, los puestos del mercado ordenados de igual manera que lo estarían en cualquier otra ciudad...
$ENTRY_JOURNAL_DESERT_FORTRESS_RIGHT_0_00	No es difícil imaginar a mi propio padre paseando por estas calles, riendo, maldiciendo e intercambiando historias con los demás ancianos de la ciudad. <N><N>Y con todo, la gente de este lugar destruyó Terna y mató a sus habitantes, a todos y cada uno de sus hombres, mujeres y niños.
$ENTRY_JOURNAL_THE_FOX_TITLE	
$ENTRY_JOURNAL_THE_FOX_LEFT_0_00	Noche 17 - El zorro
$ENTRY_JOURNAL_THE_FOX_LEFT_0_10	Cuando aún era una niña, me encontré un zorro moribundo en los jardines que rodeaban la Biblioteca Real. Para mí es un misterio cómo esta criatura salvaje pudo llegar hasta el corazón de la ciudad, pero su presencia había provocado que los callados patronos abandonaran su meditación y atacaran a la pequeña bestia con piedras y ramas, convirtiendo con su ira los jardines circundantes en un arsenal. Herido y ensangrentado, el zorro se arrastró hasta un escondrijo para morir. Podía escuchar su débil respiración quejumbrosa desde el camino que recorría con mi madre. Salí disparada y me deslicé hasta la entrada del escondrijo. El zorro se quedó petrificado con mi presencia. Contuvo los gimoteos en la boca manchada de sangre. El silencio que mantuvo contenía más dolor e ira que cualquier gruñido de advertencia posible. Clavó los ojos en los míos cuando mi madre tiró de mí hacia el sendero y nos perdimos de vista.<N>He recordado este momento mientras espero en vano que el sueño me asalte. Me preparé para una violenta tempestad, pero [mage_hero] ha caminado entre los salones en ruinas todo el día con templanza, al parecer no se ha visto afectada por los signos de muerte que nos rodean.
$ENTRY_JOURNAL_THE_FOX_RIGHT_0_00	Seguí esperando que la tormenta se desatara, pero cuando lo hizo, no fue para nada lo que esperaba.<N>Mientras recorría los salones y los túneles de esta ruina en busca de pistas de nuestro paradero, me tropecé con un pequeño fragmento de pergamino cubierto por abrasiones y marcas de violencia. Una mitad completa del texto había sido destruida, como si el horror del combate hubiera sido tan encarnizado que ni siquiera las palabras pudieron escapar. El resto parecía escritura quaidí; elegante, pero escrita apresuradamente. Se la mostré a [healer_hero], pero declaró que el resto del escrito no tiene relevancia para nuestra misión. Parecía ansioso por perderlo de vista. No sé por qué hice lo que hice.
$ENTRY_JOURNAL_THE_FOX_RIGHT_0_10	Mi sueño me hace no estar segura de mis propias motivaciones.
$ENTRY_JOURNAL_THE_FOX_RIGHT_0_20	Me gustaría decir que hablé con ella por el anhelo de una amistad, o incluso simplemente por pura curiosidad, pero me temo que mis acciones nacieron fruto del deseo de herir al único objetivo disponible para todos mis miedos y mi odio. Los quaidís han sido la causa invisible de toda mi angustia durante toda mi vida. Tal vez solo quería ver a uno de ellos sufrir el dolor de la pérdida que tan a menudo nos infligieron a nosotros. Puede que su serenidad me irritase. O quizás envidiaba su fuerza y
$ENTRY_JOURNAL_THE_FOX_LEFT_1_00	quería quebrarla. No lo sé.<N><N>Sea cual fuere la razón, cogí el fragmento de pergamino y se lo entregué a [mage_hero]. Se metió en la tienda y salió tiempo después con una traducción recién entintada sobre una piel de oveja. Dice así:
$ENTRY_JOURNAL_THE_FOX_LEFT_1_10	Esta, nuestra Gran Tumba...<N>...último de...<N>Joya del desierto.<N>Nadie debería lamentar... el más grande...<N>Una desgracia, provocada... hijos del hombre...<N>Morimos...<N>... una rotundidad que ni honra...<N>... a los desdichados...<N>Sin excelencia...<N>... cenizas abandonadas...<N>... desdichado...<N>... el mal...
$ENTRY_JOURNAL_THE_FOX_RIGHT_1_00	Obviamente son las palabras de uno de los defensores quaidís, condenados a morir en el asalto. Su elocuencia frente a la muerte, y aún más, la muerte de todos a quienes conocía, me dejó sin palabras. Mientras seguía reflexionando sobre la elegía deteriorada, me impactó descubrir las lágrimas que manchaban el final de la página.<N><N>Abrí la solapa de la tienda de [mage_hero], pero me detuve antes de poder decir nada. Estaba hecha un ovillo en el extremo opuesto. Los mechones lacios de cabello rubio le tapaban la cara. Sus ojos de raposa, enrojecidos por una tristeza que nunca habría imaginado, se encontraron con los míos. Fue el mismo silencio que el de años atrás, repleto de furia y dolor, más del que se puede llegar a expresar con palabras.<N><N>Me marché inmediatamente, pero la escena todavía me atormenta. En esta ocasión fui yo la que lanzó las piedras.
$ENTRY_JOURNAL_THE_FOX_LEFT_2_00	APÉNDICE:<N><N>TENGO UN POEMA PARA TI:
$ENTRY_JOURNAL_THE_FOX_LEFT_2_10	MÚSCULOS...<N>... DEMASIADOS PARA CONTARLOS...<N>SENSUALIDAD... TANTÍSIMA...<N>KHAN... KARISSA...<N>BASTIONES DE GLORIA Y PODER.<N>ALGO IMPRESIONANTE, FORJADO...<N>LOS ABDOMINALES DE [berserker_hero]<N>TANTA MARAVILLA...<N>... GLÚTEOS HIPNÓTICOS...<N>... RELUCIENTES...<N>... PODEROSOS...<N><N>
$ENTRY_JOURNAL_THE_FOX_LEFT_2_20	FALTAN PALABRAS PORQUE FLEXIONÉ UN MÚSCULO Y EL TEJIDO DE LA REALIDAD SE DESGARRÓ.
$ENTRY_JOURNAL_MARKOS_TITLE	
$ENTRY_JOURNAL_MARKOS_LEFT_0_00	Día 18 - [knight_hero]
$ENTRY_JOURNAL_MARKOS_LEFT_0_10	¿Puede que me haya acostumbrado tanto a la compañía de lunáticos que ya no crea en la cordura?<N><N>[knight_hero] es cortés, inteligente, con intenciones nobles, incluso a veces hasta gracioso... Por todos los dioses, incluso cree en la higiene personal... y aun así estoy con la mosca detrás de la oreja.<N><N>¡Tiene que tener algún defecto!  Alguna extravagancia, alguna manía, algo que se salga de lo común.  Si hay algo que he aprendido durante toda esta aventura es que la normalidad no existe en el Foso.<N><N>Seguro que es el bigote, ¿verdad?  Está escondiendo toda la locura tras su bigote.
$ENTRY_JOURNAL_LETTER_MARKOS_1_TITLE	
$ENTRY_JOURNAL_LETTER_MARKOS_1_LEFT_0_00	Día 19
$ENTRY_JOURNAL_LETTER_MARKOS_1_LEFT_0_10	Para milady [mcguffin_hero] Livbar de parte de [knight_hero_fu] Kashantir, Caballero del Reino de Ash.<N><N>Milady, con el debido respeto que os debo como comandante de este grupo, me gustaría haceros partícipe de mis reservas en cuanto a vuestra elección de compañía.   Por ejemplo, no puedo garantizar vuestra seguridad, y por ende la seguridad de toda esta empresa, mientras [mage_hero_fu] Lan Laxmi siga viajando con nosotros.<N><N>Podéis decirme que no es <LQ>tan mala<RQ> y que la guerra quaidí ha terminado, pero os aseguro que para ella no se ha terminado en absoluto.  Está dedicada con total devoción a algo que ya no existe.  No hay vigilancia que pueda contener su locura.  Si [mage_hero_fu] creyera que la gloria quaidí consiste en que nos rajen a todos la garganta mientras dormimos, ningún miembro de nuestra compañía permanecería con vida al amanecer.
$ENTRY_JOURNAL_LETTER_MARKOS_1_RIGHT_0_00	Os recomiendo que cortéis lazos con ella tan pronto y tan delicadamente como sea posible.<N><N>Vuestro humilde servidor.<N><N>[knight_hero_fu] Kashantir
$ENTRY_JOURNAL_LETTER_MARKOS_2_TITLE	
$ENTRY_JOURNAL_LETTER_MARKOS_2_LEFT_0_00	Noche 19 - Carta para [knight_hero_fu], borrador núm. 1
$ENTRY_JOURNAL_LETTER_MARKOS_2_LEFT_0_10	Estimado [knight_hero_fu]:<N><N>En respuesta a tu carta, me gustaría comentar tres asuntos.<N><N>Lo primero, ¿por qué me escribes una carta cuando puedes caminar unos tres metros y hablar conmigo en persona?  ¿Hay algún problema con mi higiene personal?  ¿Están los demás riéndose de mí en secreto por eso?<N><N>Segundo, deja de llamarme milady de una vez.<N><N>Y tercero, deja a [mage_hero] en paz o te... no sé, te quemaré las patillas o algo así.
$ENTRY_JOURNAL_LETTER_MARKOS_2_RIGHT_0_00	P. D.: - Lo de las patillas es broma, nunca te las quemaría porque entonces estarías raro y tendría que inventarme otro apodo secreto para ti, y Míster Bigotantástico queda genial y no lo quiero cambiar.  En definitiva, lo que digo es que [mage_hero_fu] lo ha pasado muy mal, así que por qué no la tomas con alguien que se lo merezca, como con [berserker_hero_up], que cree que no me entero de que está leyendo por encima de mi hombro incluso cuando al muy idiota le apesta el aliento y huele como un montón de
$ENTRY_JOURNAL_LETTER_MARKOS_2_RIGHT_0_10	TE AMO [knight_hero_up] QUIERO CASARME CON TU BIGOTE AUNQUE SEAS MUCHO MENOS INCREIBLE QUE [berserker_hero_up] Y TAMBIEN TE PONGAS UNA FALDA JAJAJAJA VENGA VAMOS A CASARNOS!!!!
$ENTRY_JOURNAL_LETTER_MARKOS_3_TITLE	
$ENTRY_JOURNAL_LETTER_MARKOS_3_LEFT_0_00	Día 20
$ENTRY_JOURNAL_LETTER_MARKOS_3_LEFT_0_10	Milady [mcguffin_hero_fu]:<N><N>Imagino que no tenía que recibir vuestra última carta, teniendo en cuenta que fue [berserker_hero_fu] quien la envió y que lo habéis perseguido por todo el campamento y golpeado despiadadamente con el cucharón de la sopa.  <N><N>Con esto simplemente os comunico que os devuelvo la carta sin leer.  Oh, y por favor, lavad ese cucharón antes de usarlo otra vez.  Gracias.<N><N>P. D.: - ¿Míster Bigotantástico?  ¿En serio?  ¿Es lo mejor que se os ha ocurrido?<N><N>-[knight_hero_fu] Kashantir
$ENTRY_JOURNAL_LETTER_MARKOS_SLAK_TITLE	
$ENTRY_JOURNAL_LETTER_MARKOS_SLAK_LEFT_0_00	Día 21
$ENTRY_JOURNAL_LETTER_MARKOS_SLAK_LEFT_0_10	EY [mcguffin_hero_up] SOY [knight_hero_up] QUIERO TENER TUS BEBES PORQUE SOY UNA CHICA<N>Y POR ESO LLEVO FALDA AH Y [berserker_hero_up] ES EL MEJOR<N><N>CORDIALMENTE<N><N>EL VERDADERO [knight_hero_up]
$ENTRY_JOURNAL_LETTER_AZRA_SLAK_TITLE	
$ENTRY_JOURNAL_LETTER_AZRA_SLAK_LEFT_0_00	Noche 21
$ENTRY_JOURNAL_LETTER_AZRA_SLAK_LEFT_0_10	Querido [berserker_hero_fu]:<N><N>Si estás leyendo esto significa que has vuelto a entrar a hurtadillas en mi tienda para pintarrajear mi diario y/o dejar por escrito tus iletradas imitaciones.  Bueno, pues no va a ocurrir otra vez.  ¿Ves la solapa de la puerta de la tienda detrás de ti?  ¿Te imaginas lo que hay detrás de esa solapa? <N><N>Te daré una pista: está sujetando el cucharón de la sopa y no le caes muy bien.
$ENTRY_JOURNAL_LETTER_AZRA_SLAK_LEFT_0_20	JAJA CASI ME ENGAÑAS Y MI NOMBRE ES [knight_hero_up] Y ME ENCANTA LLEVAR VESTIDITOS Y ESAS COSAS
$ENTRY_JOURNAL_NIRU_TITLE	
$ENTRY_JOURNAL_NIRU_LEFT_0_00	Noche 22 - [dragon_hero]
$ENTRY_JOURNAL_NIRU_LEFT_0_10	Había oído hablar sobre los dragones muchas veces.  Cuando era pequeña, mi prima estaba obsesionado con ellos, y ella devoraba cualquier leyenda que podía encontrar en la Biblioteca, ya fueran las afirmaciones científicas de Polimon o las fábulas nómadas.  Después regurgitaba estas historias sobre mí como suelen hacer los niños: al revés, mezclando todo y sin pausas para respirar.  A pesar de la calidad de las lecciones, una buena cantidad de material se quedó en los recovecos de mi mente.  Ahora que camino junto a un dragón de carne y hueso, puedo sentir como esas lecciones de mi infancia me inundan de nuevo.<N><N>Durante el transcurso de esta aventura he aprendido que mis ideas preconcebidas son extremadamente imprecisas comparadas con el tema real de mi estudio.  Sin embargo, en este caso, creo que mi formación ha dado en el blanco: [dragon_hero] es una lagarta gorda, codiciosa, egoísta, arrogante e infantil, muy dada a presentarse con delirios de ente divino.
$ENTRY_JOURNAL_NIRU_RIGHT_0_00	De hecho, una criatura tan poderosa es un verdadero peligro.  No ha mostrado ninguna clase de escrúpulos a la hora de devorar a miembros de nuestro grupo, ha matado a todo el que la ha molestado ligeramente y, normalmente, trata cualquier cosa <LQ>mortal<RQ> como si fuera algo inferior a ella.<N><N>La superioridad es a menudo la prueba de la ignorancia.  [dragon_hero] tiene en su poder un valioso <LQ>cáliz del tamaño de un dragón<RQ>.  Si hubiera prestado atención al mensaje en ashiano que lleva debajo, habría sabido que la inscripción indica que el artefacto en cuestión es el mismísimo <LQ>Orinal de Lord Redamal<RQ>.  Cuando sus modales me exasperan, solo tengo que pensar en lo contenta que se pone cuando bebe de su <LQ>cáliz<RQ>.
$ENTRY_JOURNAL_NIRU_LEFT_1_00	Noche 24 - Apéndice
$ENTRY_JOURNAL_NIRU_LEFT_1_10	A pesar de la incertidumbre en todo lo que la rodea, [dragon_hero] es una madre realmente cariñosa.<N><N>Cuando vi su preocupación por el bienestar de sus crías, no pude evitar acordarme de mi propia madre.  Es extraño sentir eso cuando tienes frente a ti a un monstruo que amenaza con quemarte viva o devorarte todos los días, pero es lo que sentí.  <N><N>Sé que tal compasión podría ser mi fin, pero no puedo ni imaginar el vacío que debe sentir tras haber perdido a las crías que los zombis se llevaron.  Parece que la tragedia que estamos sufriendo afecta incluso a los seres más poderosos y distantes.
$ENTRY_JOURNAL_SPEECH_TITLE	
$ENTRY_JOURNAL_SPEECH_LEFT_0_00	Día 23 – Discurso
$ENTRY_JOURNAL_SPEECH_LEFT_0_10	Hoy, mientras satisfacía los antojos de una lagarta gorda, estúpida, aterradora y, por suerte, analfabeta, me encontré una colección de pergaminos. La mayoría eran antiguos y estaban cubiertos de moho, pero quedaba uno legible. Fue toda una sorpresa encontrarme con el discurso de ascensión del Lord Regente:
$ENTRY_JOURNAL_SPEECH_LEFT_0_20	Asumo, de manera absolutamente solemne y con el corazón apenado, esta toga y el cargo de Lord Regente. Nuestra gente ha sufrido una doble pérdida. Poco después de haber quedado huérfanos por la muerte del gran rey Zenimal, el luto nos golpea de nuevo con la noticia de la muerte de Zelemir, nuestro príncipe heredero, en el campo de batalla.<N><N>Aunque el barco zozobre y el rumbo sea desconocido, os aseguro que un nuevo día despunta en el horizonte.<N><N>Os pido que aceptéis mi capitanía hasta que el primogénito de la Fuente, el descendiente de Ashantimon, se alce para tomar el timón y liderar a su pueblo hacia la paz.
$ENTRY_JOURNAL_SPEECH_RIGHT_0_00	Parece que han pasado vidas enteras desde que me hallaba en la capital y escuché estas palabras de boca del mismísimo Lord Regente. Qué gran abismo se antepone entre mí y esta joven niña que lloró en la Plaza del Templo, aquella que se preguntaba cómo volvería a brillar el sol en Ash sin un rey.
$ENTRY_JOURNAL_ASSASSIN_TITLE	
$ENTRY_JOURNAL_ASSASSIN_LEFT_0_00	Día 24 - Asesino
$ENTRY_JOURNAL_ASSASSIN_LEFT_0_10	Hoy, durante los peculiares y exultantes instantes que tienen lugar después de nuestras ardorosas victorias, descubrí algo extraño. Estábamos revisando concienzudamente los restos de nuestros enemigos caídos, buscando algo de provecho, cuando encontré un objeto verdaderamente peculiar.<N><N>Se parecía a un arreo lamelar, o lo que quedaba de uno, todavía con retazos de un fino gambesón que se había llevado por debajo. Las placas eran más pequeñas, y con uniones más intrincadas, que ninguna otra que hubiera visto en nuestros ejércitos o en los de los quaidís. Los delicados contornos de su diseño y la presencia de fibras enganchadas entre los segmentos me hicieron pensar que se vistió sobre prendas comunes. Este intento de secretismo me sugiere que la armadura en cuestión era más civil que militar en su origen.<N>El misterio más importante que planteaba el arreo eran los estragos que, lamentablemente, lo hacían inútil para ninguno de nosotros. Tiene un agujero de más de un palmo de ancho prácticamente en la zona en la que habría estado el corazón 
$ENTRY_JOURNAL_ASSASSIN_RIGHT_0_00	del portador. Las escamas imbricadas circundantes están retorcidas y negruzcas, como si se hubieran sometido a un calor y una fuerza increíbles.<N><N>Esta destrucción no me es ajena. Lo he visto en numerosos cadáveres de zombis derrotados tras haber utilizado mis escasos poderes para aniquilarlos con el espíritu del rayo. Pero esto no ha sido obra mía.<N><N>Lo más inquietante es que las placas dañadas están dobladas hacia fuera, como si el terrible calor y la presión se hubieran ejercido desde el interior de la armadura.<N>No puedo evitar preguntarme, ¿qué persona habría llevado este atuendo, y por si fuera poco, qué la habría matado de esta forma tan extraña?<N><N>APÉNDICE:<N><N>Mientras escribo esto, sigo temblando a causa de los sucesos recién acontecidos y de la muerte que he evitado por poco.
$ENTRY_JOURNAL_ASSASSIN_LEFT_1_00	Había empezado a desmontar la coraza descrita anteriormente, separando las placas de metal del cordón de seda que las unía, con esperanzas de convertir una armadura inservible en chatarra intercambiable. Estaba a punto de sujetar la manga del gambesón que quedaba para desgarrarla cuando [knight_hero] sostuvo mi mano. Sin soltar mi muñeca, cogió su cuchillo y rajó la costura del gambesón. Dentro había una hilera de clavos afilados. Siguió cortando a lo largo de toda la manga y revelando más púas escondidas. En total había 32, todas ellas rematadas con veneno, cosidas en la capa exterior del tejido en la zona en la que uno sujetaría el brazo de un atacante.<N>Mientras [knight_hero] seguía con la disección, descubrimos un bolsillo fino cosido en la muñeca de la manga. Dentro había un pergamino prietamente enrollado. La representación no era distinta a las de los muchos manuscritos ilustrados con los que trabajaba en la Gran Biblioteca de Ash, aunque su estilo me era ajeno. A pesar del deterioro significativo, todavía se distingue la imagen: una mujer esbelta sentada en un trono. El rostro está oculto por las marcas de las quemaduras, pero el largo cabello blanco le cae hasta los hombros y se mezcla con las joyas que lleva en el cuello.
$ENTRY_JOURNAL_ASSASSIN_RIGHT_1_00	A sus pies hay dos niños sentados de piel morena y ojos dorados. La mujer apoya las manos en las cabezas de los niños. Tienen el mismo pelo blanco que ella. Los bordes del pergamino son irregulares, como si hubiera sido cortado de una página mucho más grande con un cuchillo. El lado contrario está cubierto con diversos símbolos de origen desconocido trazados meticulosamente con tinta negra.<N><N>[knight_hero], por su parte, intenta restarle importancia a todo el suceso. Según dice, las púas deben llevar tanto tiempo ahí que su veneno seguramente no tenga ningún efecto. Me ha asegurado que con su intervención simplemente quería evitarme un pinchazo en el dedo. Esas han sido sus palabras, pero veo en sus ojos una preocupación que contradice sus bromas.<N><N>Saber cómo predijo la existencia de estos aguijones en el arreo del asesino es algo que no he podido sonsacarle.
$ENTRY_JOURNAL_SUPERSHEEP_TITLE	
$ENTRY_JOURNAL_SUPERSHEEP_LEFT_0_00	Día 24 - La muerte de una superoveja
$ENTRY_JOURNAL_SUPERSHEEP_LEFT_0_10	La Axxima Vatta Muttanaxxor yace muerta a mis pies.<N>Este hecho, según los alardes jactanciosos de [dragon_hero], es una hazaña que será recordada durante generaciones. Aunque claro, también parece ser de la opinión de que ha logrado esta proeza sola con sus manitas (¿garritas?), así que tal vez no haya que darle tanta importancia a lo que dice. Admito que estoy disfrutando de los festejos. En las entrañas más profundas de una ciudad desolada, perseguidos por dementes y zombis y rodeados de caos, es agradable tener un momento para poder disfrutar de algo, incluso si es un festín organizado por una lagarta grandilocuente con delirios divinos y el hábito de amenazar con una inmolación ante la más mínima ofensa. Qué extraño me resulta verla juguetear junto a la hoguera con sus retoños. A falta de una palabra más exacta, parece que es feliz, si es que tal emoción puede aplicarse a un monstruo. Nunca habría imaginado que los estados de ánimo de una criatura así pudieran ser contagiosos, pero yo misma empiezo a sentir algo por la exuberancia de nuestra
$ENTRY_JOURNAL_SUPERSHEEP_RIGHT_0_00	 anfitriona. ¡He matado a una criatura legendaria! ¡Me he dado un festín con su carne! ¡He ingerido una cantidad nada desdeñable de algo a lo que [berserker_hero] llama <LQ>vino en botalla<RQ>!<N>No debería explicar los orígenes de la denominación de esta sustancia por deferencia a los futuros lectores al no ser apta para cardíacos, pero debo decir que voy por mi segunda bota-lla y, aunque puede que mi paladar nunca se recupere de los horrores que ha sufrido, mis entrañas están tremendamente cálidas, y el mundo que me rodea se mece y palpita de forma muy agradable.<N>El progenitor de este raro incunable está en este momento a gatas, retozando junto a las llamas con nuestros anfitriones reptilianos y gritando <LQ>¡este es mi rugido de dragón!<RQ> No hace falta que sigamos comentando el sonido que se emite, ni el orificio por el que se origina, pero tanto su regularidad como su volumen son impresionantes.<N>Voy por la tercera bota-lla, y me doy cuenta de que mi negativa impresión inicial de la creación de [berserker_hero] tal vez fuese demasiado precipitada. El sabor es un marco de referencia completamente inválido con el que juzgar esta sustancia. Textura, viscosidad, una
$ENTRY_JOURNAL_SUPERSHEEP_LEFT_1_00	combinación de temperatura e impulsos gravitacionales... Si los rayos estuvieran hechos de cuero y barro...<N><N>Mi bota está vacía. Hay que corregir esto.<N><N>¡Ha vuelto a ocurrir! Lo que hay en la bota no se queda ahí cuando te lo bebes todo... ¿Adónde va? ¿Por qué la bota no se queda llena? ¿Por qué la... ¡Solución! Otra bota.<N>La bota número cinco es, de lejos, la bota más botástica de todos los calzados. Esta bota tiene botas. Textura: impresionante. Sabor: indescriptible. Estancia: todo da vueltas.<N><N>Acabo de comer un poco de oveja<N><N>Ni siquiera la he cocinado sobre el fuego<N><N>Me la he comido cruda<N><N>Ha sido increíble<N><N>Es como... Vale: patillas.<N><N>Acaso yo
$ENTRY_JOURNAL_SUPERSHEEP_RIGHT_1_00	Es raro querer<N><N>Solo quiero meterme dentro de las patillas y acurrucarme y echarme una siesta<N><N>Como una pequeña hamaca<N><N>Solo acurrucarme y<N><N>Seguro que huelen bien<N><N>¿Eso es una enfermedad? Puede que sea una enfermedad.<N>Puede que esté enferma... puede que
$ENTRY_JOURNAL_SUPERSHEEP_RIGHT_1_10	Mañana 25 - Apéndice
$ENTRY_JOURNAL_SUPERSHEEP_RIGHT_1_20	Nunca<N><N>Nunca nunca nunca nunca nunca nunca nunca<N><N>Nunca nunca<N><N>Nunca más.
$ENTRY_JOURNAL_DREAM2_TITLE	
$ENTRY_JOURNAL_DREAM2_LEFT_0_00	Día 25 - Segundo sueño
$ENTRY_JOURNAL_DREAM2_LEFT_0_10	Anoche volví a tener ese sueño.  La forma era diferente, pero diría que fue el mismo sueño, o al menos yo era la misma soñadora.<N><N>Me encontraba en un gran salón.  Los muros que me rodeaban se alejaban del suelo, se alzaban tan alto que el techo estaba hecho de nubes.  Cada pared era brillante y dorada, adornada con asombrosas joyas hasta donde la vista alcanzaba.  Tenía un cáliz en las manos tallado en algún tipo de material refulgente, del color del vino y frío al tacto.  <N><N>A pesar de las maravillas que me rodeaban, lo que más apreciaba era el cáliz. Intenté no derramar ni una sola gota por el borde. De repente, el salón se tornó oscuro y una muchedumbre repugnante apareció de la nada. Me golpearon, me insultaron y me arrancaron el cáliz de las manos. Grité y extraje una afilada daga de mis ropajes con la que los apuñalé y acuchillé hasta que el salón quedó ennegrecido por la sangre.
$ENTRY_JOURNAL_DREAM2_RIGHT_0_00	A pesar de los abatidos, la multitud seguía persiguiéndome y me obligaron a salir del salón hacia una lóbrega antecámara. Luché hasta quedar exhausta, pero la horda contraatacaba por todas partes. Me desplomé y la muchedumbre se apresuró ansiosa por despedazar las brillantes joyas de las paredes. <N><N>Yací en el suelo mucho tiempo. Creía que había muerto. Cuando pude ponerme en pie el salón estaba desierto. Los muros estaban destrozados y despojados de joyas, solo ruinas cubiertas de hollín y polvo. Miré alrededor, pero el cáliz ya no estaba. Deambulé por el salón una eternidad, gritando, pero estaba sola. Me habían arrebatado el cáliz. <N><N>Me senté sobre los escombros y lloré.
$ENTRY_JOURNAL_ZELEMIR_DEAD_TITLE	
$ENTRY_JOURNAL_ZELEMIR_DEAD_LEFT_0_00	Día 28 - La muerte del hombre de rojo
$ENTRY_JOURNAL_ZELEMIR_DEAD_LEFT_0_10	<N>Recuerdo vagamente haberlo visto cuando era una niña, aunque mi mente no puede asociar la imagen de este recuerdo difuso con el hombre que ahora yace muerto.<N><N>Entonces llevaba el pelo largo, al estilo de las provincias del este, y la mayor parte de su cara estaba oculta por el preminente vendaje que le envolvía parte de la cabeza y un ojo. De hecho, solo supe que era distinto al resto de los veteranos lisiados que se nos unieron en la Fuente del Templo por la velada reverencia con la que mi madre me hizo retroceder.<N><N>Recuerdo cómo levantó a otro soldado, obligado a usar una muleta y con una manga vacía donde debería haber estado su brazo derecho, para que el joven pudiera beber de la Fuente. Recuerdo cómo siguió allí de pie, largo rato después de que el hombre más joven se alejara cojeando. Recuerdo cómo la luz captaba las lágrimas que escapaban del ojo descubierto, corrían por su barba y se mezclaban con el agua pura del Templo.
$ENTRY_JOURNAL_ZELEMIR_DEAD_RIGHT_0_00	Y ahora está muerto, yo lo he matado.<N><N>El regicidio deja una sensación amarga.  En mi cabeza me digo que era lo único razonable, pero aun así he derramado sangre real de Ash.  Se había desviado tanto de su propósito que ponía en peligro el orden de las cosas.  Aun así, ese sentimiento me sigue acechando.  Es la primera vez que mato a un hombre de carne y hueso.<N><N>[mage_hero] oscila entre el regocijo y el enfado. Maldice su nombre como si pudiera matarlo una y otra vez.  Supongo que no es un deseo completamente vano, si tenemos en cuenta nuestras acciones durante las últimas semanas.<N>Lo que más me atormenta de todo son los zombis que todavía nos persiguen.  Su líder y creador está muerto.  ¿Cómo puede su voluntad guiarlos todavía?<N><N>Antes de formular la pregunta ya sé la respuesta, aunque no me guste admitirlo.  No es su voluntad.  Siento algo distinto.  Hay otra mano que los guía. He sentido el extraño poder del que Zelemir habló: el mal que permanecía sellado por el sacrificio de sangre.  Eztli-Tenoch.
$ENTRY_JOURNAL_GIBBERISH_TITLE	
$ENTRY_JOURNAL_GIBBERISH_LEFT_0_00	Día 25 - Galimatías
$ENTRY_JOURNAL_GIBBERISH_LEFT_0_10	[knight_hero] me despertó hoy. Nos detuvimos brevemente para almorzar unas pocas sobras de comida y me recosté contra la fría piedra del pasaje abovedado que acabábamos de cruzar; estaba agotada de la larga caminata. Por una vez el sueño me asaltó con facilidad, algo nada fácil en los últimos días. Mi duermevela no pudo haber durado más que unos instantes. De inmediato abrí los ojos y vi a [knight_hero] de pie frente a mí. Me informó de que teníamos que continuar, y mientras volvía al sendero, añadió que había estado pronunciando un galimatías mientras dormía.<N><N>Aunque debió ser una retahíla sin sentido para él, creí oportuno aferrarme a los recovecos de mi mente somnolienta. Saqué mi diario y anoté lo que recordaba apresuradamente; no me atreví a pararme y examinarlo por temor a perder mi hallazgo.
$ENTRY_JOURNAL_GIBBERISH_RIGHT_0_00	Tanta, tanta, tantísima belleza albergabas.<N>Y la destruí,<N>y te hice a mi semejanza.<N><N>Y ahora, ahora, ahora,<N>soy el prisionero y el loco<N>que devora su propia mente<N>porque no puede devorar el mundo.
$ENTRY_JOURNAL_WRENNASTORY_TITLE	
$ENTRY_JOURNAL_WRENNASTORY_LEFT_0_00	Día 26 – La historia de [mage_hero]
$ENTRY_JOURNAL_WRENNASTORY_LEFT_0_10	Sigo descubriendo grandes abismos entre el mundo que me rodea, tal y como es ahora, y la colorida interpretación esculpida que mi mente guarda. Parece que he pasado la mayor parte de mi vida juzgando las cosas por la invención intelectual que había creado de ellas, no por sí mismas.<N>Anoche, mientras estábamos sentados alrededor de la hoguera, [mage_hero] empezó a contar una historia. Respiré hondo, preparada para un viaje lúgubre y macabro: algunos asesinatos triviales siendo joven, el violento fervor de los fanáticos...<N>En vez de eso, contó una historia sobre su hermana pequeña.<N>Esta niña, siete años más pequeña que [mage_hero], envidiaba la movilidad de la mayor. Tenía tal sentimiento de incompetencia que empezó a trepar, en los momentos más insólitos, por la espalda de [mage_hero], parasitando y asumiendo de esta manera la altura y la condición física que codiciaba. [mage_hero] pronto se convirtió en una experta en deshacerse de esta pasajera indeseada, para frustración de la pequeña. Continuó
$ENTRY_JOURNAL_WRENNASTORY_RIGHT_0_00	así durante un tiempo; la más pequeña se sujetaba repetidamente a la más mayor, y esta la derrocaba de inmediato. Un día [mage_hero] se despertó y encontró a su hermana sentada en el cabecero de la cama, embadurnándose trabajosamente con el contenido de un tarro robado de miel, con la esperanza de que este adhesivo improvisado le uniera permanentemente a su bestia de carga preferida.<N><N>[mage_hero] terminó la historia y me miró expectante con una sonrisa pueril. Transcurrieron unos segundos antes de que me diera cuenta de que estaba esperando mi carcajada.<N>Fue una reacción nueva y desconocida para mí. La [mage_hero] de mi mente solo provocaba miedo o compasión. Su retrato era bien el de una señora de la guerra oscura y terrible, incluso en sus momentos más amables con su humor sanguinolento y su risa fanática, bien el de una niña frágil y herida, un ser indefenso sobre el que verter toda mi compasión santurrona.<N><N>Cuán equivocados son mis prejuicios, pues buscan reducir el alma humana a un simple objeto que solo importa si me afecta a mí.
$ENTRY_JOURNAL_EVILINSIDE_TITLE	
$ENTRY_JOURNAL_EVILINSIDE_LEFT_0_00	Día 27 - La maldad interior
$ENTRY_JOURNAL_EVILINSIDE_LEFT_0_10	Selinadt escribió en su Carta segunda al rey Vekalimon: <LQ>Cuando el hombre acepta la maldad de su propio interior, no puede haber vencedores<RQ>.<N>Que te recuerden tus propios fracasos es una lección amarga. Me creía una verdadera devota apasionada de Selinadt (un orgullo que ahora veo como un error grave). Pero acaso alguien como yo, razoné para mí misma, que ha recitado los versos desde pequeña y ha sido beata habitual del Templo, ¿no podría considerarse que está en el camino correcto? A pesar de eso, durante toda mi vida me he engañado secretamente pensando que la maldad era algo puramente exterior. Primero fueron los quaidís, los artífices de todo el dolor y la miseria que contemplé durante mis primeros años de vida. Mientras leo cada día sobre el mal de mi propio corazón, me digo a mí misma que nada de esto puede compararse con la maldad de los ejércitos del este, asesinos y expoliadores, hombres que se habían convertido en alimañas. Todo lo que me rodea, los lamentos de las viudas, el llanto de los huérfanos, los quejidos de los veteranos lisiados, todos los gemidos de dolor de la ciudad se transformaban en palabras de afirmación en mi mente.
$ENTRY_JOURNAL_EVILINSIDE_RIGHT_0_00	<LQ>La maldad que albergo<RQ> dije para mis adentros, <LQ>no es equiparable a esto<RQ>.<N><N>Incluso en esta aventura, que ha servido para abrirme los ojos a muchos prejuicios, sigo manteniendo la fantasía de pureza. No importan los anhelos secretos de mi corazón; podría apuntar a Ozimal o Zelemir y decir <LQ>este es el mal verdadero<RQ>.<N><N>El camino de Selinadt, con su habitual dogma enrevesado, me ha mostrado la lamentable locura de mis creencias secretas. En el centro de esta ciudad muerta, apretado en la mano de lo que antaño fue un caballero de Ash, encontré un pergamino. Las siguientes palabras estaban escritas con una caligrafía floral hecha por manos habilidosas:
$ENTRY_JOURNAL_EVILINSIDE_RIGHT_0_10	<N><N><N><N>Apreciado Maestro Anciano:<N>Como respuesta a tu excomunión, me gustaría aclarar que solo he actuado en consonancia moral con las directrices de nuestra fe. Declaras que el asesinato en masa de los prisiones bajo mi supervisión viola la responsabilidad de mi posición y mi deber ante el Impulsor Impasible, pero te aseguro que
$ENTRY_JOURNAL_EVILINSIDE_LEFT_1_00	es al contrario.<N><N>Recordarás, sin duda, cuando el enemigo llegó a la ciudad de Terna. Buscaban aterrorizar al resto de Ash para que se sometieran, y juraron que no habría cuartel para los atribulados defensores. Aquel día negro en el que la ciudad sucumbió, vimos cómo se cumplía el juramento. Pero el enemigo no estaba contento con la masacre de la guarnición y tornaron su furia contra la población: ancianos, niños y mujeres fueron víctimas de una cólera sin sentido. Cuando cayó la noche, treinta mil hombres, mujeres y niños habían sido masacrados. Terna quedó reducida a cenizas, habitada solo por unas pocas almas que contarían el horror que allí se cometió.<N><N>Esta es la razón por la que uno de cada diez prisioneros será quemado vivo. Hasta que treinta mil hombres mueran a mis manos, las inmolaciones continuarán en pos de la edificación de los prisioneros y la restitución de la verdadera justicia. Lo juro solemnemente por el oro de la mismísima Fuente. Ni siquiera las amenazas de un clérigo equivocado evitarán que haga honor a ello.<N>– General Keznimon Kalredos
$ENTRY_JOURNAL_EVILINSIDE_RIGHT_1_00	Conocí a este hombre. Ah... ahora veo, como iluminada por un relámpago, la verdadera oscuridad que acecha en todas las almas. Más que en ninguna otra, lo veo en mi propia alma. Qué fácil sería abandonarse a la corrupción en lugar de luchar contra ella. Es una sensación dulce y conocida, difícil de describir; ¿tanto tiempo he vivido con odio que he llegado a disfrutarlo? Miro el horror presente en la página que tengo frente a mí y veo el pecado más vil. Pero qué fácil habría sido dejarse llevar. Qué dulce sensación me habría provocado beber abundantemente de ese torrente secreto en mi corazón, infligir el dolor y la pérdida, sentir que mi alma danza espoleada por el regocijo sombrío de la venganza. Pienso en [mage_hero] llorando en su tienda, en la maldad que infligí con mis modestos medios. ¿Qué podría haber hecho con un verdadero poder?<N><N>Cuando el hombre acepta la maldad de su propio interior, no puede haber vencedores.
$ENTRY_JOURNAL_MARKOSSTORY_TITLE	
$ENTRY_JOURNAL_MARKOSSTORY_LEFT_0_00	Día 27 - La historia de [knight_hero]
$ENTRY_JOURNAL_MARKOSSTORY_LEFT_0_10	Para milady [mcguffin_hero] Livbar de parte de [knight_hero] Kashantir, Caballero del Reino de Ash.<N><N>Hace tiempo me preguntasteis cómo predije el peligro que se escondía dentro de la extraña armadura que encontrasteis. Como adivinasteis certeramente, ya me había encontrado con un asesino ataviado de igual manera. Aunque apacigüé vuestra curiosidad en aquel momento, he estado pensando durante días sobre este asunto, y he decidido contaros mi experiencia.<N><N>No se trata de una historia que comento abiertamente a menudo, y si puedo evitarlo, tampoco pienso sobre ella.<N><N>Eran tiempos oscuros. La peste no volvería en los próximos dos años. Parecía como si nada pudiese detener a la máquina de guerra quaidí en esa época. Las provincias del este estaban bañadas por el rojo de la sangre de su gente, y las incursiones empezaban a llegar incluso hasta el corazón de Ash.
$ENTRY_JOURNAL_MARKOSSTORY_RIGHT_0_00	Mi padre estaba muerto. Mis hermanos estaban muertos. Como varón de más edad superviviente de la estirpe Kashantir, di un paso al frente para luchar. Había muchos como yo, chicos de noble cuna que habían dedicado toda su vida a entrenar, pero que nunca habían derramado la sangre de un hombre. Por debajo de nosotros había niños aún más pequeños: plebeyos, comerciantes, hijos de granjeros recién salidos de los campos, todos ellos convocados para dar sus vidas por Ash. Supongo que encomendarnos una tarea tan delicada a nosotros fue un símbolo de la desesperación del reino.<N><N>Los espías trajeron nuevas de un general quaidí que había acampado con su avanzadilla; la garra más importante de los adoradores del fuego se hundía en el corazón de Ash. Según los espías, había pocos guardias: era el momento de atacar.<N>Nuestro comandante estaba mal preparado para tal cometido. El grueso de las tropas eran reclutas novatos, de mi edad o más jóvenes, y los refuerzos nómadas estaban desertando continuamente. No tenía reservistas, ningún veterano al que recurrir, y apenas suficiente oro para llevar sobre el terreno a un puñado de mercenarios.
$ENTRY_JOURNAL_MARKOSSTORY_LEFT_1_00	Encontró a un hombre solitario.<N><N>Había escuchado historias de estos carcásicos, asesinos engendrados bajo siglos de guerras entre las ciudades estado del norte, hombres que valoraban el propio asesinato más que el oro que les pagaban por cometerlo. Siempre los había considerado meros cuentos de soldados.<N>Tras contemplar al hombre empecé a preguntarme si no los habría juzgado mal.<N><N>No tenía vello, por lo que podía ver, ni en el rostro, ni en la frente, ni en la coronilla, ni en el dorso de las manos. Nunca había visto un ser vivo tan calmado. No hablaba, pero de vez en cuando y sin motivo aparente, empezaba a reírse, dejando entrever unos dientes negros como la noche. Los hombres lo llamaban Devorasombras.<N><N>Nuestras órdenes eran simples: llevar al carcásico hasta el campamento enemigo y proporcionarle cualquier asistencia que necesitara durante su encomienda. El tiempo estaba en nuestra contra. Había una niebla espesa de la noche anterior, y la oscuridad del antelucano nos
$ENTRY_JOURNAL_MARKOSSTORY_RIGHT_1_00	hizo perder el rumbo. Reacios a llamarnos en voz alta por riesgo de desvelar nuestra posición al enemigo, nuestro pequeño grupo se disolvió rápidamente. Me percaté de que estaba solo entre la neblina y mi temor creció.<N>Deambulé largo rato, tropezando a causa de mi ceguera, aterrado por la idea de que mis pasos alertaran al enemigo. De repente, me encontré con una forma en la niebla. Era un guardia quaidí, estaba muerto, rojo por su propia sangre. No tenía párpados.<N><N>Había llegado hasta el campamento enemigo y no estaba solo. Frente a mí, agazapado entre dos tiendas, había otra figura. No pude discernir el aspecto del hombre, pero deduje por su postura que también era un intruso. Me arrastré hasta donde se encontraba y alargué la mano para tocarle el hombro y alertarlo de mi presencia. Sin llegar a girarse me agarró el brazo.<N><N>Esbozó una sonrisa de dientes ennegrecidos tan amplia que parecía que su rostro se iba a partir en dos. El Devorasombras señaló la tienda
$ENTRY_JOURNAL_MARKOSSTORY_LEFT_2_00	que había frente a nosotros. La solapa estaba bordada con la cimera imperial de Quaid. El guardia ya estaba muerto. Sin dejar de sujetar mi brazo, el carcásico entró en la tienda del general llevándome tras él. El general descansaba en un catre, rodeado de mapas, pergaminos y otras enseres de la comandancia. Incluso tumbado pude apreciar que era un hombre enorme; la cabeza y los hombros eran más grandes que los míos, y él mucho más grande que el delgado carcásico. El Devorasombras me soltó y reptó hasta los pies del general. Extrajo una pequeña daga de una funda oculta. La sostuvo sobre la cabeza durante un instante, y pareció como si el tiempo se detuviese. Con un gesto violento acuchilló al enemigo quaidí que aún dormía.<N><N>El general se incorporó dando un grito. Con la daga aún sobresaliendo entre sus costillas, agarró al carcásico por los hombros y lanzó al menudo hombre al otro lado de la tienda. El hombre de Quaid desenvainó la espada que tenía junto al catre y cubrió la distancia que les separaba en un solo paso. Temiendo por la vida de mi compañero, desenfundé mi espada y me preparé para golpear al gigante que avanzaba. Mi golpe fue interceptado por el extraño sonido de la risa del carcásico.
$ENTRY_JOURNAL_MARKOSSTORY_RIGHT_2_00	Él yacía tumbado en el mismo sitio en el que lo había lanzado el general, mostrando los relucientes dientes negros en una risa grotesca. La conducta del mastodonte cambió. La espada cayó de entre sus manos temblorosas. Se derrumbó como una torre en ruinas, con todo el cuerpo destrozado por las convulsiones.<N><N>El carcásico emitió un grito mudo y se abalanzó sobre el hombre moribundo para extraer la daga. Contemplé el miedo cuando el asesino estiró las manos y empezó a hacer abluciones con los últimos estertores irregulares del general quaidí, elevándolos sobre su cabeza y vertiéndolos como si fueran agua.<N><N>Cuando los resuellos del general se silenciaron, el carcásico terminó su ritual. Se giró y me vio allí de pie, todavía sosteniendo el golpe que no había asestado. Me dedicó otra negra sonrisa y destapó la tela del hombro dejando a la vista una hilera de púas cargadas con el veneno que había acabado con la vida de su víctima.<N><N>Me agarró de la muñeca de nuevo y me llevó fuera de la tienda, hasta el borde del campamento. Se detuvo un instante, encorvado
$ENTRY_JOURNAL_MARKOSSTORY_LEFT_3_00	sobre sí mismo en la oscuridad y la niebla, y pude escuchar cómo rascaba algo. Después, con una sonrisa casi paternal, me entregó su daga. El cuero gastado de la empuñadura tenía unos extraños caracteres grabados. Alcé la vista y lo vi rodeado de otras cuatro figuras, vestidos igual y con la misma sonrisa de dientes negros. Como si fueran uno, caminaron hacia atrás y se fundieron en la niebla.<N><N>Nuestro comandante murió ahogado mientras dormía varias semanas después, y la historia que circuló entre los hombres hablaba del Devorasombras volviendo a por su pago.<N><N>Años más tarde conocí a otro soldado que tenía conocimientos de alguna de las lenguas de los carcásicos. Le enseñé la daga e interpretó los caracteres para mí. Decían <LQ>Que tengas muchas vidas, hijo.<RQ>
$ENTRY_JOURNAL_DREAM3_TITLE	
$ENTRY_JOURNAL_DREAM3_LEFT_0_00	Día 29 - Tercer sueño
$ENTRY_JOURNAL_DREAM3_LEFT_0_10	Anoche volví a soñar.<N><N>Estaba en un lugar inhóspito.  Ante mí había un imponente cristal que se alzaba una treintena de metros hacia el cielo.  Estaba llorando.  Las lágrimas corrían por mi cuerpo, por mi oro y mis amuletos, y caían al suelo.  Serpentearon a través de la tierra polvorienta hacia el cristal y me di cuenta de que ya no eran lágrimas sino riachuelos de sangre.  <N><N>Había una multitud de cadáveres a mis pies; hombres, mujeres y niños.  Tenía las manos cubiertas de sangre, su sangre.  Me giré y vi un ejército detrás de mí, cubierto, tal y como yo estaba, de sangre.  Esperaron a que yo hablara.  <N><N>Alcé los brazos encarnados hacia el cielo y mi voz resonó como un trueno.<N><N>El ejército secundó mi grito.  Era una palabra que no había escuchado nunca, pero inmediatamente supe su significado.  La palabra era sangre.  El grito se intensificó hasta que la tierra tembló.
$ENTRY_JOURNAL_SLEEP_AND_MADNESS_TITLE	
$ENTRY_JOURNAL_SLEEP_AND_MADNESS_LEFT_0_00	Día 30 - Sueño y locura
$ENTRY_JOURNAL_SLEEP_AND_MADNESS_LEFT_0_10	Tal ha sido la intensidad con la que he estado hablando en mi atribulado sueño, que en esta ocasión me he despertado a mí misma. El sonido de las palabras ya no está en mi mente, pero el significado persiste inmóvil, más grande y más extraño que en cualquier experiencia previa:
$ENTRY_JOURNAL_SLEEP_AND_MADNESS_LEFT_0_20	Aun así, sí, aun así,<N>me abandonaste<N>por ese precio grandioso y carmesí,<N>y buscaste otra vida en otra parte<N>como si el dios en ti dejase de existir.<N><N>Estaba solo.<N>Era un prisionero, un loco<N>y tú la reina del polvo,<N>la reina de los demonios<N>que habrían sido dioses.<N><N>O eso creía<N>mientras devoraba mi mente.
$ENTRY_JOURNAL_EMPRESS_TITLE	
$ENTRY_JOURNAL_EMPRESS_LEFT_0_00	Día 32 - La Emperatriz
$ENTRY_JOURNAL_EMPRESS_LEFT_0_10	Debo expresar cierto desasosiego con la ciudad fantasma en la que nos encontramos de paso. Aunque las distintas necesidades que una compañía como la nuestra necesita se han ido supliendo por la propia diversidad de mercaderes y comerciantes que se encuentran en cada asentamiento del Foso, la gente que mora aquí parecen dementes. Son quaidís, en su mayoría, y llevan consigo tal fervor impertérrito que a menudo evalúo con la mirada posibles rutas de escape cuando uno de ellos se dirige a mí.<N><N>[knight_hero] parece especialmente agitado. Ha hablado muy poco sobre su experiencia en la guerra, pero puedo asegurar que su forma de hablar y sus atuendos le traen a la mente malos recuerdos. Ya no bromea como de costumbre, sino que camina de un lado para otro, conteniéndose para no posar las manos sobre la empuñadura de su espada.<N><N>Incluso los cazadores y otros mercenarios que trabajan a cambio de cualquier chatarra que la ciudad pueda darles parecen desconfiar de sus anfitriones.
$ENTRY_JOURNAL_EMPRESS_RIGHT_0_00	Hay ingentes reservas de cristales explosivos por todas partes. A pesar de las cuantiosas reservas, el pueblo quaidí sigue con la extracción minera, dispuestos a alimentar a una máquina de guerra que ya no existe.<N><N>Todo esto ya era bastante inquietante, pero entonces [mage_hero] llegó al poblado.<N><N>La última de la familia real, hija de la Llama Cósmica. Fuera donde fuera, las miradas ávidas la seguían. En unos instantes, todo el pueblo se había reunido en silencio, haciendo corrillos en las inmediaciones, voraces a la espera de cualquier resto de determinación que pudiera dejar caer.<N><N>De repente un hombre prorrumpió entre las filas de la multitud. Vestía harapos y la desaliñada barba rubia estaba moteada de espuma. Con un grito mitad alarido, mitad carcajada, se encogió a sus pies, postrándose en el barro, agarrando el dobladillo de su capa.<N><N>Fue como si hubiera roto una barrera invisible. Todo el pueblo al unísono se acercó a [mage_hero],
$ENTRY_JOURNAL_EMPRESS_LEFT_1_00	pisoteándose unos a otros solo para alcanzar y poder agarrar sus vestiduras. Vi a un anciano vociferando como un niño mientras rodaba por el polvo apretando contra el pecho un mechón de su cabello dorado.<N><N>Intenté llegar hasta ella, pero la multitud me repelió. Durante un fugaz instante, mis ojos se encontraron con los de [mage_hero]. Nunca antes había visto una mirada de pavor tan auténtica. Desapareció entre las manos avariciosas de la multitud. Los hombres sostenían en alto los jirones que habían arrancado de su capa.<N><N>Estaba reuniendo mis fuerzas para llevarla conmigo al lugar intermedio cuando una orden sacudió a la multitud por completo. La muchedumbre enmudeció. Muchos de ellos temblaban.<N><N>[mage_hero] se irguió hasta el tejado de una de las casuchas del poblado. Su cabello se retorcía incontrolablemente al viento. Los jirones de su capa se hincharon como la vela de un navío de guerra. Por su frente corría un pequeño hilo de sangre.
$ENTRY_JOURNAL_EMPRESS_RIGHT_1_00	Rugió en idioma quaidí con una voz más fuerte de lo que jamás habría imaginado posible para su pequeño cuerpo. La gente se postró. Parecía como si todo un ejército siguiera sus palabras.
$ENTRY_JOURNAL_EMPRESS_RIGHT_1_10	<LQ>¡Soy [mage_hero] Lan Laxmi! ¡Soy la llama que se alza de las cenizas!<RQ>
$ENTRY_JOURNAL_EMPRESS_RIGHT_1_20	Bramó en quaidí, en ashiano y en nómada. La multitud se retiró, inclinándose en reverencia, sin atreverse a darle la espalda a su emperatriz. Lentamente, los hombres se adelantaron para dejar ofrendas a sus pies, cuchillos y hachas, tejidos bordados a mano, lo mejor de sus escuetas posesiones. El proceso se alargó hasta el ocaso.<N><N>Las reservas de cristales casi se habían duplicado desde nuestra llegada.
$ENTRY_JOURNAL_BLACKROBES_TITLE	
$ENTRY_JOURNAL_BLACKROBES_LEFT_0_00	Día 33 - Los Túnicas Negras
$ENTRY_JOURNAL_BLACKROBES_LEFT_0_10	[berserker_hero] ha empezado a reunir las túnicas empapadas en sangre de los sectarios derrotados para algún proyecto del que prefiero no estar al tanto. Es extraño ver las caras tras las máscaras, aunque están desfiguradas por su súbita transformación en zombis. Muchos de ellos sufren mutilaciones, y me inclino a pensar que son heridas autoinfligidas. A pesar de todo, todavía se puede apreciar la persona que antaño fueron. En otra época, habrían sido como cualquier otro nómada.<N><N>Curiosamente, [mage_hero] está pletórica por haberse enfrentado a ellos, como si luchar contra el mismo enemigo que su abuelo fuera compartir la gloria del héroe. Según me contaron, en otro tiempo los sectarios fueron la amenaza más grande del Imperio Quaid. Unidos bajo el estandarte de un matriarcado central, los dementes fueron un reino de propio derecho, que perpetraba invasiones a gran escala para saciar su apetito interminable de víctimas para sacrificios. Las generaciones quaidís lucharon contra ellos hasta frenar su avance, pero solo con la llegada del abuelo de [mage_hero] pudieron pasar a la ofensiva. Las victorias del Imperio fueron rápidas y brutales; al parecer, tras
$ENTRY_JOURNAL_BLACKROBES_RIGHT_0_00	 generaciones de triunfos, los sectarios se habían convertido en víctimas de su propia degeneración. La que una vez fuera una poderosa institución matriarcal había dado paso a una clase gobernante desorganizada de sumos sacerdotes, todos ellos ansiosos por acumular poder individual en lugar de buscar el bien colectivo. Sin la autoridad centralizada de la <LQ>Reina de Muchos Demonios<RQ> (tal y como los quaidís llamaban a su lideresa), los sectarios no eran capaces de proporcionar una resistencia unificada y se doblegaron ante el poder de la ofensiva quaidí.<N><N>Hasta la llegada de los años de la peste, [mage_hero] y su pueblo creían que los sectarios de sangre habían sido exterminados. Ahora, en esta era de caos, parece que los dementes han vuelto, azuzados por un poder nuevo y tenebroso. Que sea en este momento no es una coincidencia. Eztli-Tenoch ha encontrado a sus esbirros, hombres dispuestos a sacrificar su humanidad por él.<N><N>[ranger_hero] los llamó los <LQ>anatemas de las tribus<RQ>, lo que me lleva a pensar, si tenemos en cuenta su aspecto, que estos hombres alguna vez fueron nómadas como ella. ¿Qué les habrá convencido para entregarse a la vida que tienen (o tenían) ahora? Mi mente no logra comprenderlo.
$ENTRY_JOURNAL_BLACKROBES_LEFT_1_00	[ranger_hero] sigue escéptica en cuanto al asunto. Tras sus declaraciones iniciales, casi mareantes, pronunciadas justo después del caos del combate, no ha vuelto a decir nada. Al parecer, celebrar una victoria es una cosa, pero satisfacer la <LQ>detestable curiosidad<RQ> de un extranjero es algo totalmente distinto. Tal vez mi curiosidad es desmedida. Cuando cree que nadie la está mirando, veo a [ranger_hero] toqueteando el ídolo del zorro que lleva al cuello, recorriendo nerviosamente con la mirada las siluetas de nuestros enemigos derrotados.<N><N>Parece una obviedad que los Geka y la joven [ranger_hero] tuvieron algunos asuntos turbios con los dementes en el pasado.<N><N>Por una vez, siento que soy yo la que se ha comportado de manera frívola y grosera.
$ENTRY_JOURNAL_BLACKROBES_LEFT_1_10	<N>No puedo evitar recordar la oración secreta de [ranger_hero] para estar protegida de <LQ>los extraviados<RQ> y su deuda casi suicida con los hijos de Krast.
$ENTRY_JOURNAL_BLACKROBES_RIGHT_1_00	Apéndice – Noche 33
$ENTRY_JOURNAL_BLACKROBES_RIGHT_1_10	Mi pensamiento retorna, una y otra vez, a las palabras que escuché pronunciar a los dementes de sangre, hechizos tenebrosos en una lengua tenebrosa. Me enferma que me suenen tan familiares. No son ajenas a mis labios en las horas más profundas de la noche, cuando mi mente no es ella misma.<N><N>Estas declaraciones manchadas de sangre no son el único conocimiento secreto que siento que poseo. En este momento, bajo la feroz luz de la luna creciente, veo cosas que no podría apreciar con la claridad del día. Conozco estas túnicas negras, estas máscaras manchadas de sangre y a los muchos demonios que las llevan.<N><N>Los he comandado en mis sueños.
$ENTRY_JOURNAL_DREAM4_TITLE	
$ENTRY_JOURNAL_DREAM4_LEFT_0_00	Día 33: Cuarto sueño
$ENTRY_JOURNAL_DREAM4_LEFT_0_10	Los sueños, o más bien el sueño, en singular, que se alarga durante las noches como una narrativa continua, ahora acude a mí con más frecuencia e intensidad. Casi tengo miedo de cerrar los ojos cada noche; parece que mi mente no me pertenece cuando está atrapada en el mundo onírico.<N><N>Me encontraba en un lugar oscuro y desolado. El sol se había puesto y no volvería a salir. Lloré, rogando al cielo, pero mis pensamientos ocultos sabían que el sol nunca volvería a brillar.<N><N>La gran asamblea de gente que me acompañaba empezó a proferir lamentos y hacer ofrendas, suplicándole a algo que no entendían. Se acuchillaron a sí mismos y entre ellos, intentaron atacar todo lo que les rodeaba, como si la destrucción irrazonable pudiera hacer que volviera la luz que los había dejado. En la oscuridad, sus ojos no veían más allá de la violencia. Simplemente era lo que yo les había enseñado.<N><N>Hui de mi creación. Los gritos histéricos se perdieron en
$ENTRY_JOURNAL_DREAM4_RIGHT_0_00	el oscuro horizonte.  Seguí adentrándome en la oscuridad en lo que parecían siglos, esperando que el tiempo se acabara. Pero el tiempo no terminaba. Me precipité hacia las tinieblas, recorriendo la infinidad existente entre horizontes invisibles.<N><N>No podría decir los cientos de años que pasaron así; cuando me paro a pensarlo, me sorprende que una sola noche sea capaz de contener el tiempo de tantas vidas. Llené la infinidad con recuerdos de todos a los que había perdido y de todos a los que me había llevado; mis lágrimas eran veneno, mi mente una víctima digna. El frío de la oscuridad congeló las lágrimas en mi cuerpo. Seguí corriendo, pero no había salida. Había huido de mí misma.<N><N>Finalmente, tras muchos largos años, lo vi. No puedo decir que fuera una luz, pues sería comparable a la luz que había perdido. Era simplemente una disminución de la oscuridad. Pero había estado tanto tiempo en las tinieblas, privada de cualquier sensación salvo de mi propio dolor, que la presencia parecía una salida. Me giré y vi frente a mí una pequeña vela, exigua y tenue, titilando en el frío viento de la noche.
$ENTRY_JOURNAL_DREAM4_LEFT_1_00	 Todavía llorosa, me acerqué y la contemplé mientras trataba de calentarme.<N><N>No era una vela, sino un hombre, pequeño y canoso. Miré cómo me presentaba los adornos de su cortejo, lo mejor que su reino de telarañas podía ofrecer. Lo miré y no sentí nada. En ese momento, el vacío de mi corazón era el indulto más dichoso; que la tormenta de angustia y agitación de mi cabeza fuera reemplazada con un vacío... era más de lo que podría pedir o merecer. No sentir nada era la fantasía más feliz... me abandoné al olvido.<N><N>Ese abandono me trajo un placer amargo. Retiré las manos y descubrí que cada una sostenía una pequeña llama. Volví a llorar. ¿Qué linaje habrían perdido estas pequeñas luces que me pertenecían? Debían ser estrellas.<N><N>Tomé las dos mitades de mi corazón, los gemelos de piel y cabello dorado, como el mío, el color de la luz de los astros. Los abracé contra mi pecho, sollozaban por el padre que deberían haber tenido, el padre que nunca conocerían. Y allí estaban, curiosidades en un reino solitario, hijos de la avidez.
$ENTRY_JOURNAL_DREAM4_RIGHT_1_00	La oscuridad seguía creciendo.<N><N>Con mi llanto extinguí la vela.<N><N>Me desperté mientras mis labios pronunciaban extrañas palabras que no podía reconocer; nombres que no me atrevo a recordar.
$ENTRY_JOURNAL_DREAM4_TITLE	
$ENTRY_JOURNAL_STAHP_LEFT_0_00	Día 34 - no vuelvas a poner las zarpas en mi diario
$ENTRY_JOURNAL_STAHP_LEFT_0_10	Mientras camino entre estas ruinas recién exhumadas, las reliquias de un pasado que ha penetrado malévolamente en el presente, no puedo evitar pensar en la
$ENTRY_JOURNAL_STAHP_LEFT_0_20	    APABULLANTE ATRACCIÓN SENSUAL DE LA MUSCULATURA CONTORNEADA DE [berserker_hero_up].<N><N>KAHN Y KARISSA ASEDIAN MIS PENSAMIENTOS, SUS CONTONEOS RÍTMICOS SE CUELAN EN MIS SUEÑOS.<N><N>CREÍA SENTIR FASCINACIÓN POR EL BIGOTE DE [knight_hero_up], PERO AHORA ME DOY CUENTA DE HASTA QUÉ PUNTO PALIDECE SU SILUETA FRÁGIL Y PERTRECHADA EN COMPARACIÓN CON LOS BRILLANTES ABDOMINALES DE UN HOMBRE DE VERDAD.<N><N>OCUPAR LA MISMA ESTANCIA QUE [berserker_hero_up] Y OLER SU ROBUSTO ALMIZCLE DESATA MI LOCURA.
$ENTRY_JOURNAL_STAHP_RIGHT_0_00	SE LLAMA LA FIEBRE DE [berserker_hero_up].<N><N>NO EXISTE CURA.<N><N>DE HECHO, CADA NOCHE PIENSO EN LAS CALAMIDADES DE MI INFORTUNIO Y
$ENTRY_JOURNAL_STAHP_RIGHT_0_10	me pregunto cómo diantres [berserker_hero] se ha vuelto tan habilidoso para escribir mientras corre a toda velocidad.<N><N>También me pregunto cómo voy a doblar el cucharón para poder utilizarlo de nuevo.
$ENTRY_JOURNAL_DREAM5_TITLE	
$ENTRY_JOURNAL_DREAM5_LEFT_0_00	Día 34: Quinto sueño
$ENTRY_JOURNAL_DREAM5_LEFT_0_10	Parece algo habitual el despertarme en lo más profundo de la noche con palabras extrañas en mi boca y mi cabeza llena de oscuros pensamientos ajenos.<N><N>Me arrastré lentamente, pasé junto a [ranger_hero], que duerme con una mano agarrando su ídolo de zorro y la otra en el puño de su daga, y garabateé febrilmente con mi pluma sobre el pergamino, sin conocer las palabras hasta que aparecían en la página.
$ENTRY_JOURNAL_DREAM5_LEFT_0_20	Cuánto anhelaba verlas,<N>las luces que deberían haber sido mías,<N>desconocedoras de su linaje.<N>Y pienso<N>cuán doradas serían<N>si pudieran saborear<N>la corrupción de mi divinidad.<N>Aun así, sí, aun así,<N>la luz de mi interior sabe<N>que sería su ruina,<N>tal y como lo fui para ti.
$ENTRY_JOURNAL_DREAM6_TITLE	
$ENTRY_JOURNAL_DREAM6_LEFT_0_00	Día 35: Sexto sueño
$ENTRY_JOURNAL_DREAM6_LEFT_0_10	Parece como si cada noche el sueño me eludiera, y los insignificantes instantes en los que lo concilio se llenan con las vidas y los pensamientos de otros. Más palabras sordas que son enigmas para mi mente agotada.
$ENTRY_JOURNAL_DREAM6_LEFT_0_20	La voz del dios llamó<N>y dejaste atrás el polvo gris,<N>te deshiciste de los sórdidos hechizos de los mortales<N>y corriste hasta mí<N>portando en tus brazos una díada de salvación.<N><N>Si me lo pidieras, te lo daría<N>y acabaría con el mundo<N>o conmigo mismo.
$ENTRY_JOURNAL_DREAM6_LEFT_0_30	¿Quién habla a través de mis labios? ¿Quién vive a través de mis sueños?<N><N>Me hago estas preguntas, pero no deseo conocer la respuesta.
$ENTRY_JOURNAL_THRONE_ROOM_TITLE	
$ENTRY_JOURNAL_THRONE_ROOM_LEFT_0_00	Día 35 - El trono de Eztli
$ENTRY_JOURNAL_THRONE_ROOM_LEFT_0_10	Mientras escribo esto, [berserker_hero] está sentado tranquilamente en el trono.  En el trono de Eztli-Tenoch.<N><N>Al principio me ha hecho sentir desazón.  ¿Pero por qué debería sentir eso?  ¿Qué respeto merece la maldad?  Este hombre dorado no es más que un bravucón que ansía la divinidad.  Hay algo tremendamente patético en este tipo de maldad.  Alardea de la misma ilusión que los aspirantes a hombres buenos.  Observa este lugar: todo un palacio dedicado a reforzar una imagen creada por él mismo.  Mírame, grita, soy la personificación del poder.  El dios Eztli-Tenoch, impotente en su prisión de cristal.
$ENTRY_JOURNAL_THRONE_ROOM_RIGHT_0_00	Y aun así, hay otra parte de mí que lo comprende.  Una parte de mí que ha caminado por estos salones y que ha conocido la divinidad.  Me he sentado a su lado y he juzgado a la plebe.  He sentido la llamada divina.<N><N>Puede que sea esta muestra que aprecié en mis sueños la que motiva mi desdén.  He visto lo que él es y lo que él cree ser.
$ENTRY_JOURNAL_EVNI_TITLE	
$ENTRY_JOURNAL_EVNI_LEFT_0_00	Día 36 - Evni
$ENTRY_JOURNAL_EVNI_LEFT_0_10	Aunque no hay ningún motivo, lógica, ni razón, le he comprado a [berserker_hero] su <LQ>verdadero amor<RQ>. Nunca me lo perdonaré.<N><N>Pero hay algo que no puede negársele a [berserker_hero]: no es uno de esos hombres caprichosos que después de haber obtenido el objeto de su deseo se aburren inmediatamente y lo abandonan.<N><N>Evni se ha convertido en una más dentro de nuestra compañía. <LQ>Ella<RQ> tiene un sitio reservado cuando comemos. Y su espacio en los concilios. Y toda una serie de opiniones convenientemente traducidas por [berserker_hero], que <LQ>habla espadiano con soltura<RQ>.<N><N>Juro por la memoria de mis padres que no me invento ni adorno la historia, pero tiene su propia cama en la que [berserker_hero] la arropa por las noches, y en la que, os juro otra vez que esto no es una fantasía, le canta nanas para dormir. La decapitación es un tema recurrente.<N><N>
$ENTRY_JOURNAL_EVNI_RIGHT_0_00	En cuanto a [ranger_hero], está más áspera de lo normal. Durante el almuerzo de mediodía, [berserker_hero] se distrajo temporalmente mientras intentaba atrapar un insecto solo flexionando sus <LQ>pectorales de la destrucción<RQ>. [ranger_hero], que estaba sentada cerca y creía que nadie la observaba, alargó el brazo y derribó el tazón de gachas de [berserker_hero] sobre la espada. [berserker_hero] lloriqueó y se golpeó el pecho (con el que, por cierto, había conseguido aplastar el insecto), creyendo que su propia torpeza había sido la causa de la desgracia de Evni. Crucé la mirada con [ranger_hero] y la sostuve lo suficiente para que supiera que me había percatado de su travesura. Ella simplemente me enseñó los dientes.<N><N>APÉNDICE:<N>Ese mismo día, más tarde, me cobré una venganza, de manera extraña y accidental. Evni descansaba a la sombra mientras [berserker_hero] recogía flores con las que fabricarle un cenador para su <LQ>siesta de la tarde<RQ>. Mientras caminaba alrededor, me encontré con [ranger_hero]. Estaba sentada en cuclillas sobre la espada. Conforme me iba acercando, empecé a distinguir las palabras que siseaba en un ronco murmullo: <LQ>No eres nada para él. Se olvidará de ti. Un día desaparecerás y yo-<RQ>
$ENTRY_JOURNAL_EVNI_LEFT_1_00	Me aclaré la garganta, y [ranger_hero] dio un respingo. Tenía los ojos como platos. No sabía que un rostro humano podía alcanzar tal nivel de sonrojo.<N><N>Empezó a tartamudear, y al verse incapaz de proferir un insulto adecuado para distraerme, se tapó la cara con la capa y huyó.<N><N>Valoro ese momento como uno de los logros más importantes de mi vida.
$ENTRY_JOURNAL_PEACE_TITLE	
$ENTRY_JOURNAL_PEACE_LEFT_0_00	Día 38 - ¿Paz?
$ENTRY_JOURNAL_PEACE_LEFT_0_10	Qué sensación tan curiosa y exótica el no estar hostigados por el enemigo; lo único que espolea nuestro viaje es nuestro propio deseo de alcanzar la salida.<N><N>Y ahora que ha caído el último enemigo, soy la única mortal que conoce el secreto del fuego draconiano. [mage_hero] me mira con una extraña envidia. Ella carga con la maldición del infierno. En cambio entiende que yo he recibido el regalo del cielo.<N><N>Termino esta entrada con un descubrimiento un poco triste: Por primera vez desde el origen de mis habilidades surgidas a raíz de la plaga, soy capaz de llevar a cabo el tan demandado acto de <LQ>derretirle a alguien la cara<RQ>.
$ENTRY_JOURNAL_PEACE_LEFT_0_20	LA CARA SE ME DERRITIO HACE AÑOS POR ESO ME DEJE ESTE BIGOTE HORRIBLE PARA ESCONDER MI VERGUENZA EH QUE SOY [knight_hero_up] DEBAJO DEL BIGOTE MI CARA PARECE UN CULO Y NO UN BASTIÓN IMPRESIONANTE DE PODER Y GLORIA COMO
$ENTRY_JOURNAL_PEACE_RIGHT_0_00	<N><N><N><N>La ausencia de enemigos no significa que adopte la ausencia de violencia. 
$ENTRY_JOURNAL_PEACE_RIGHT_0_00_A	KHAN Y KARISSA SINO EN PLAN FLÁCIDO FOFO Y VIE
$ENTRY_JOURNAL_DREAM7_TITLE	
$ENTRY_JOURNAL_DREAM7_LEFT_0_00	Día 38 - Un sueño de despedida
$ENTRY_JOURNAL_DREAM7_LEFT_0_10	Mi sueño parece más placentero ahora, una vez superados los extraños sucesos que tuvieron lugar en la cámara del tesoro. Solo me desperté una vez por causas extraordinarias.<N><N>La noche era agradable y dormimos con las solapas de las tiendas abiertas. Me desperté y vislumbré la luna llena brillando resplandeciente a través de la abertura, con una luz tan intensa que me sentí reconfortada por su presencia.<N><N>Tal visión me provocó una respuesta que me cuesta describir. Me sentí dolorida y eufórica a la vez. Con el fervor del momento, comencé a hablar.<N><N>Las extrañas y desconocidas palabras que brotaron de mis labios ya no seguían en mi cabeza, pero su significado perdura al despertarme.
$ENTRY_JOURNAL_DREAM7_LEFT_0_20	 
$ENTRY_JOURNAL_DREAM7_RIGHT_0_00	Vienes, dime, has venido<N>con los deseos secretos de mi corazón dividido<N>a eclipsar mi oscuridad<N>o a liberarla.
$ENTRY_JOURNAL_ANTIAZRA_TITLE	
$ENTRY_JOURNAL_ANTIAZRA_LEFT_0_00	Día 37 - Tletl-Meztli
$ENTRY_JOURNAL_ANTIAZRA_LEFT_0_10	Apenas comprendo, por lo menos en cuanto a hechos, lo que ha ocurrido en la cámara del tesoro.<N><N>He presenciado mi propia muerte, o al menos, la muerte de un yo.  Tletl-Meztli, la luna de fuego.<N><N>Mirar a alguien y decir <LQ>yo he sido esta persona<RQ>, es un sentimiento muy extraño. Pero así ha ocurrido.  El poder, la pérdida, el castigo divino.  He vivido, al menos en parte, las cosas que originaron su creación.  Ahora he presenciado el sacrifico que acabó con ella.
$ENTRY_JOURNAL_ESCAPE_TITLE	
$ENTRY_JOURNAL_ESCAPE_LEFT_0_00	Día 39 - ¿Huida?
$ENTRY_JOURNAL_ESCAPE_LEFT_0_10	Zelemir ha vuelto.  Trae consigo una oferta traicionera: nuestra libertad, la salvación de nuestro mundo.  Todo a cambio de unas cuantas miles de vidas.  Una gota más en el embravecido océano de sangre.<N><N>[dragon_hero] está fuera de sí.  [mage_hero] echa espuma por la boca.<N><N>¡La salida está ahí mismo!<N><N>Cualquier decisión está llena de peligro: si me opongo a Zelemir pongo en riesgo mi vida, y las vidas de todos los que morirán si Eztli-Tenoch es liberado.  ¡Pongo en riesgo el destino del mundo!  Pero si dejo que lleve a cabo su plan, pongo en riesgo mi alma.<N><N>Ojalá hubiera muerto en Ash.  Ojalá no tuviera que tomar esta decisión.
$ENTRY_JOURNAL_FOLLOWING_ZELEMIR_TITLE	
$ENTRY_JOURNAL_FOLLOWING_ZELEMIR_LEFT_0_00	Día 40 - Siguiendo a Zelemir
$ENTRY_JOURNAL_FOLLOWING_ZELEMIR_LEFT_0_10	Ya no puedo decir que la solución de Zelemir fuera una locura.  Estaba bien razonada y muy meditada; el trabajo de un maestro estratega para resolver una terrible maldición.<N><N>Y es una solución abominable.<N><N>Aquel que combate el caos con la muerte de inocentes traiciona su propia causa.<N><N>Ya he combatido con él antes.  Lo haré tantas veces como sea necesario para proteger a esta gente.  O moriré en el intento.
$ENTRY_JOURNAL_EPILOGUE_TITLE	
$ENTRY_JOURNAL_EPILOGUE_LEFT_0_00	Epílogo
$ENTRY_JOURNAL_EPILOGUE_LEFT_0_10	Qué sentimiento tan extraño poder decir <LQ>No hay nada en absoluto que intente matarme en este momento<RQ>.<N><N>Todavía no estoy segura de poder creerlo.  Todavía espero que unas ovejas asesinas irrumpan en los pasillos de la Biblioteca.  Hasta ahora solo ha aparecido un ratoncillo del que me deshice rápidamente con el Tratado de Polimon sobre el correcto uso de las plantas.<N><N>[knight_hero] frecuenta bastante la Biblioteca.  El mes pasado quiso ver prácticamente todos los tratados militares que pude conseguirle, y tras haber agotado todos estos temas, ha expandido sus horizontes hacia cualquier cosa que esté a su alcance.  Creo que la última cosa que estuvo hojeando era un manual para la cría del hurón, juraría que lo escogió al azar, y se dedicó a hablar conmigo todo el tiempo en vez de leer.  Sabía que pasaba algo raro con él.
$ENTRY_JOURNAL_EPILOGUE_RIGHT_0_00	Aun así, es agradable tener alguien con quien poder hablar mientras repongo las estanterías.  Se usaron tantos libros para hacer fuego durante la peste que la Biblioteca ha quedado paupérrima.  Las estanterías estaban descorazonadoramente vacías cuando llegué.  <N><N>[knight_hero] ha donado muchos que ha comprado a los comerciantes nómadas, y ayer recibí un misterioso paquete con el mensaje <LQ>PARA [mcguffin_hero_up] Y SU ABURRIDO TRABAJO QUE ES MUCHO MENOS IMPRESIONANTE QUE EL MIO QUE ES MATAR COSAS<RQ><N><N>Contenía muchos textos extraordinariamente desconocidos de las tierras del oeste, fechados hace más de tres siglos, además de una colección de monigotes dibujados toscamente en la que ponía <LQ>YO<RQ> y se representaba matando varias monstruosidades.  Los guardaré todos para la posterioridad en la nueva ala este, junto a este diario, tan pronto como lo termine.<N><N>A menudo me pregunto cómo les va a mis viejos compañeros.
$ENTRY_JOURNAL_EPILOGUE_LEFT_1_00	Solo han pasado dos meses, pero sé que dos meses pueden ser setecientas aventuras para gente como [berserker_hero] y [ranger_hero].<N><N>No he tenido muchas noticias de [mage_hero], aunque de vez en cuando los comerciantes nómadas mencionan a una tal <LQ>Emperatriz tarada de las ruinas<RQ>, e imagino que eso significa que su reconquista marcha bien.<N><N>A veces temo por ella; tras la desaparición de los zombis y la peste, el Imperio Quaid será un territorio idóneo para cualquier aspirante a señor de la guerra o rey canalla, por no hablar de los reinos del norte.  No obstante, si hay alguien que puede combatir contra el mundo entero y triunfar, esa es [mage_hero].<N><N>[healer_hero] ha vuelto a su monasterio.  Recibo alguna que otra carta en las que detalla la lenta transformación del Foso.  Los comerciantes, viajeros y peregrinos vuelven a circular poco a poco, aunque tendrá que pasar algo de tiempo antes de que desaparezca
$ENTRY_JOURNAL_EPILOGUE_RIGHT_1_00	el estigma.  Puede que acepte su invitación y lo visite el mes que viene.  Están reconstruyendo la ciudad y eso significa la vuelta a la agitada vida urbana que detesto.<N><N>Mi espíritu ansía volver a disfrutar de los paisajes y el horizonte lejano.  Puede que incluso yo sea una aventurera, después de todo.  No hay duda de que [knight_hero] y sus guardias me acompañarían, de manera que el viaje no entrañara ningún peligro, y si pudiera persuadirlo para que cante otra vez, tampoco nos aburriríamos.<N><N>Creo que [dragon_hero] se ha marchado de una vez por todas del mundo de los <LQ>mortales<RQ>, pero no estoy segura.  La semana pasada alguien dejó un fardo lleno de manuscritos ilustrados con oro en el tejado de la Biblioteca.  Sería necesario un escalador experimentado para poder llevar un peso tan grande a tanta altura. Me gustaría creer que nuestro misterioso benefactor tenía el don de volar, lo que significaría que cierta deidad autoproclamada habría encontrado una pareja para que cuide de sus crías.
$ENTRY_JOURNAL_EPILOGUE_LEFT_2_00	Es un pensamiento positivo, y me quedaré con él.<N><N>Es raro hablar con otra gente que no sea de nuestro pequeño grupo.  A los pocos a los que les he empezado a contar algo, se han burlado de mis relatos o ya conocían parte de la historia por las historias enormemente exageradas que cuentan los refugiados que han vuelto.  <N><N>Esta mañana, dos niños me han parado en la calle y me han suplicado que le derrita la cara a un matón que les estaba amedrentando.  Siempre con lo de derretir caras.  Una mirada asesina ha bastado para que se escabullera a casa a cambiarse los pantalones, lo que ha funcionado mucho mejor con mi audiencia que lo de derretir caras.  Ha habido otros que se me han acercado en la calle pidiéndome que curara sus juanetes, bendijera a sus burros, maldijera a sus insoportables vecinos... la lista es interminable.<N><N>Puede que por eso me alegre tanto de ver a [knight_hero] en la Biblioteca.
$ENTRY_JOURNAL_EPILOGUE_RIGHT_2_00	Nunca hablamos de nuestras aventuras pasadas, pero hay un entendimiento implícito, unos cimientos comunes que nunca volveré a compartir con nadie que no haya sido miembro de nuestra compañía.<N><N>Me pregunto si alguna vez nos encontraremos todos de nuevo.<N>-[mcguffin_hero] Yalkie Livbar
$ENTRY_JOURNAL_EPILOGUE_RIGHT_2_10	<N>ME PREGUNTO SI ALGUNA VEZ APRENDERAS A GUARDAR TU DIARIO EN UN ESCONDITE MEJOR JAJA PROBABLEMENTE NO PORQUE SOY DEMASIADO INCREIBLE Y MI NOMBRE ES [knight_hero_up] Y NO MOLO NADA DE NADA ME GUSTA LLEVAR FLORES BONITAS EN EL PELO Y BAILAR CON MI FALDA MORADA CON VOLANTES CANTANDO LALALALALAY<N><N>EN SERIO [knight_hero_up] TENGO QUE ESCRIBIR ESTO POR TI?  ERES TAN TONT
$ENTRY_JOURNAL_EPILOGUE_RIGHT_2_20	<N>Me he guardado el cucharón de la sopa.
$ENTRY_JOURNAL_EPILOGUE_LEFT_3_00	Apéndice
$ENTRY_JOURNAL_EPILOGUE_LEFT_3_10	En los meses transcurridos desde nuestra extraña y tumultuosa victoria, solo he tenido un sueño: un eco, imagino, de los poderes oscuros que antes dominaban mi mente dormida.<N><N>Estaba cubierta por el polvo de largas travesías, y mi pequeño cuerpo macilento por los grandes y terribles viajes que había ido dejando atrás.<N><N>Crucé las enormes puertas azules de mi hogar hacia unos brazos abiertos que me recibían, era yo misma.<N><N>Me acerqué a su oído y le susurre las trágicas noticias.<N><N>Madre había vuelto a casa.<N><N>En mis pueriles manos sostenía su corazón desecado.
$ENTRY_JOURNAL_INDEX_2_LEFT_10	@<LQ>malla de placas<RQ>@
$ENTRY_JOURNAL_INDEX_2_LEFT_20	@Una aclaración sobre las dimensiones@
$ENTRY_JOURNAL_INDEX_2_LEFT_30	@Citas de las intros del acto@
$ENTRY_JOURNAL_INDEX_2_LEFT_40	@Los berserker y la adecuada colocación de la vaina@
$ENTRY_JOURNAL_INDEX_2_LEFT_50	@Jefe zombi@
$ENTRY_JOURNAL_INDEX_2_LEFT_60	@Túnica del jefe tribal y el Árbol del Mundo@
$ENTRY_JOURNAL_INDEX_2_LEFT_70	@Personajes eliminados: la Paladín y el Protector@
$ENTRY_JOURNAL_INDEX_2_LEFT_80	@Ojo de la Llama@
$ENTRY_JOURNAL_INDEX_2_LEFT_90	@La mano derecha de Eztli Tenoch@
$ENTRY_JOURNAL_INDEX_2_LEFT_100	@Gedemon Dalavbar, Maestro de Arqueros@
$ENTRY_JOURNAL_INDEX_2_LEFT_110	@Introducción@
$ENTRY_JOURNAL_INDEX_2_LEFT_120	@Receta del bocadillo favorito de James@
$ENTRY_JOURNAL_INDEX_2_LEFT_130	@Arreo del Lord Guardián@
$ENTRY_JOURNAL_INDEX_2_LEFT_140	@El bigote de Markos@
$ENTRY_JOURNAL_INDEX_2_LEFT_150	@El nombre de Markos@
$ENTRY_JOURNAL_INDEX_2_LEFT_160	@La falda de Markos@
$ENTRY_JOURNAL_INDEX_2_LEFT_170	@El hechizo de Markos y el libro de los cinco anillos@
$ENTRY_JOURNAL_INDEX_2_LEFT_180	@Presentación del berserker: escena eliminada@
$ENTRY_JOURNAL_INDEX_2_LEFT_190	@Nombres e idiomas@
$ENTRY_JOURNAL_INDEX_2_LEFT_200	@Poniéndole un nombre al mal@
$ENTRY_JOURNAL_INDEX_2_LEFT_210	@Espiritismo nómada@
$ENTRY_JOURNAL_INDEX_2_LEFT_220	@Fin@
$ENTRY_JOURNAL_INDEX_2_LEFT_230	@Cicatrices@
$ENTRY_JOURNAL_INDEX_2_LEFT_240	@Slak el Bibliotecario@
$ENTRY_JOURNAL_INDEX_2_LEFT_250	@Inspiraciones para la historia@
$ENTRY_JOURNAL_INDEX_2_LEFT_260	@Fuerza de Wocolan@
$ENTRY_JOURNAL_INDEX_2_LEFT_270	@Las tribus de los Dementes de Sangre@
$ENTRY_JOURNAL_INDEX_2_LEFT_280	@Las ciudades estado del norte@
$ENTRY_JOURNAL_INDEX_2_LEFT_290	@El Credo del Fuego Imperial de Quaid@
$ENTRY_JOURNAL_INDEX_2_LEFT_300	@Los Selini@
$ENTRY_JOURNAL_INDEX_2_LEFT_310	@El Templo de Ash@
$ENTRY_JOURNAL_INDEX_2_LEFT_320	@Hábito del monje guerrero@
$ENTRY_JOURNAL_INDEX_2_LEFT_330	@El nombre de Zelemir@
$ENTRY_JOURNAL2_INTRODUCTION_TITLE	 
$ENTRY_JOURNAL2_INTRODUCTION_LEFT_00	Introducción
$ENTRY_JOURNAL2_INTRODUCTION_LEFT_10	¡Hola a todos! Este es nuestro diario ultrasecreto entre bambalinas con todo tipo de información top secret de detrás de las cámaras, como lo que pasaba por mi cabeza cuando escribía ciertas partes de la historia (normalmente cosas como <LQ>¿cuándo fue la última vez que vi el sol?<RQ> y <LQ>¿por qué Hugh Jackman no ha contestado a ninguna de mis cartas en las que le digo que quiero ser su mejor amigo?<RQ>, pero también cosas interesantes de la historia que a la gente le podría interesar leer como <LQ>el origen de la cicatriz del rostro de Wrenna cuando fue capturada durante la guerra e intentó cortarse su propia lengua antes de revelar secretos al ser torturada<RQ> y <LQ>¡Ahora que soy el autor puedo tener tantas frases explicativas mal construidas como quiera! ¡Ja ja ja ja ja!<RQ> (En serio, esto parece una muñeca rusa.))<N><N>Ah, claro, tal vez debería presentarme. Me llamo James <LQ>Autor Principal Endiabladamente Guapo<RQ> Cavin. Como habréis adivinado por el nombre increíblemente preciso que mis padres me pusieron, soy el escritor de la historia de Defender's Quest: Valley of the Forgotten. También
$ENTRY_JOURNAL2_INTRODUCTION_RIGHT_0_00	debería reconocer el trabajo de Lars <LQ>No Tan Guapo Como James Pero Bastante Guapo Es Decir De Manera Completamente Platónica<RQ> Doucet, que ha escrito parte del texto de los objetos y los enemigos cuando no estaba ocupado programando y esas cosas. (En serio, nuestros padres demostraron una visión de futuro sorprendente cuando estaban rellenando nuestros certificados de nacimiento).<N><N>Bueno, este diario entre bambalinas tendrá todo tipo de información del trasfondo de la historia, notas sobre la construcción del mundo, ideas rechazadas, etc. Será como echar un vistazo al alocado y fantástico proceso creativo que desembocó en la historia de Valley of the Forgotten, salvo por lo de alimentarte con los cubos de basura y llorar por las noches hasta dormirte. ¡Vamos a comenzar juntos este viaje fantástico!<N><N>Por cierto, Hugh (¿puedo llamarte Hugh?), si estás ahí, ¿te llegó la invitación a mi fiesta de cumpleaños? Créeme, si no vienes todo el mundo pensará que eres un carca. ¡Mis peluches sí que vendrán a la fiesta!
$ENTRY_JOURNAL2_INTRODUCTION_LEFT_1_00	 
$ENTRY_JOURNAL2_INTRODUCTION_RIGHT_1_00	 
$ENTRY_JOURNAL2_PLATEMAIL_TITLE	 
$ENTRY_JOURNAL2_PLATEMAIL_LEFT_00	<LQ>malla de placas<RQ>
$ENTRY_JOURNAL2_PLATEMAIL_LEFT_10	Hay mucha gente que utiliza indiscriminadamente el término <LQ>malla de placas<RQ>. Cuando apareció por primera vez en Defender's Quest como nombre para algunos de los objetos de armadura pesada, dejé inmediatamente lo que estaba haciendo (contemplar de manera impropia unos manuscritos alemanes del arte de esgrimir espadas largas) y tomé las riendas. A ver, <LQ>malla de placas<RQ> es un término estúpido y redundante que nunca debería asociarse a nada que tenga valor. Pero... si existe la <LQ>malla de cadena<RQ>, entonces la armadura de placas sería una <LQ>malla de placas<RQ>, ¿no? ¡PUES NO!<N><N>La palabra <LQ>malla<RQ> (o <LQ>maille<RQ>, si nos ponemos exquisitos), viene de una palabra medieval francesa que significa <LQ>cadena<RQ>. La expresión <LQ>malla de cadena<RQ> es una redundancia que no surgió hasta el siglo XIX. Una vez que <LQ>malla de cadena<RQ> caló en el vocabulario popular, la gente olvidó el significado original de la parte <LQ>malla<RQ> y lo suplieron como si significara <LQ>armadura o algo así, no sé<RQ>. Después empezaron a añadirlo al final de todo lo que simplemente debería haberse llamado armadura.
$ENTRY_JOURNAL2_PLATEMAIL_RIGHT_0_00	Ya que estoy poniendo a todo el mundo en mi contra, ¿podemos hablar sobre lo de poner pinchos en todas partes? ¿Qué vas a hacer, abrazar a la gente hasta matarla? ¿Qué pasa si quieres levantar el brazo más de 30° y de repente los pinchos de más de 20 centímetros que llevas en el hombro te atraviesan la cabeza? ¿Cómo se supone que vas a moverte y luchar embutido en algo que empalaría a su portador en cualquier posición que no sea <LQ>pose dramática estática<RQ>?<N><N>¿Eh, adónde se ha ido todo el mundo?
$ENTRY_JOURNAL2_PLATEMAIL_LEFT_1_00	 
$ENTRY_JOURNAL2_PLATEMAIL_RIGHT_1_00	 
$ENTRY_JOURNAL2_DIMENSIONS_TITLE	 
$ENTRY_JOURNAL2_DIMENSIONS_LEFT_00	Una aclaración sobre las dimensiones 
$ENTRY_JOURNAL2_DIMENSIONS_LEFT_10	<N>Para los que estéis interesados en la naturaleza del <LQ>mundo intermedio<RQ>, aquí podéis ver una descripción de uno de nuestros documentos de diseño interno sobre cómo funcionan las dimensiones:<N><N>La realidad está formada por muchas capas diferentes. Lo que percibimos es la combinación de una fracción de cada <LQ>dimensión<RQ> o <LQ>reino<RQ>. Los colores, los sabores, el tacto, el olor, etc. son diminutos destellos en su propia dimensión. Solo la punta del iceberg se cruza con el mundo. Pero mediante una concentración extrema, uno puedo separar las capas y experimentar por completo la dimensión en su totalidad. El <LQ>reino<RQ> con el que más interactuamos es el reino de las <LQ>sombras<RQ>, tal y como lo denominan los personajes. El reino de las sombras es la dimensión del espíritu: algo así como un ideal platónico aplicado a todos los objetos de la existencia. Todos los seres vivos están animados por una fuerza invisible que apenas podemos sentir, pero en el reino de la sombras, uno puede palpar esta fuerza espiritual e interactuar con ella. Tal y como explica el sanador:
$ENTRY_JOURNAL2_DIMENSIONS_RIGHT_0_00	SANADOR: Cada uno de vuestros sentidos solo os ofrece un ápice de lo que existe realmente.<N><N>BIBLIOTECARIA: Entiendo.<N><N>SANADOR: La realidad está formada por capas...–<N><N>BERSERKER: ¿Como una tarta?<N><N>SANADOR: ... Sí... como una tarta. Estas capas conforman el mundo que percibim–<N><N>BERSRERKER: ¿Qué tipo de tarta?<N><N>BIBLIOTECARIA: ¡Una tarta de realidad! ¡Cállate ya!<N><N>BERSERKER: Mmm... Tarta de realidad... ñam ñam.
$ENTRY_JOURNAL2_DIMENSIONS_LEFT_1_00	 
$ENTRY_JOURNAL2_DIMENSIONS_RIGHT_1_00	 
$ENTRY_JOURNAL2_ACTQUOTES_TITLE	 
$ENTRY_JOURNAL2_ACTQUOTES_LEFT_00	Citas de las intros del acto
$ENTRY_JOURNAL2_ACTQUOTES_LEFT_10	Algunas de las cosas con las que más disfruté al escribirlas fueron los pequeños fragmentos de texto que abrían cada acto de la historia. Pude experimentar con otras voces y presentarle al jugador pequeños retazos del amplio mundo en el que se desarrolla la historia. Al principio del séptimo acto, se me ocurrieron tres citas diferentes, y finalmente escogí mi preferida para utilizarla en el juego. Estas son las dos que no pasaron el corte: <LQ>Cuando se enfrenta a una decisión, el hombre egoísta contempla un gran abanico de resultados, sopesando qué opción le concederá el mayor beneficio.  El hombre íntegro solo piensa en las acciones que servirán a la Llama<RQ>.<N>- extracto del libro de los siete deseos sobre el camino de la espada<N><N><LQ>Contemplo los rostros de nuestros mercenarios norteños y veo la ruina de un hombre que ha apostado y ha perdido.  Todos tenemos que morir, pero yo moriré por mi hogar, por mi familia y por el rey y el Templo.  Ellos van a morir por unas míseras monedas de oro<RQ>.<N>- defensor desconocido, asedio del Paso de Karedon
$ENTRY_JOURNAL2_ACTQUOTES_RIGHT_0_00	La que finalmente se incluyó en el juego es esta:<N><LQ>Dicen que los hombres temen a la muerte.  Según mi experiencia, a lo que realmente temen los hombres es a la incertidumbre de la muerte.  Durante esa dura prueba, cuando la muerte era el único resultado posible, me embargó una embriagadora calma que nunca antes había sentido, y que nunca he vuelto a sentir.  Solo cuando la oportunidad de sobrevivir se manifestó, volví a sentir la verdadera opresión del miedo<RQ>.<N>-extracto de las memorias de Gedemon Dalavbar, Maestro de Arqueros, una historia de sus aventuras y proezas al servicio del rey de Ash<N><N>Esta cita está inspirada principalmente en un pasaje de La sombra del torturador, de Gene Wolfe, un libro que empecé a leer cuando estaba terminando el trabajo de Defender's Quest. (No fui consciente de esta inspiración hasta mucho después de haber terminado de escribir esta parte). Es un libro verdaderamente peculiar e inquietante que no recomendaría a los lectores más jóvenes. Sin embargo, para una audiencia más madura interesada en iniciar un viaje a un lugar nuevo y desconocido, este libro captura una esencia de otredad en su mundo y valores que rara vez se encuentran en la ficción moderna.
$ENTRY_JOURNAL2_ACTQUOTES_LEFT_1_00	Hablando de inspiraciones, la idea de que cada acto tuviera un poco de texto introductorio fue sacada de Thief: The Dark Projekt, uno de mis juegos favoritos de todos los tiempos. Creo que nunca he jugado a ningún otro juego que tuviera una ambientación con tal derroche de imaginación, detalles y belleza conmovedora. La imagen de Garret, el Maestro de Ladrones, mimetizándose silenciosamente con las sombras de La Ciudad entre la maquinaria industrial y los horrores ocultos, escabulléndose sin ser visto entre las facciones enfrentadas, es algo que permanecerá conmigo durante el resto de mi vida. A veces lloro cuando lo pienso. Aunque quizá esté más relacionado con toda la pintura que me comí cuando era un crío...
$ENTRY_JOURNAL2_ACTQUOTES_RIGHT_1_00	 
$ENTRY_JOURNAL2_BERSERKERS_TITLE	 
$ENTRY_JOURNAL2_BERSERKERS_LEFT_00	Los berserker y la adecuada colocación de la vaina
$ENTRY_JOURNAL2_BERSERKERS_LEFT_10	Eh, colega, ¿¡a que mola cuando un mercenario asesino lleva una espada despampanante en la funda a la espalda en lugar de en la cadera como una persona normal!? De hecho, mola tanto, que originalmente diseñé al Berserker así. Por suerte, mi espíritu exaltado por la neurótica obsesión histórica se materializó frente a mí, me arreó una bofetada con una mano enguantada en malla auténtica 100 % ribeteada y puntualizó que llevar la espada a la espalda es lo más estúpido que a alguien se le ocurriría hacer.<N><N>¡Pero Link! ¡Y Geralt! ¡Y los ninjas!<N><N>A lo que el espíritu de la neurótica obsesión histórica contesta: La espalda es un sitio genial para guardar cosas si solo quieres transportarlas. Por ejemplo, las mochilas.<N>Sin embargo, si quieres ser capaz de desenvainar un arma, verás que es imposible hacerlo desde la espalda. Adelante, inténtalo. Sacar cualquier cosa de cualquier longitud
$ENTRY_JOURNAL2_BERSERKERS_RIGHT_0_00	de una funda, requiere una fuerza hercúlea. (Hubo un emperador romano, creo que fue Adriano, estoy demasiado vago para buscarlo ahora mismo, que de hecho presumía en uno de sus escritos de que Londres era una ciudad tan subyugada que sus tropas podían recorrer las calles con las armas a la espalda. Porque... si existiera el peligro de que te atacaran... querrías tener tus armas en un sitio donde realmente pudieras alcanzarlas).<N><N>La próxima vez que veas una película en la que un tío superguay lleva la espada a la espalda (o mejor aún, dos espadas), fíjate atentamente cuando la desenfunde. Te darás cuenta de que la película siempre lo omite convenientemente; extrae un par de centímetros de la funda (con el correspondiente sonido siseante del choque del metal que, por cierto, solo se escucharía si alguien estuviera arañando a conciencia la espada) y después, mágicamente, ya se ve con la espada completamente desenvainada. Esto se debe a que la parte que falta es anatómicamente imposible: no puedes sacar desde la espalda nada más largo que tu brazo. Al menos no sin dislocarte algo.<N><N>Pues bien, hay gente que está tan obsesionada con
$ENTRY_JOURNAL2_BERSERKERS_LEFT_1_00	la espectacularidad de desenvainar cosas desde la espalda que ha diseñado fundas especiales cuyo único fin es este. Son esta especie de fundas partidas, que son estúpidas, tienen una pinta estúpida y solo la gente estúpida las usa. Además, sigue sin funcionar tan bien como desenvainar desde la cadera. (Muchos incluso le ponen un gran aro de metal en la parte superior, así te aseguras el oír el sonido metálico… Claro, tienes un aro de metal enorme destrozando el filo de la espada).<N><N>En definitiva, lo que digo es que la gente está obsesionada con lo <LQ>guay<RQ> que queda desenvainar la espada desde la espalda aunque nunca, nunca jamás vaya a funcionar igual que desenfundarla desde la cadera como una persona normal, ni siquiera si diseñas una especie de superfunda específicamente para esto.<N><N>Afortunadamente, subsané mi terrible error y ahora todos nuestros berserkers disfrutan de una colocación de la funda correcta y fisiológicamente viable. Después me pasé dos horas en YouTube, viendo vídeos en alemán sobre cómo esgrimir espadas y llorando por mis pecados.
$ENTRY_JOURNAL2_BERSERKERS_RIGHT_1_00	P. D.: Si te fijas, verás que en los juegos en 3D el personaje lleva la espada a la espalda, y la espada mágicamente atraviesa la funda en lugar de salir por la boca al completo.<N><N>Segunda P. D.: algunos sables napoleónicos y los de las fuerzas militares victorianas disponen de fundas metálicas con un muelle de metal en la entrada. Este presiona la espada para que se ciña en su sitio, de esta manera, al desenfundar se crea ese sonido de choque metálico siseante que tanto gusta en las películas. Este muelle también deteriora la hoja, así que si encontráis un sable de esta variedad, es frecuente que tengan un desgaste importante en la hoja en la zona en la que el muelle rozaba cada vez se extraía. Así que sí, ese sonido tan molón tiene su explicación, aunque es muy limitado y sigue siendo perjudicial para las espadas a largo plazo. Ahora, si me disculpáis, tengo que autoflagelarme mientras leo unos manuales del manejo de la espada y la rodela.
$ENTRY_JOURNAL2_BOSSREVENANT_TITLE	 
$ENTRY_JOURNAL2_BOSSREVENANT_LEFT_00	Jefe zombi
$ENTRY_JOURNAL2_BOSSREVENANT_LEFT_10	Para los que sintáis curiosidad por nuestro jefe zombi, aquí os dejo una explicación de uno de nuestros documentos de diseño internos:<N><N>Algunos zombis pueden ser más poderosos que otros dependiendo de cuánta concentración espiritual deposite el hechicero en ese peón en concreto. Además, algunas <LQ>cáscaras<RQ> son más conductivas que otras. Por ejemplo, un poderoso nigromante podría residir en los cadáveres de unas ardillas. Y aunque un ejército de ardillas zombi sería bastante desternillante, las ardillas no tienen la misma profundidad de existencia espiritual que tienen los humanos; su ser llega en menor medida al reino de las sombras. Básicamente, cuanto mayor es el vacío que deja un alma, más espacio hay disponible para que el hechicero lo llene con su propia concentración espiritual (lo ideal es hacerlo tan pronto como muera el ente; si el cadáver se corrompe, también lo hacen sus dimensiones espirituales. Cuanto más envejece un cadáver, menos puede hacer). Esto también se aplica a las personas. No todo el mundo tiene tanto espacio para que el hechicero trabaje. Las vasijas poco profundas solo pueden llevar
$ENTRY_JOURNAL2_BOSSREVENANT_RIGHT_0_00	una pequeña cantidad de su espíritu y no le permitirán hacer cosas que requieran más energía de la que puedan albergar. Por otro lado, algunas personas tienen una profundidad espiritual mucho más considerable, y le ofrecen mucho más espacio para trabajar; cuanto más reciente es el cadáver, más vacío espiritual puede llenar.
$ENTRY_JOURNAL2_BOSSREVENANT_LEFT_1_00	 
$ENTRY_JOURNAL2_BOSSREVENANT_RIGHT_1_00	 
$ENTRY_JOURNAL2_CHIEFTANSTUNIC_TITLE	 
$ENTRY_JOURNAL2_CHIEFTANSTUNIC_LEFT_00	Túnica del jefe tribal y el Árbol del Mundo
$ENTRY_JOURNAL2_CHIEFTANSTUNIC_LEFT_10	Las raíces retorcidas del Árbol del Mundo que decoran la Túnica del jefe tribal formaban parte de mis múltiples esfuerzos por aludir a una cultura y folclore más profundos para nuestras diferentes facciones, en este caso para los nómadas.<N>Hay muchas culturas del mundo real que tienen el concepto del Árbol del Mundo, pero me inspiré específicamente en un extracto de folclore griego muy extraño que leí sobre unos duendecillos balcánicos llamados Kallikantzaroi. Los Kallikantzaroi pasan todo el año bajo tierra serrando las raíces del Árbol del Mundo con la esperanza de que colapse (y por consiguiente, también el mundo). Supongo que los Kallikantzaroi simplemente son así de idiotas. Bueno, pues el único momento en el que dejan de intentar acabar con el mundo es en Navidad, que llega justo cuando están a punto de serrar el Árbol del Mundo. El día de Navidad, salen a la superficie y van por ahí haciendo pis en las cervezas de la gente, robándoles caramelos a los niños, tirando cepillos de dientes al váter y, en general, comportándose como unos bufones de mucho cuidado.
$ENTRY_JOURNAL2_CHIEFTANSTUNIC_RIGHT_0_00	La diversión se termina para ellos en la Noche de Reyes, en la que son desterrados de vuelta bajo tierra. Entonces se dan cuenta de que han sido las verdaderas víctimas de la broma; las raíces del Árbol del Mundo han sanado por completo. Esto ocurre todos los años, porque los Kallikantzaroi no solo son unos payasetes, son unos payasetes increíblemente estúpidos. (Me gusta pensar que el Árbol del Mundo hizo pis en todas sus cervezas mientras no estaban).<N>Ah, y si quieres proteger tu cerveza, los caramelos de los niños y los cepillos de dientes de los Kallikantzaroi, solo tienes que poner un colador en el porche. Los Kallikantzaroi solo pueden contar hasta el número dos; al ser el número de la Trinidad, el tres es un número sagrado. Si uno de los Kallikantzaroi lo dice en voz alta, muere inmediatamente. Así que si pegas un colador en la puerta, estos gamberretes se quedarán ahí toda la noche intentando contar todos los agujeros que tiene, pero siempre perderán la cuenta después del segundo. Después solo tienes que levantarte a la mañana siguiente, desenfundar tu calibre 45 favorito, apuntar a esos idiotas obsesionados con las matemáticas al trasero, poner los cuerpos en la trituradora de basura y disfrutar de una cerveza sin orina durante el resto de las vacaciones. Al menos yo imagino que funciona así.
$ENTRY_JOURNAL2_CHIEFTANSTUNIC_LEFT_1_00	 
$ENTRY_JOURNAL2_CHIEFTANSTUNIC_RIGHT_1_00	 
$ENTRY_JOURNAL2_CUTCHARS_TITLE	 
$ENTRY_JOURNAL2_CUTCHARS_LEFT_00	Personajes eliminados: la Paladín y el Protector
$ENTRY_JOURNAL2_CUTCHARS_LEFT_10	En un principio íbamos a tener una plantilla de personajes todavía más amplia, pero hubo que descartar personajes para mantener el juego en una escala más manejable. La Paladín y el Protector acabaron entre la lista de descartes.<N><N>El Protector iba a ser un tipo de unidad <LQ>tanque<RQ> eminentemente defensiva que cargaba con un escudo gigantesco. El truco es que podía proteger a los aliados cercanos además de protegerse a sí mismo. Por lo tanto, si un defensor que se encontrara a su lado fuera a recibir un golpe, el Protector se adelantaría y bloquearía el ataque con su escudo. Por lo que respecta a la historia, si no recuerdo mal, el Protector iba a formar parte de una aguerrida unidad militar de élite de Ash que creía tener la obligación moral de defender cualquier territorio en el que uno de sus miembros hubiera derramado sangre. Algunos elementos del Protector se reciclaron para Markos el Caballero, aunque los aspectos más fanáticas como <LQ>¡Nuestra sangre! ¡Las sangre de los patriotas!<RQ> se quedaron en la pila de descartes.
$ENTRY_JOURNAL2_CUTCHARS_RIGHT_0_00	La Paladín también tenía muchas coincidencias con el Caballero, y se suprimió de manera idéntica. De hecho, esta es la clase a la que Wrenna iba a pertenecer en un principio: la <LQ>fanática y belicosa princesa enemiga que se vuelve aliada a regañadientes<RQ> parecía un papel perfecto para alguien con una espada. Cuando esta clase finalmente se eliminó, decidí que el personaje de la princesa enemiga era demasiado bueno como para no usarlo en alguna parte, y así nació la Maga Gélida que todos conocemos y adoramos.<N><N>Ya que estamos con el tema de las clases que cambiaron, en un principio el Dragón iba a ser un Jinete de dragones. Esta unidad absurdamente dominante habría sido un dragón con un arquero montado en su lomo. Tal y como está ahora, las Arqueras son una de las clases más dominantes del juego, así que el Jinete de dragones se simplificó convirtiéndose en el típico Dragón. Creo que Niru lo agradece.
$ENTRY_JOURNAL2_CUTCHARS_LEFT_1_00	 
$ENTRY_JOURNAL2_CUTCHARS_RIGHT_1_00	 
$ENTRY_JOURNAL2_EYEOFFLAME_TITLE	 
$ENTRY_JOURNAL2_EYEOFFLAME_LEFT_00	Ojo de la Llama
$ENTRY_JOURNAL2_EYEOFFLAME_LEFT_10	La descripción de este objeto se inspiró en el poema anglosajón <LQ>The Ruin<RQ>, una elegía que homenajea las ruinas de una ciudad romana extinguida hace mucho tiempo. El poema solo se encontró en un manuscrito. Estaba tan dañado que el final del poema se va diluyendo en frases y palabras inconexas. Uno de los últimos fragmentos de texto comprensible dice así <LQ>Tal y como un rey...<RQ><N><N>Si nunca lo has leído, recomiendo encarecidamente buscar una copia, dedicar una década a dominar el inglés antiguo y leerlo en su versión original. O supongo que simplemente podrías encontrar una de las tropecientas traducciones que hay disponibles, pero entonces no podrías sentirte moralmente superior a la gente que te encuentras en las fiestas, retraerte, pasarte el resto de la noche sentado en una esquina bebiendo solo y farfullando obscenidades en inglés antiguo contra todo el mundo, ni te echarían porque las obscenidades que dices en inglés antiguo son sospechosamente igual de insultantes que en otros idiomas.
$ENTRY_JOURNAL2_EYEOFFLAME_RIGHT_0_00	 
$ENTRY_JOURNAL2_EYEOFFLAME_LEFT_1_00	 
$ENTRY_JOURNAL2_EYEOFFLAME_RIGHT_1_00	 
$ENTRY_JOURNAL2_RIGHTHAND_TITLE	 
$ENTRY_JOURNAL2_RIGHTHAND_LEFT_00	La mano derecha de Eztli Tenoch
$ENTRY_JOURNAL2_RIGHTHAND_LEFT_10	<N>Cuando en un primer momento incluí la mano derecha de Eztli Tenoch en la historia, quise referirme por <LQ>mano derecha<RQ> a lo que un general sería para su gobernante, <LQ>la mano derecha del rey<RQ>. Simplemente se trataba de una figura retórica. La mano derecha de Eztli Tenoch solo iba a ser un gigantesco zombi particularmente aterrador que actuaba como el mejor sirviente de Eztli.<N><N>Después del planteamiento inicial, la idea se plasmó de forma literal, dando como resultado el sprite de la espeluznante mano gigante que aparece en el juego a día de hoy. Me resistía a rehacer los diseños, así que simplemente añadí unas pocas líneas explicativas en el diálogo. ¡De hecho, esta falta de comunicación resultó en uno de los combates contra un jefe más memorables del juego! (Además, Lars escribió el texto de descripción para la Mano Derecha, así que el <LQ>siniestro<RQ> juego de palabras no es solo culpa mía).
$ENTRY_JOURNAL2_RIGHTHAND_RIGHT_0_00	 
$ENTRY_JOURNAL2_RIGHTHAND_LEFT_1_00	 
$ENTRY_JOURNAL2_RIGHTHAND_RIGHT_1_00	 
$ENTRY_JOURNAL2_MASTEROFARCHERS_TITLE	 
$ENTRY_JOURNAL2_MASTEROFARCHERS_LEFT_00	Gedemon Dalavbar, Maestro de Arqueros
$ENTRY_JOURNAL2_MASTEROFARCHERS_LEFT_10	Gedemon Dalavbar, autor de la cita que adorna una de las intros de nuestros actos, es uno de los tantos que llevaron la armadura del Maestro de arqueros.<N><N>Contemplé brevemente la idea de escribir un libro completo de sus aventuras antes de decidir que este tipo de atención por los detalles me volvería loco.<N><N>Quién sabe, algún día...<N><N>(Está claro que Klest Kada, el aventurero nómada, tendría que tener su propia historia también).
$ENTRY_JOURNAL2_MASTEROFARCHERS_RIGHT_0_00	 
$ENTRY_JOURNAL2_MASTEROFARCHERS_LEFT_1_00	 
$ENTRY_JOURNAL2_MASTEROFARCHERS_RIGHT_1_00	 
$ENTRY_JOURNAL2_SANDWICH_TITLE	 
$ENTRY_JOURNAL2_SANDWICH_LEFT_00	Receta del bocadillo favorito de todos los tiempos
$ENTRY_JOURNAL2_SANDWICH_LEFT_10	Tío, escribir todo esto me ha abierto el apetito. ¿Vosotros tenéis hambre? Yo sí que tengo. Hay que ponerle solución.<N><N>Necesitáis:<N><N>Salchichas<N>Huevos<N>Pan<N>Tomates<N>Chucrut<N>Mostaza<N>Yogur (natural, sin azúcar, no somos unos debiluchos)<N>Salsa picante (a mí me gusta al estilo Louisiana, pero puedes escoger otra si eres una especie de inadaptado social o un comunista)
$ENTRY_JOURNAL2_SANDWICH_RIGHT_0_00	Paso 1:<N>Mata un animal (preferiblemente un animal flipante, como un tiburón), machaca su cadáver y después mete sus restos en su propio intestino. Como alternativa, supongo que podrías ir a comprar unas salchichas, ¿pero qué tiene eso de divertido?<N><N>Paso 2:<N>Corta la salchicha a lo largo en tiras gruesas.<N><N>Paso 3:<N>Fríe las tiras de salchicha en una sartén hasta que ambos lados queden dorados y crujientes, pero sin pasarte.<N><N>Paso 4:<N>Fríe los huevos (tantos como creas que puedas poner en un bocadillo; yo normalmente pongo 2, pero tú no te cortes) sobre la grasa que ha soltado la salchicha.<N><N>Paso 5:<N>Este pan es demasiado sano si lo comparamos con el resto de los ingredientes. ¡Coge a ese desgraciado y fríelo en la grasa de la salchicha que queda! Puedes añadir más grasa si lo necesitas. Lo importante es que el pan se
$ENTRY_JOURNAL2_SANDWICH_LEFT_1_00	ha transformado en algo que remotamente podía contener algún beneficio para la salud en un crujiente e inminente infarto cardiaco repleto de grasa. Recuerda: si la comida no te llena de remordimientos, lo estás haciendo mal.<N><N>Paso 6:<N>¡Ahora la salsa! Combina cantidades aproximadamente iguales de mostaza y yogur en un bol, o en otro recipiente adecuado, como las calaveras huecas de tus enemigos. Añade salsa picante al gusto y remueve hasta que todo esté mezclado de manera homogénea. Si todavía queda grasa de la salchicha en la sartén, este es el momento de añadirla.<N><N>Paso 7:<N>¡Hora de montar el bocadillo! Extiende generosamente la salsa en las dos mitades del pan. Ahora amontona todos los ingredientes aleatoriamente: huevos fritos, tiras de salchicha frita, chucrut, tomate en rodajas, dedos cercenados accidentalmente, etc. El monumento resultante de esta grandeza debería medir al menos doce centímetros.
$ENTRY_JOURNAL2_SANDWICH_RIGHT_1_00	Paso 8:<N>Devora. Como todos los ingredientes chorrean grasa, el bocadillo tiende a ponerse pastoso con el tiempo. Ni te plantees guardarlo para después, ¡comételo entero ahora mismo! ¡Sin piedad! ¡No hacemos prisioneros! ¡Que no quede nada! ¡La democracia está en juego!<N><N>Paso 9:<N>Arrepiéntete.
$ENTRY_JOURNAL2_LORDWARDEN_TITLE	 
$ENTRY_JOURNAL2_LORDWARDEN_LEFT_00	Arreo del Lord Guardián
$ENTRY_JOURNAL2_LORDWARDEN_LEFT_10	En un principio, el Lord Guardián iba a ser un personaje principal en la historia. En mis primeros borradores era el antagonista principal. Tras haber sido corrompido en secreto por la peste, habría usado su posición de autoridad en el Reino de Ash para trabajar a escondidas para la peste y su creador. Finalmente, Zelemir ocupó su lugar, ya que tenía una serie de motivaciones mucho más interesantes y complejas. No obstante, siempre me gustó el título y la ocupación del Lord Guardián, así que se reencarnó en una pieza de armadura. ¡Eh, al menos el nombre aparece en el juego! (Mucho más de lo que puede decirse de otros personajes eliminados).
$ENTRY_JOURNAL2_LORDWARDEN_RIGHT_0_00	 
$ENTRY_JOURNAL2_LORDWARDEN_LEFT_1_00	 
$ENTRY_JOURNAL2_LORDWARDEN_RIGHT_1_00	 
$ENTRY_JOURNAL2_MARKOS_MUSTACHE_TITLE	 
$ENTRY_JOURNAL2_MARKOS_MUSTACHE_LEFT_00	El bigote de Markos
$ENTRY_JOURNAL2_MARKOS_MUSTACHE_LEFT_10	La pelambrera que Markos tiene en la cara se debe a que su perilla original hacía que la gente lo identificara con un <LQ>vendedor de coches de segunda mano<RQ>.<N><N>El pelamen de su rostro se inspiró en Everett Burnside, general del Ejército de la Unión (inventor de las patillas), y en el líder de Motörhead, Lemmy Kilmister (inventor de una música tan metalera que si se mudara a tu barrio, el césped del jardín se secaría). A rockear, tío. A rockear.<N><N>Es todavía más impresionante cuando te das cuenta de que lo único que tiene para afeitarse es la espada...
$ENTRY_JOURNAL2_MARKOS_MUSTACHE_RIGHT_0_00	 
$ENTRY_JOURNAL2_MARKOS_MUSTACHE_LEFT_1_00	 
$ENTRY_JOURNAL2_MARKOS_MUSTACHE_RIGHT_1_00	 
$ENTRY_JOURNAL2_MARKOS_NAME_TITLE	 
$ENTRY_JOURNAL2_MARKOS_NAME_LEFT_00	El nombre de Markos
$ENTRY_JOURNAL2_MARKOS_NAME_LEFT_10	Curiosamente, el nombre de Markos procede de una historia muy rara que un profesor de St. Andrews le contó a un buen amigo mío. Durante su juventud temprana, este profesor hizo un tour por Europa. Mientras estaba en Francia visitó uno de las muchas catedrales medievales abiertas al público. Estaba tan embelesado por la estructura que decidió que sería una buena idea separarse del grupo del tour y esconderse, de esta manera, una vez que todo el mundo se marchara y la catedral cerrara, podría fisgonear y verlo todo sin un molesto guía turístico diciéndole dónde podía o no podía ir.<N>Su plan funcionó, y en cuanto la catedral hubo cerrado las puertas, salió a hurtadillas de su escondite y comenzó a inspeccionar. En ese momento atisbó un par de pies que asomaban por detrás de un tapiz. Resulta que no era el único que tuvo la gran idea de admirar en secreto la arquitectura medieval. La persona tras el tapiz resultó ser una joven de su mismo grupo turístico, y ambos comenzaron a explorar la catedral juntos. Ninguno de los dos, al estar distraídos por la conversación, 
$ENTRY_JOURNAL2_MARKOS_NAME_RIGHT_0_00	se percató de la llegada de un tercero hasta que les preguntó si les gustaría hacer un <LQ>tour secreto<RQ>. El hombre, que se presentó como Markos, tenía el pelo desaliñado, la barba descuidada y unas largas uñas. Al parecer, tenía la costumbre de esconderse en catedrales hasta que las cerraban para explorarlas por la noche, y contaba con una gran cantidad de información y capacidades secretas, hasta llegar al punto de interpretar improvisadamente con el órgano de la iglesia. Llegados a este punto explicó que muchas catedrales cristianas de la Edad Media en realidad se construyeron en antiguos emplazamientos paganos, y que a menudo estas obras paganas todavía existían bajo la estructura subsiguiente. De hecho, esta era la razón de su interés por las catedrales, ya que era un druida. Tras dedicar un tiempo a explorar la parte trasera de la iglesia, pudo localizar una trampilla de aspecto importante en el suelo, la cual se abrió hacia una catacumba que se extendía bajo la catedral. Los dos turistas, que al parecer no veían nada malo en seguir a un hombre extraño a una cámara mortuoria subterránea, se unieron a Markos bajo tierra, donde encontraron los restos de la tumba pagana sobre la que se había construido la iglesia. Tras juguetear un poco con las calaveras, Markos les dio las buenas noches, y cada uno se fue por su
$ENTRY_JOURNAL2_MARKOS_NAME_LEFT_1_00	 camino. Posteriormente, el futuro profesor y la joven se casaron. Me gusta pensar que Markos sigue viviendo en una gruta debajo de una catedral en alguna parte y se pinta de azul.<N><N>Me gustaba tanto el personaje que decidí que tenía que meter el nombre de Markos en algún momento.
$ENTRY_JOURNAL2_MARKOS_NAME_RIGHT_1_00	 
$ENTRY_JOURNAL2_MARKOS_SKIRT_TITLE	 
$ENTRY_JOURNAL2_MARKOS_SKIRT_LEFT_00	La falda de Markos
$ENTRY_JOURNAL2_MARKOS_SKIRT_LEFT_10	Para los que tenéis interés en estas cosas, la <LQ>falda<RQ> de la armadura de Markos está formada por tiras de cuero, lo que se conoce como pteruges. ¡Lo que uno aprende!<N><N>Puede que te sean familiares por los uniformes de los soldados griegos y romanos. El hecho de incluirlos en la armadura de Markos formaba parte de mi esfuerzo por imbuir Ash con una atmósfera bizantina/mediterránea.
$ENTRY_JOURNAL2_MARKOS_SKIRT_RIGHT_0_00	 
$ENTRY_JOURNAL2_MARKOS_SKIRT_LEFT_1_00	 
$ENTRY_JOURNAL2_MARKOS_SKIRT_RIGHT_1_00	 
$ENTRY_JOURNAL2_MARKOS_SPELL_TITLE	 
$ENTRY_JOURNAL2_MARKOS_SPELL_LEFT_00	El hechizo de Markos y el libro de los cinco anillos
$ENTRY_JOURNAL2_MARKOS_SPELL_LEFT_10	No golpees con la fuerza del brazo, sino con la fuerza del espíritu, con la mente y el cuerpo como un único ente, empuja y aleja a tu enemigo.
$ENTRY_JOURNAL2_MARKOS_SPELL_LEFT_20	El <LQ>hechizo<RQ> de Markos está inspirado en el libro de los cinco anillos, un fascinante tratado samurái sobre el manejo de la espada y tácticas escrito alrededor de 1645. El autor, Miyamoto Musashi, es uno de los duelistas samuráis más famoso de todos los tiempos. También ha servido como inspiración para unas cuantas películas superguays de Toshiro Mifune, las cuales recomiendo encarecidamente a cualquiera que le guste ver a Toshiro Mifune cortando en rodajas a otros tipos en el glorioso formato Technicolor de los cincuenta. (Toshiro Mifune también estaría más que invitado a mi fiesta de cumpleaños, si no fuera porque, bueno, murió cuando yo tenía 11 años).
$ENTRY_JOURNAL2_MARKOS_SPELL_RIGHT_0_00	 
$ENTRY_JOURNAL2_MARKOS_SPELL_LEFT_1_00	 
$ENTRY_JOURNAL2_MARKOS_SPELL_RIGHT_1_00	 
$ENTRY_JOURNAL2_MEET_BERSERKER_TITLE	 
$ENTRY_JOURNAL2_MEET_BERSERKER_LEFT_00	Presentación del berserker:<N>escena eliminada
$ENTRY_JOURNAL2_MEET_BERSERKER_LEFT_10	En un primer momento, el jugador no conseguía a Slak hasta terminar la primera batalla. Durante el primer combate, Azra solo combatía utilizando el hechizo de rayo; al final nos dimos cuenta de que esto confundía a los jugadores y les hacía creer que la mecánica principal del juego era utilizar hechizos en lugar de defensores.<N><N>Hicimos unos ajustes rápidos en el guion, encasquetamos a Slak en la primera batalla ¡y así estaba claro para los jugadores! Si estáis interesados en saber cómo se presentaba a Slak originalmente en el juego, esta es la escena eliminada:<N><N>AZRA:<N>(Aturdida)<N>    <LQ>Dios... ¿qué demonios ha sido eso?<RQ><N><N>AZRA:<N>(Desconcertada)<N>    <LQ>¿Cuánto tiempo llevo aquí?<RQ>
$ENTRY_JOURNAL2_MEET_BERSERKER_RIGHT_0_00	(Aparece SLAK)<N><N>SLAK:<N>(Emocionado)<N>    <LQ>¡Eso ha molado mucho!<RQ><N><N>AZRA:<N>(Desconcertada)<N>    <LQ>¿Cómo?<RQ><N><N>SLAK:<N>(Emocionado)<N>    <LQ>¡Acabas de cargarte veinte zombis!<RQ><N><N>AZRA:<N>(Desconcertada)<N>    <LQ>¿Zombis?<RQ><N><N>SLAK:<N>(Con naturalidad)<N>    <LQ>Ya sabes, monstruos, no muertos, sorbesesos, atrocidades renqueantes, cadáveres resucitados que deambulan devorando a la gente: zombis.<RQ>
$ENTRY_JOURNAL2_MEET_BERSERKER_LEFT_1_00	SLAK:<N>(Emocionado)<N>    <LQ>¡Ha molado MUCHO!<RQ><N><N>AZRA:<N>(Desconcertada)<N>    <LQ>Mira, no entiendo nada de lo que dices. Solo sé que estaba muy enferm-<RQ><N><N>SLAK:<N>(Con naturalidad)<N>    <LQ>... Y te arrojaron aquí para que murieras.<RQ><N><N>AZRA<N>(Desconcertada)<N>    <LQ>Sí.<RQ><N><N>SLAK:<N>(Imitando)<N>    <LQ>Y después los zombis en plan 'Oh, vamos a comerte'.<RQ><N><N>SLAK:<N>(Chiflado)
$ENTRY_JOURNAL2_MEET_BERSERKER_RIGHT_1_00	    <LQ>¡Y después te pusiste en plan '¡Ni de broma, comemierdas! Preparaos para saborear una ración de muerte eléctrica!'<RQ><N><N>SLAK:<N>(Encogido de miedo)<N>    <LQ>Y ellos en plan '¡Ah, dios mío! ¡Por favor, no nos frías con tus molones poderes letales eléctricos! ¡AH! ¡Cómo duele! ¡Quema! ¡ARDE CON LA FURIA HIRVIENTE DE MILES DE SOLES CONSUMIÉNDOSE!'<RQ><N><N>SLAK:<N>(Decepcionado)<N>    <LQ>Y después yo en plan 'Maldita sea, supongo que no voy a poder robarle los zapatos'.<RQ><N><N>AZRA:<N>(Irritada)<N>    <LQ>...<RQ><N><N>SLAK:<N>(Con naturalidad)<N>    <LQ>Olvida eso último que he dicho.<RQ>
$ENTRY_JOURNAL2_MEET_BERSERKER_LEFT_2_00	AZRA:<N>(Irritada)<N>    <LQ>Mira, aunque agradezca tu representación teatral, no tengo ni la más mínima idea de lo que está pasando, así que si me disculpas-<RQ><N><N>SLAK:<N>(Amigable)<N>    <LQ>Bueno, estás de suerte, nena, ¡porque acabas de toparte con el mejor guía turístico de todo el Foso!<RQ><N><N>AZRA:<N>(Irritada)<N>    <LQ>¿Guía turístico?<RQ><N><N>SLAK:<N>(Amigable)<N>    <LQ>Escucha, por aquí hay todo tipo de peligros para una neófita como tú. Zombis, capos mafiosos, bandidos... no sobrevivirías ni cinco segundos por tu cuenta. Pero por el módico precio de nada, o sea, gratis, te enseñaré los entresijos de la supervivencia en este vertedero dejado de la mano de Dios.<RQ>
$ENTRY_JOURNAL2_MEET_BERSERKER_RIGHT_2_00	AZRA:<N>(Desconcertada)<N>    <LQ>¿Gratis?<RQ><N><N>SLAK:<N>(Amigable)<N>    <LQ>Pues claro. Solo por la bondad de mi increíblemente sexy y musculado corazón, sin ninguna intención en absoluto de utilizar tus fantásticos poderes para acumular riqueza personal.<RQ><N><N>SLAK:<N>(Declamando)<N>    <LQ>Primera parada, ¡el Gran Tesoro Escondido de Ozimal Kaz!<RQ>
$ENTRY_JOURNAL2_NAMES_LANG_TITLE	 
$ENTRY_JOURNAL2_NAMES_LANG_LEFT_00	Nombres e idiomas
$ENTRY_JOURNAL2_NAMES_LANG_LEFT_10	Hay mucha gente que comenta los extraños e inusuales nombres que el juego genera para las unidades genéricas cuando el jugador recluta en las ciudades. Estos nombres formaban parte de un esfuerzo por resaltar las diferencias entre las tres culturas principales: Ash, Quaid y Nomadia.<N>Se puede apreciar que ciertos nombres vienen dados por ciertas características físicas. Esto es porque el juego tiene una lista de características físicas para cada civilización y una lista de nombres específicos de esta cultura; cuando el jugador clica para reclutar un personaje, el juego escoge primero una de los tres orígenes culturales del recluta de manera aleatoria y después elige un nombre aleatorio y las características físicas a partir de las listas de esa cultura. Para los dos o tres que estéis interesados en este tipo de cosas, aquí podéis ver nuestra guía denominativa:
$ENTRY_JOURNAL2_NAMES_LANG_LEFT_20	Esta es nuestra lista de nombres para los personajes genéricos. Los nombres están divididos según las culturas. Se puede añadir cualquiera que se os ocurra. Las reglas generales para los nombres son las siguientes:
$ENTRY_JOURNAL2_NAMES_LANG_RIGHT_0_00	Nombres ashianos: muchas Z y V, varias consonantes sonoras seguidas y un tono generalmente mediterráneo. Los nombres masculinos suelen terminar en -mon/man, -ir o -al; los nombres femeninos tienden a terminar en -a o -i, y a veces en <LQ>-vni<RQ>. Las combinaciones de sonidos comunes incluyen <LQ>vn<RQ> y <LQ>zr<RQ><N>Apariencia ashiana:<N><N>Aceitunado, a veces un color de piel africano<N>Cabello moreno, castaño, a veces rubio oscuro, ocasionalmente pelirrojo<N>Ojos de color marrón, avellana o azul<N><N>    En general, una especie de combinación de características mediterráneas/griegas/germánicas/arábigas. Ash tiene el abanico de apariencias más amplio al tener el mayor número de matrimonios interraciales con los pueblos de los alrededores.<N><N>Nombres nómadas: Nombres de sílabas cortas y fuertes con terminaciones prominentes y consonantes no consecutivas. Los nombres femeninos suelen terminar en -a. La K aparece preeminentemente, al
$ENTRY_JOURNAL2_NAMES_LANG_LEFT_1_00	 igual que ciertos sonidos como <LQ>sk<RQ> y <LQ>st<RQ>, y es el único idioma que utiliza el sonido J.<N><N>Apariencia nómada:<N><N>Piel morena clara<N>Ojos de color verde, azul y avellana<N>Cabello castaño rojizo oscuro y claro, a veces azabache<N><N>    En general, una especie de combinación de características romanís/afganas. Al tener una población reducida que se casa mayoritariamente entre sí, los genes inusuales, como el pelo rojo y los ojos verdes, tiende a aparecer con más frecuencia. Nombres quaidís - muchas W y L. Se usan como inspiración el galés y el hawaiano, pero sin enfatizar claramente en uno u otro (principalmente porque buscaba letras que no se usaran muy a menudo en los nombres ashianos, y la L y la W fueron las que escogí). Hay también una pincelada de influencia anglosajona. En el idioma quaidí se usa la letra C en lugar de la K, y a menudo se utiliza la Y como una I palatal. Los nombres femeninos suelen terminar en -a, a menudo en <LQ>-nna<RQ>.
$ENTRY_JOURNAL2_NAMES_LANG_RIGHT_1_00	Apariencia quaidí:<N><N>Piel muy pálida.<N>Cabello muy oscuro o muy claro (negro azabache o rubio platino, poca variedad entre estos extremos). El cabello rubio es poco común entre el pueblo llano, pero está más presente en la familia imperial.<N>Ojos de color negro (marrón muy oscuro), marrón oscuro y grises.<N><N>    En general, una especie de combinación de características galesas/escandinavas/orientales.<N><N>Nombres ashianos:<N>Zir<N>Kered<N>Kolos<N>Teluman<N>Gozal<N>Gozra (de mujer)<N>Sivnah (de mujer)<N>Zamena (de mujer)<N>Hektamon<N>Devdi (de mujer)
$ENTRY_JOURNAL2_NAMES_LANG_LEFT_2_00	Tavida (de mujer)<N>Yoavna (de mujer)<N>Kesmir<N>Vasmon<N>Zenimon<N>Kastal<N>Kavni (de mujer)<N>Bazan<N>Evni (de mujer)<N>Rostal<N>Kezal<N>Tezra (de mujer)<N>Zinak<N>Restavni (de mujer)<N>Sedemon<N>Zerevna (de mujer)<N>Ezran<N>Tanos<N>Yevkani (de mujer)<N>Keznimon<N>Ayimi (de mujer)<N>Admon<N>Azakal<N>Bakaza
$ENTRY_JOURNAL2_NAMES_LANG_RIGHT_2_00	Kevnimi (de mujer)<N><N>Nombres nómadas:<N><N>Senna (de mujer)<N>Koat<N>Kem<N>Raska (de mujer)<N>Saja (de mujer)<N>Tulk<N>Rendt<N>Senga (de mujer)<N>Jast<N>Pak<N>Tanna (de mujer)<N>Dank<N>Serk<N>Drask<N>Sotta (de mujer)<N>Leska (de mujer)<N>Joata (de mujer)<N>Saj<N>Het<N>Tetch
$ENTRY_JOURNAL2_NAMES_LANG_LEFT_3_00	Nesk<N>Dysta (de mujer)<N>Skod<N>Senji (de mujer)<N>Klest<N>Zekka (de mujer)<N>Kask<N>Droat<N>Jek<N>Jekka (de mujer)<N>Kaji (de mujer)<N>Plosk<N>Skent<N>Foska (de mujer)<N>Fytt<N>Zesk<N>Sajesh<N><N><N>Nombres quaidís:<N><N>Lawan<N>Sawul<N>Wassa
$ENTRY_JOURNAL2_NAMES_LANG_RIGHT_3_00	Aluwo<N>Sanna (de mujer)<N>Wocolan<N>Celu<N>Laclanna (de mujer)<N>Walucella (de mujer)<N>Xeowan<N>Xeowanna (de mujer)<N>Wastan<N>Luwella (de mujer)<N>Lumenna (de mujer)<N>Stawan<N>Wacali (de mujer)<N>Neorxennawanga (de mujer)<N>Centawal<N>Solowan<N>Cyleth<N>Wulacal<N>Cedmal<N>Lanna (de mujer)<N>Hylla (de mujer)<N>Hywada (de mujer)<N>Walacanna (de mujer)<N>Cullad
$ENTRY_JOURNAL2_NAMES_LANG_LEFT_4_00	Cuwain<N>Cella (de mujer)<N>Celuwanna (de mujer)<N>Celuwon<N>Cylehal<N>Awan<N>Alenna (de mujer)<N>Awucella (de mujer)<N>Awucan<N>Iowan<N>Ittella (de mujer)<N>Walla<N>Lacan
$ENTRY_JOURNAL2_NAMINGEVIL_TITLE	 
$ENTRY_JOURNAL2_NAMINGEVIL_LEFT_00	Poniéndole un nombre al mal
$ENTRY_JOURNAL2_NAMINGEVIL_LEFT_10	Cuando tuvimos que ponerle un nombre al malo malísimo, quise encontrar una convención de nomenclatura que le hiciera parecer verdaderamente ajeno al resto de nuestros personajes y territorios. El problema era que ya teníamos tres civilizaciones principales y se intentó que fueran muy distintas entre sí.<N><N>Terminé decidiéndome por nombres náhuatl (aztecas), dado que el idioma se alejaba bastante de otros idiomas del mundo real que estábamos usando como inspiración (griego y árabe para los ashianos, galés, hawaiano y anglosajón para los quaidís, y una imitación de finlandés y afgano para los nómadas).<N><N>Echando la vista atrás, la mezcla de nombres del mundo real, como Azra y Zelemir, con jerigonzas completamente inventadas, como Ketta y Bakal, es un poco extraña (aunque supongo que hace honor a nuestras raíces de JRPG). <N>También significa que toda nuestra historia podría resumirse, como dice Lars, en <LQ>una escena de persecución continua con un dios azteca enterrado al final<RQ>.
$ENTRY_JOURNAL2_NAMINGEVIL_RIGHT_0_00	 
$ENTRY_JOURNAL2_NAMINGEVIL_LEFT_1_00	 
$ENTRY_JOURNAL2_NAMINGEVIL_RIGHT_1_00	 
$ENTRY_JOURNAL2_NOMADSPIRIT_TITLE	 
$ENTRY_JOURNAL2_NOMADSPIRIT_LEFT_00	Espiritismo nómada
$ENTRY_JOURNAL2_NOMADSPIRIT_LEFT_10	En un principio, los nómadas practicaban un politeísmo tribal. Cada tribu tiene sus propios dioses (y entre muchas tribus, cada familia individual tiene un subconjunto de semidioses menores familiares) representados mediante ídolos. Estos dioses existen para servir a los intereses de la tribu, pero también deben ser honrados y servidos como agradecimiento. Las disputas internas y las enemistades son muy comunes entre las diferentes tribus, dado que los nómadas en constante movimiento a menudo invaden los territorios de otros, y no le hacen ascos al cuatrerismo o al pillaje. Los dioses tribales sirven como estandartes en estas luchas. Que una tribu pierda sus ídolos es la mayor desgracia, y (a menos que la tribu pueda recuperar los ídolos en otra contienda) generalmente significa el fin de la existencia de esa tribu. Una tribu sin sus dioses se considera de baja calaña, y se le excluye del comercio y de otras actividades sociales. Cada nómada recibe además un ídolo personal cuando nace, y se cree que actúa como un sirviente de los dioses de la tribu. Estos espíritus sirvientes se entregan como guías y guardianes del individuo a lo largo de su vida. Cuando un nómada muere, el ídolo personal se entierra con su poseedor para garantizarle un viaje
$ENTRY_JOURNAL2_NOMADSPIRIT_RIGHT_0_00	seguro hasta el paraíso. Perder un ídolo personal es un suceso catastrófico para un nómada. Sin un espíritu guardián que le guíe, el fantasma del nómada está condenado a pasar siglos buscando el camino al paraíso.<N>    La exposición prolongada al Reino de Ash mediante el comercio y otras actividades ha llevado a muchas tribus a aprender las enseñanzas del Templo de Ash. Solo unos pocos han estado dispuestos a abandonar sus tradiciones y unirse por completo al Templo de Ash. La mayoría intenta conciliar la deidad de Ash con la suya propia. Este batiburrillo de fe ha despertado mucha hostilidad religiosa en el Templo de Ash, que se suma a los prejuicios ya existentes contra los nómadas en el Reino de Ash.
$ENTRY_JOURNAL2_NOMADSPIRIT_LEFT_1_00	 
$ENTRY_JOURNAL2_NOMADSPIRIT_RIGHT_1_00	 
$ENTRY_JOURNAL2_SCARS_TITLE	 
$ENTRY_JOURNAL2_SCARS_LEFT_00	Cicatrices
$ENTRY_JOURNAL2_SCARS_LEFT_10	En la historia no ahondamos mucho en este tema, pero las cicatrices del rostro de Wrenna se remontan a cuando fue capturada durante la guerra entre Ash y Quaid. Asustada por la idea de revelar secretos si la torturaban, intentó cortarse su propia lengua para evitar traicionar a su país. En un primer momento, estas cicatrices eran mucho más evidentes, pero decidimos suavizarlas porque se acabó pareciendo demasiado al Joker.<N><N>Aunque Wrenna es el único personaje con una historia específica asociada a sus cicatrices, intentamos hacer que la mayoría de los supervivientes del Foso tuvieran algún tipo de cicatriz visible. Esto no solo ayudó a reforzar la idea de que el Foso era un lugar peligroso y repleto de violencia, sino que también sirvió para distinguir a Azra como <LQ>carne fresca<RQ>. Al ser una incorporación relativamente nueva en el Foso, Azra no ha tenido tiempo de acumular todas esas cicatrices de batalla que tienen los demás.
$ENTRY_JOURNAL2_SCARS_RIGHT_0_00	 
$ENTRY_JOURNAL2_SCARS_LEFT_1_00	 
$ENTRY_JOURNAL2_SCARS_RIGHT_1_00	 
$ENTRY_JOURNAL2_SLAKLIBRARIAN_TITLE	 
$ENTRY_JOURNAL2_SLAKLIBRARIAN_LEFT_00	Slak el Bibliotecario
$ENTRY_JOURNAL2_SLAKLIBRARIAN_LEFT_10	¿Sabías que en un principio el bibliotecario del grupo iba a ser Slak y no Azra?<N><N>De la biografía original de Slak:
$ENTRY_JOURNAL2_SLAKLIBRARIAN_LEFT_20	Ocupación: Antes de ser encarcelado fue bibliotecario, descendiente de una gran familia de bibliotecarios de la capital.  Ahora es un aventurero y mercenario profesional de las múltiples facciones del Foso.<N><N>Educación: Muy ilustrado, sus materias favoritas son la historia y la literatura épica.  Odia las ciencias aplicadas, como las matemáticas.<N>
$ENTRY_JOURNAL2_SLAKLIBRARIAN_LEFT_30	Finalmente, este origen se aplicó a Azra, que se convirtió en la bibliotecaria ligeramente neurótica que mejor empuña un cucharón que todos conocemos y adoramos. Slak se convirtió en... algo completamente distinto.
$ENTRY_JOURNAL2_SLAKLIBRARIAN_RIGHT_0_00	 
$ENTRY_JOURNAL2_SLAKLIBRARIAN_LEFT_1_00	 
$ENTRY_JOURNAL2_SLAKLIBRARIAN_RIGHT_1_00	 
$ENTRY_JOURNAL2_STORYINSPIRE_TITLE	 
$ENTRY_JOURNAL2_STORYINSPIRE_LEFT_00	Inspiraciones para la historia
$ENTRY_JOURNAL2_STORYINSPIRE_LEFT_10	Un compañero filólogo me preguntó una vez que cuáles eran las inspiraciones literarias de la historia de Valley of the Forgotten. Para los otros dos que estáis interesados en estas cosas, aquí tenéis las tres cosas principales que tenía en mente mientras escribía:<N><N>El concepto de la colonia infectada procede en realidad de una de las historias cortas de Rudyard Kipling, The Strange Ride of Morrowbie Jukes. Lo leí cuando tenía 11 o 12 años. La idea de una prisión creada de forma natural llena de gente que había <LQ>muerto<RQ>, pero que se había recuperado, la tenía grabada desde siempre. Existe esta fuerte sensación de sociedad infecta que inspiró algunos detalles del Foso. (Por ejemplo, el hecho de que no haya caballos. Una de las primeras cosas que le ocurren a Morrowbie es que matan y se comen a su caballo, aunque le dan una parte de la carne, así que no todo es malo).<N><N>Además de esto, hay mucho trasfondo cultural que procede de registros históricos bizantinos. Gran parte de la cultura Selini está basada en los escritos de los Padres del desierto y del cristianismo oriental primigenio.
$ENTRY_JOURNAL2_STORYINSPIRE_RIGHT_0_00	Y para completar mi historia de sabelotodismo, diría que la literatura anglosajona fue una GRAN inspiración. Acababa de terminar un curso de inglés antiguo cuando empecé a trabajar en Defender's Quest, y el idioma y la cultura fueron una tremenda inspiración para casi todo. El tono tan pensativo y elegíaco parecía perfecto para nuestra ambientación medieval posapocalíptica. Recomiendo encarecidamente echarle un vistazo a The Ruin si estáis interesados en ese tipo de cosas; es corto y realmente recoge esa especie de sensación memento mori de la literatura anglosajona.<N><N>Está claro que además de todo esto hay muchas cosas más, pero estas tres fueron probablemente la influencia más importante para la ambientación. Bueno, eso y una dosis considerable de mis escritores de humor favoritos.
$ENTRY_JOURNAL2_STORYINSPIRE_LEFT_1_00	 
$ENTRY_JOURNAL2_STORYINSPIRE_RIGHT_1_00	 
$ENTRY_JOURNAL2_WOCOLAN_TITLE	 
$ENTRY_JOURNAL2_WOCOLAN_LEFT_00	Fuerza de Wocolan
$ENTRY_JOURNAL2_WOCOLAN_LEFT_10	La descripción de <LQ>Wocolan aplastando una cabeza de oso con sus propias manos<RQ> que adorna esta armadura pesada fue un intento de aludir a una mitología quaidí más extensa. <LQ>Más abajo, sus vástagos Wastan y Wacella beben la sangre que emana de la boca del oso para sobrevivir a la extenuante marcha al exilio de su familia.<RQ> Nunca profundizamos en ello, pero la historia de Wocolan y sus hijos es parte de la creación de la religión de Quaid y de la fundación del Imperio. Durante el trascurso del exilio, Wocolan sería escogido por la Llama Cósmica y se le concedería la fuerza, no solo para sobrevivir a esa dura prueba, sino para convertirse en el patriarca fundador de todos los quaidís.<N>Intenté hacerlo especialmente raro, para captar legítimamente esa sensación mitológica del mundo antiguo. Si alguna vez queréis que algo parezca una auténtica <LQ>religión antigua<RQ>, solo tenéis que hacer que alguien se coma algo ligeramente inquietante. (O supongo que podríais utilizar el Antiguo Egipto en todo, pero eso habría superado nuestro clasificación autoimpuesta de no recomendado para menores de 12 años).
$ENTRY_JOURNAL2_WOCOLAN_RIGHT_0_00	 
$ENTRY_JOURNAL2_WOCOLAN_LEFT_1_00	 
$ENTRY_JOURNAL2_WOCOLAN_RIGHT_1_00	 
$ENTRY_JOURNAL2_BLOODMAD_TITLE	 
$ENTRY_JOURNAL2_BLOODMAD_LEFT_00	Las tribus de los Dementes de Sangre
$ENTRY_JOURNAL2_BLOODMAD_LEFT_10	<N>Los nómadas en realidad son los descendientes dispersos de una antigua civilización que una vez fue parte de los dominios de Eztli-Tenoch.  Cuando Eztli-Tenoch fue derrotado, la mayoría se dispersó, y se convirtieron en los sujetos tribales, nómadas y politeístas que hoy conocemos.  Pero algunos de ellos permanecieron fieles a su <LQ>dios<RQ> derrotado. Bajo el liderazgo de su Reina misteriosa se convirtieron en una secta chamanista obsesionada con la muerte dedicada a liberar a Eztli-Tenoch de su prisión.  Estas tribus circundaron las zonas que rodeaban la prisión de Eztli y se consagraron a romper el sello de sangre de la única forma que sabían: matando a cualquiera que se les pusiera por delante y pintando el Gran Monolito con su sangre, esperando que algún día pudieran echarle el guante a la persona correcta.  La gente aprendió rápidamente a evitar estas áreas, así que lo sectarios de la sangre se expandieron y llegaron hasta el territorio del Imperio Quaid.  Como es natural, que maten a todos los ciudadanos en los caminos para un ritual no es un buen negocio, y por supuesto, no era adecuado para la gloria de la Llama
$ENTRY_JOURNAL2_BLOODMAD_RIGHT_0_00	Cósmica, así que el Imperio Quaid libró varias guerras para erradicar las sectas (son las guerras a las que Wrenna se refiere). Las sectas están dispersas, pero aún representan una amenaza.  Tras la desaparición de su reina hace siglos, las sectas empezaron a perder gran parte de la motivación de sus acciones para un ritual tan complicado. La mayoría de los sectarios de sangre ya no se concentran alrededor del Gran Monolito; en su lugar, adoran y hacen sacrificios en réplicas más pequeñas.  Sin embargo, una vez que Eztli Tenoch ha sido liberado en cierto modo de su prisión, ha localizado a sus vástagos tiempo ha perdidos.  Los chamanes de las sectas de sangre han escuchado su llamada y todos están guiando a su gente de vuelta al Foso, hasta el Gran Monolito, la prisión de su dios.<N><N>Los sectarios llevan una dieta tóxica (los mismos venenos que Zelemir utilizó con Ozimal) y les invade una obsesión delirante que les hace creer que el espíritu de su maestro les invade. Esta dieta venenosa les permite transformarse en zombis si lo necesitan. (La mano derecha de Eztli-Tenoch es un chamán, o tal vez un grupo de chamanes, que se sacrifican a sí mismos para convertirse en el repugnante instrumento retorcido de la voluntad de su maestro).
$ENTRY_JOURNAL2_BLOODMAD_LEFT_1_00	La tribu de Ketta, los Geka, fue masacrada por los sectarios de sangre cuando no era más que una adolescente, motivo por el cual tiene algunas afiliaciones tribales y los reconocería.<N><N>Hay que reconocerle a Lars la gran idea de hacer que Zelemir envenenara a Ozimal.  Sin eso, las tribus de los Dementes de Sangre nunca se me habrían ocurrido. (En un primer momento, Ozimal iba a convertirse en un zombi después de que Zelemir lo apuñalara brutalmente hasta la muerte en una escena, pero mi baño de sangre tarantinesco se vetó y se sustituyó por un envenenamiento fuera de cámara. Por cierto, también se suponía que el tío tuerto de la lanza, que inexplicablemente ha reunido un pequeño club de fans, iba a morir en esta pelea).<N>
$ENTRY_JOURNAL2_BLOODMAD_RIGHT_1_00	 
$ENTRY_JOURNAL2_CITYSTATES_TITLE	 
$ENTRY_JOURNAL2_CITYSTATES_LEFT_00	Las ciudades estado del norte
$ENTRY_JOURNAL2_CITYSTATES_LEFT_10	Mientras escribía todo este contenido ampliado de la historia para la actualización HD, me encontré un viejo cuaderno. Al parecer, en algún momento decidí que las ciudades estado del norte a las que se alude en el juego ocasionalmente se iban a llamar Las Carcásicas. Me pareció que sonaba muy guay, así que retomé el juego y empecé a utilizarlo en distintas partes. Emocionado por la idea de que este cuaderno ajado fuera una especia de portal mágico hacia el país en el que nunca queda trabajo por hacer, seguí leyendo. Al parecer, la Maga Gélida es un tío que se llama Laz que hace relojes. Además, la última página es una lista de cosas <LQ>pendientes<RQ> que dice así:<N>1. Limpiar el garaje<N>2. Llamar al fontanero por lo del grifo que gotea<N>3. Ganar la lotería, casarme con una supermodelo/princesa finlandesa, mudarme a una isla del Caribe, construir un castillo y tener 2 hijos y medio.<N><N>Por si tenías alguna duda, el garaje sigue lleno de chismes.
$ENTRY_JOURNAL2_CITYSTATES_RIGHT_0_00	 
$ENTRY_JOURNAL2_CITYSTATES_LEFT_1_00	 
$ENTRY_JOURNAL2_CITYSTATES_RIGHT_1_00	 
$ENTRY_JOURNAL2_FIRECULT_TITLE	 
$ENTRY_JOURNAL2_FIRECULT_LEFT_00	El Credo del Fuego Imperial de Quaid
$ENTRY_JOURNAL2_FIRECULT_LEFT_10	<N>El Imperio Quaid es una de las culturas más antiguas del mundo. Su religión también es antigua, aunque ha ido inspirándose paulatinamente en aspectos de religiones cercanas durante el paso de los años. En resumidas cuentas, el Credo Imperial es una religión monoteísta bastante sofisticada fundamentada en la adoración del fuego. A la familia imperial se la considera como los hijos de la Llama Cósmica. Si traen gloria al Imperio Quaid, los hijos se ganan el derecho de reunirse con sus progenitores en el más allá. Los nombres de los miembros de la familia imperial que han traído gloria al Imperio de una u otra manera se graban en un gran muro de piedra en el complejo del palacio imperial; esto funciona como una especie de pasaporte ceremonial y rubrica que tienen derecho a continuar hasta el más allá. Los que fracasan a la hora de glorificar al Imperio durante su vida son eliminados de todos los registros históricos. Además, su cuerpo se entierra, no se incinera. Esto supone una deshonra inmensa, ya que la cremación es la única forma de unirse a la Llama Cósmica.
$ENTRY_JOURNAL2_FIRECULT_RIGHT_0_00	 Todo esto significa que, aunque la aristocracia disfruta de toda suerte de beneficios que no tienen los plebeyos, también cargan con las expectativas que tienen que cumplir.<N><N>Muchos emperadores han sido derrocados y asesinados por sus súbditos porque se consideraba que estaban ignorando sus obligaciones. La guerra contra Ash fue una gran oportunidad para muchas generaciones de emperadores de <LQ>honrar al Imperio<RQ> con bastante facilidad.
$ENTRY_JOURNAL2_FIRECULT_LEFT_1_00	 
$ENTRY_JOURNAL2_FIRECULT_RIGHT_1_00	 
$ENTRY_JOURNAL2_SELINI_TITLE	 
$ENTRY_JOURNAL2_SELINI_LEFT_00	Los Selini
$ENTRY_JOURNAL2_SELINI_LEFT_10	Las sectas o las escuelas de pensamiento son algo común entre los acólitos del Templo de Ash. Los Selini son una secta monástica del Tempo de Ash que se dedican a emular la vida del fundador de la religión, Selinadt, recuperando el equilibrio del mundo que les rodea. Se lleva a cabo mediante el ascetismo propio y la atención de las necesidades del mundo que les rodea. La mayoría de los monasterios Selini funcionan como hospitales y santuarios en zonas inestables y desequilibradas azotadas por la guerra.
$ENTRY_JOURNAL2_SELINI_RIGHT_0_00	 
$ENTRY_JOURNAL2_SELINI_LEFT_1_00	 
$ENTRY_JOURNAL2_SELINI_RIGHT_1_00	 
$ENTRY_JOURNAL2_ASHTEMPLE_TITLE	 
$ENTRY_JOURNAL2_ASHTEMPLE_LEFT_00	El Templo de Ash
$ENTRY_JOURNAL2_ASHTEMPLE_LEFT_10	El Templo de Ash es una filosofía religiosa monárquica y monoteísta centrada en el equilibrio y la comunidad. El mundo se percibe como una gran máquina que funciona gracias a las acciones del Impulsor Impasible, el creador que hace que todo se ponga en marcha. El rol del individuo es atender su finalidad como parte de la gran máquina, respetando el equilibrio del mundo que le rodea. El mal se percibe como el desequilibrio o la incapacidad de lograr esta armonía. (La estructura social dicta los preceptos: se hace especial hincapié en la cadena de mando o en la escala natural de los seres). El centro de la religión es el Gran Templo físico, que antaño sirvió como escuela de la filosofía original. El agua es un elemento fundamental en los rituales del Templo. El ciclo hidrológico es un ejemplo de un elemento en equilibrio con su propósito en la gran máquina. Tras la muerte, el Impulsor Impasible se encarga de acoger a aquellos que han cumplido su propósito dentro de la Máquina Terrenal y los hace parte de la Máquina Celestial, la versión perfeccionada de la tierra.<N>El Templo de Ash fue fundado por Selinadt, un filósofo exiliado de una de las distantes ciudades
$ENTRY_JOURNAL2_ASHTEMPLE_RIGHT_0_00	estado independientes del norte. Tras ser desterrado de su patria tras las maquinaciones de sus rivales políticos, Selinadt vagó errante hacia el sur, ofreciendo sus servicios como consejero a varios gobernantes locales. El rey de Ash se hizo con sus servicios después de que venciera a los más sabios en una competición de acertijos. Tras la conversión del rey de Ash, la filosofía religiosa de Selinadt se popularizó a lo largo y ancho de la región.<N><N>Dado que el rey de Ash fue el primer converso, todos sus sucesores se consideran guardianes del Templo. La religión se practica también en los reinos colindantes más pequeños, pero el Gran Templo de Ash es el centro. Por este motivo, Ash siempre es completamente neutral en las guerras que libran sus vecinos. En las pocas ocasiones que uno de sus vecinos les ha amenazado, los otros se han unido en contra para defender el Templo. Esta neutralidad ha permitido que Ash crezca como un robusto centro de comercio, incrementando así en gran medida su poder e influencia. A raíz de la amenaza del Imperio Quaid, los reinos próximos más pequeños se han unido como una federación de facto, lo que convierte a Ash en un imperio de tamaño considerable, aunque separado.
$ENTRY_JOURNAL2_ASHTEMPLE_LEFT_1_00	 
$ENTRY_JOURNAL2_ASHTEMPLE_RIGHT_1_00	 
$ENTRY_JOURNAL2_WARRIORMONK_TITLE	 
$ENTRY_JOURNAL2_WARRIORMONK_LEFT_00	La Novena Escisión de Selini, División de los Militantes, Defensores de la Verdad y el Orden
$ENTRY_JOURNAL2_WARRIORMONK_LEFT_10	Una de las inspiraciones principales para la religión de Ash, y especialmente para los Selini, como Bakal, fue el cristianismo oriental. Cuando estaba escribiendo me preocupaba bastante que la inspiración fuera demasiado obvia. Quería evitar a toda costa cortar y pegar indiscriminadamente una religión del mundo real en un universo de fantasía, en lugar de crear una religión de fantasía que pareciese una parte orgánica de ese mundo.<N>Empecé a buscar partes en las que la filosofía de Ash se desviara de mis inspiraciones, cómo habrían evolucionado los valores de forma única en este entorno, etc. Una de las cosas de las que detecté inmediatamente fue el pacifismo. El cristianismo oriental, a pesar de permitir un mínimo nivel de violencia necesaria, cuenta con un contexto verdaderamente pacifista. El clero no tiene permitido el asesinato por ninguna razón, ni siquiera en defensa propia. (La defensa propia tampoco está bien vista entre la población seglar). Los sacerdotes deben ser capaces de oficiar un
$ENTRY_JOURNAL2_WARRIORMONK_RIGHT_0_00	<LQ>sacrificio sin sangre<RQ> cuando se encargan de la liturgia, el centro de la vida eclesial. (De hecho, si un clérigo está involucrado en una muerte accidental, por ejemplo, un accidente de coche mortal, no puede volver a servir nunca más).<N> Esto parece un elemento que no funcionaría necesariamente con la filosofía Selini que había creado hasta ahora. Sería completamente concebible, si tenemos en cuenta la importancia del orden en la religión de Ash, que la violencia pudiera llegar a verse, en momentos de absoluta necesidad, como un deber sagrado. En ocasiones hay que sacar una parte rota antes de que dañe el resto de la máquina. ¿Quién mejor que un guerrero Selini para llevar a cabo esta tarea? Aunque los Selini solo contemplarían la violencia como último recurso, no estaría prohibido que el clero o los monjes fueran quien la administrasen, ya que la religión que creé no tenía nada de <LQ>sacrificio sin sangre<RQ> como dogma tal y como tiene el cristianismo oriental.<N><N>Y así es como llegamos a los monjes guerreros, que nunca llegan a aparecer en el juego, pero, oye, están en la historia. (Hay muchos capitolios de Selini, y solo algunos son de la <LQ>División de los Militantes<RQ>. Bakal pertenece a un capitolio mucho más pacífico). Una vez que teníamos
$ENTRY_JOURNAL2_WARRIORMONK_LEFT_1_00	 a los monjes guerreros, un sistema de castas que gobernaba el orden social, una sensación muy deísta gracias al Impulsor Impasible, los rituales hidrológicos, etc., empecé a confiar en que el Templo de Ash estaba adquiriendo identidad propia, en lugar de ser un refrito de religiones del mundo real.
$ENTRY_JOURNAL2_WARRIORMONK_RIGHT_1_00	 
$ENTRY_JOURNAL2_ZELEMIR_NAME_TITLE	 
$ENTRY_JOURNAL2_ZELEMIR_NAME_LEFT_00	El nombre de Zelemir
$ENTRY_JOURNAL2_ZELEMIR_NAME_LEFT_10	Escogí este nombre por dos motivos: 1) empieza por Z, así que es genial, y 2) significa <LQ>deseo de paz<RQ> en eslavo antiguo. Es interesante que la palabra para <LQ>paz<RQ> (<LQ>mir<RQ>) también sea la palabra para <LQ>mundo<RQ>. Una interpretación alternativa de su nombre sería <LQ>Deseo por el mundo<RQ>. Pensé que sería una dicotomía interesante que realmente encajaba con nuestro ambivalente villano.
$ENTRY_JOURNAL2_ZELEMIR_NAME_RIGHT_0_00	 
$ENTRY_JOURNAL2_ZELEMIR_NAME_LEFT_1_00	 
$ENTRY_JOURNAL2_ZELEMIR_NAME_RIGHT_1_00	 
$ENTRY_JOURNAL2_OUTRO_TITLE	 
$ENTRY_JOURNAL2_OUTRO_LEFT_00	Fin
$ENTRY_JOURNAL2_OUTRO_LEFT_10	¿Qué pasa, se ha acabado el diario entre bambalinas?<N><N>¡Vaya, ha sido un viaje alucinante! ¡Hemos reído, llorado, trascendido a planos superiores de existencia y atisbado verdades ignotas! Siento que hemos conectado. Es como si fuerais mis hermanos, salvo por lo de robarme los juguetes y lo de llenarme la cama con chinchetas, la cama que tenía sábanas de franela casi del mismo color que las chinchetas, y que mi madre no me dejaba poner en la lavadora porque pensaba que las chinchetas iban a romperla, así que me pasé todo el invierno durmiendo con ropa de cama sucia y plagada de chinchetas... Vlad, hermanito.<N><N>Bueno, ¡menuda aventura! Espero que hayáis disfrutado de este repaso al alocado y aterrador proceso de creación que acabó convirtiéndose en Defender's Quest: Valley of the Forgotten (excepto lo de llorar por las noches hasta quedarme dormido mientras bebía enjuague bucal y veía la teletienda en el canal por cable robado de los vecinos).<N>
$ENTRY_JOURNAL2_OUTRO_RIGHT_0_00	¡Os veré a todos de nuevo en Defender's Quest 2!<N><N>¿Cómo, eso existe?<N><N>¡Pues claro que sí! ¡Y va a ser brutal!<N><N>¡Deberías comprarlo ahora mismo!<N><N>P. D.: Te perdiste una fiesta de cumpleaños de la leche, Hugh. Uno de los invitados trajo enjuague bucal y fue un desmadre.<N><N>Segunda P. D.: Por si os lo estabais preguntando, la frase "canal por cable robado de los vecinos" significa que los vecinos han pinchado el cable, no que yo se lo haya robado a ellos. Tengo principios. Yo simplemente veo su televisión a través de la ventana trasera con unos prismáticos.
$ENTRY_JOURNAL2_OUTRO_LEFT_1_00	 
$ENTRY_JOURNAL2_OUTRO_RIGHT_1_00	 
$ENTRY_JOURNAL_END	FIN
