flag	name
$CLASS_MCGUFFIN	图书管理员
$CLASS_MCGUFFIN_PL	图书管理员
$CLASS_KNIGHT	骑士
$CLASS_KNIGHT_PL	其实
$CLASS_RANGER	游侠
$CLASS_RANGER_PL	游侠
$CLASS_BERSERKER	狂战士
$CLASS_BERSERKER_PL	狂战士
$CLASS_HEALER	医师
$CLASS_HEALER_PL	医师
$CLASS_MAGE	冰霜法师
$CLASS_MAGE_PL	冰霜法师
$CLASS_DRAGON	巨龙
$CLASS_DRAGON_PL	巨龙
$CLASS_SORCEROR	巫师
$CLASS_SORCEROR_PL	巫师
$CLASS_ANTIMCGUFFIN	女巫
$CLASS_ANTIMCGUFFIN_PL	女巫
$SKILL_MCGUFFIN_A_LIGHTNING	闪电
$SKILL_MCGUFFIN_A_FRENZY	狂暴
$SKILL_MCGUFFIN_A_HEALING	治疗
$SKILL_MCGUFFIN_A_CRYSTAL	水晶
$SKILL_MCGUFFIN_A_PUSHBACK	击退
$SKILL_MCGUFFIN_A_DRAGON_FIRE	龙息
$SKILL_MCGUFFIN_A_DRAGONFIRE	<RE>$SKILL_MCGUFFIN_A_DRAGON_FIRE
$SPELL_ENEMY_ZAP	<RE>$SKILL_MCGUFFIN_A_LIGHTNING
$SPELL_ENEMY_FRENZY	<RE>$SKILL_MCGUFFIN_A_FRENZY
$SPELL_ENEMY_HEAL	<RE>$SKILL_MCGUFFIN_A_HEALING
$SPELL_ENEMY_FIRE	<RE>$SKILL_MCGUFFIN_A_DRAGON_FIRE
$SKILL_MCGUFFIN_A_LIGHTNING_DESC	对单个敌人造成 $X 点伤害。但是会燃烧能源，降低敌人的能源奖励。
$SKILL_MCGUFFIN_A_FRENZY_DESC	所有守护者的攻击速度提高 $X%，持续 $Y 秒。
$SKILL_MCGUFFIN_A_HEALING_DESC	为所有守护者恢复 $X 点生命值。
$SKILL_MCGUFFIN_A_CRYSTAL_DESC	放置水晶，对 $Y 方格范围内的所有敌人造成$X点伤害。在 $Z 秒后，或被闪电击中后爆炸。
$SKILL_MCGUFFIN_A_PUSHBACK_DESC	击退敌人，使之往入口方向后退 $X 方格。
$SKILL_MCGUFFIN_A_DRAGON_FIRE_DESC	对屏幕上的所有敌人造成 $X 伤害，并使之燃烧，持续 $Y 秒。
$SKILL_MCGUFFIN_fake_attackEXPLOSION	爆炸
$SKILL_ANTIMCGUFFIN_A_LIGHTNING	闪电
$SKILL_ANTIMCGUFFIN_A_HEALING	治疗
$SKILL_ANTIMCGUFFIN_A_FRENZY	狂暴
$SKILL_ANTIMCGUFFIN_A_CRYSTAL	水晶
$SKILL_ANTIMCGUFFIN_A_PUSHBACK	击退
$SKILL_ANTIMCGUFFIN_A_DRAGON_FIRE	龙息
$SKILL_ANTIMCGUFFIN_A_LIGHTNING_DESC	对单个敌人造成 $X 点伤害。但是会燃烧能源，降低敌人的能源奖励。
$SKILL_ANTIMCGUFFIN_A_FRENZY_DESC	所有守护者的攻击速度提高 $X%，持续 $Y 秒。
$SKILL_ANTIMCGUFFIN_A_HEALING_DESC	为所有守护者恢复 $X 点生命值。
$SKILL_ANTIMCGUFFIN_A_CRYSTAL_DESC	放置水晶，对 $Y 方格范围内的所有敌人造成$X点伤害。在 $Z 秒后，或被闪电击中后爆炸。
$SKILL_ANTIMCGUFFIN_A_PUSHBACK_DESC	击退敌人，使之往入口方向后退 $X 方格。
$SKILL_ANTIMCGUFFIN_A_DRAGON_FIRE_DESC	对屏幕上的所有敌人造成 $X 伤害，并使之燃烧，持续 $Y 秒。
$SKILL_SORCEROR_A_LIGHTNING-Z	闪电
$SKILL_SORCEROR_A_HEALING-Z	治疗
$SKILL_SORCEROR_A_FRENZY-Z	狂暴
$SKILL_SORCEROR_A_PUSHBACK-Z	击退
$SKILL_SORCEROR_A_DRAGON_FIRE-Z	龙息
$SKILL_SORCEROR_A_LIGHTNING_DESC	对单个敌人造成 $X 点伤害。但是会燃烧能源，降低敌人的能源奖励。
$SKILL_SORCEROR_A_FRENZY-Z_DESC	所有守护者的攻击速度提高 $X%，持续 $Y 秒。
$SKILL_SORCEROR_A_HEALING-Z_DESC	为所有守护者恢复 $X 点生命值。
$SKILL_SORCEROR_A_PUSHBACK-Z_DESC	击退敌人，使之往入口方向后退 $X 方格。
$SKILL_SORCEROR_A_DRAGON_FIRE-Z_DESC	对屏幕上的所有敌人造成 $X 伤害，并使之燃烧，持续 $Y 秒。
$SKILL_KNIGHT_A_SWING	挥舞
$SKILL_KNIGHT_P_ARMOR_PIERCE	护甲穿透
$SKILL_KNIGHT_A_SMASH	粉碎
$SKILL_KNIGHT_P_ARMOR_BREAK	破甲
$SKILL_KNIGHT_P_ARMOR_TRAINING	护甲训练
$SKILL_KNIGHT_P_HARD_KNOCK	重击
$SKILL_KNIGHT_A_COUNTER	反击
$SKILL_KNIGHT_A_LUNGE	刺击
$SKILL_KNIGHT_P_STUN_STAB	眩晕之刺
$SKILL_KNIGHT_P_SWORD_TRAINING	剑术训练
$SKILL_KNIGHT_A_CLEAVE	顺劈
$SKILL_BERSERKER_A_SLASH	挥砍
$SKILL_BERSERKER_A_DOUBLE_HIT	二连击
$SKILL_BERSERKER_P_SWIFTNESS	迅捷
$SKILL_BERSERKER_A_FLURRY	飓风
$SKILL_BERSERKER_P_RESILIENCE	快速回复
$SKILL_BERSERKER_A_SWIPE	猛击
$SKILL_BERSERKER_P_RAGE	狂怒
$SKILL_BERSERKER_P_REFLEXES	反射
$SKILL_BERSERKER_P_MADNESS	疯狂
$SKILL_BERSERKER_A_WHIRLWIND	旋风
$SKILL_HEALER_A_AID	救援
$SKILL_HEALER_A_ETHER_FLASH	以太之光
$SKILL_HEALER_P_BULK_UP	巨大化
$SKILL_HEALER_P_BLINDING	致盲
$SKILL_HEALER_A_GROUP_HEAL	群体治疗
$SKILL_HEALER_A_HOLY_LIGHT	神圣之光
$SKILL_HEALER_A_ZEAL	狂热
$SKILL_HEALER_P_INSPIRE	激励
$SKILL_MAGE_A_ICE_BALL	冰球
$SKILL_MAGE_P_CHILL	寒冷
$SKILL_MAGE_A_ICE_SHARD	冰刺
$SKILL_MAGE_P_FREEZE	冰冻
$SKILL_MAGE_A_SLEET	冰雹
$SKILL_MAGE_P_ICE_SPEAR	冰枪
$SKILL_MAGE_A_ICE_SPLASH	冰霜溅射
$SKILL_MAGE_A_BLIZZARD	暴风雪
$SKILL_DRAGON_A_BITE	撕咬
$SKILL_DRAGON_A_CLAW	爪击
$SKILL_DRAGON_P_EPIC_HALITOSIS	史诗口臭
$SKILL_DRAGON_A_FIRE_BREATH	火焰吐息
$SKILL_DRAGON_P_STRENGTH	力量
$SKILL_DRAGON_A_ROAR	咆哮
$SKILL_DRAGON_P_FATTEN_UP	肥胖
$SKILL_DRAGON_P_NOM	吞咽
$SKILL_DRAGON_A_FIRE_BALL	火球
$SKILL_RANGER_A_BASIC_SHOT	基础设计
$SKILL_RANGER_P_SHARP_SHOOTER	致命射击
$SKILL_RANGER_A_TRIPLE_SHOT	三连矢
$SKILL_RANGER_P_DEEP_SHOT	深度射击
$SKILL_RANGER_A_RAPID_SHOT	急速射击
$SKILL_RANGER_P_RANGE_FOCUS	瞄准范围
$SKILL_RANGER_P_PIERCING_SHOT	穿刺射击
$SKILL_RANGER_P_POISON_SHOT	毒性射击
$SKILL_RANGER_A_SPREAD_SHOT	弹幕射击
$SKILL_RANGER_A_BLACK_OUT_THE_SUN	遮天蔽日
$TYPE_RANGED	范围
$TYPE_MELEE	近战
$TYPE_ULTIMATE	终极
$BLURB_BERSERKER	拥有最快的攻击速度。<N>快速攻击大量敌人，造成中等伤害。<N>对付大量的孱弱敌人有奇效！
$BLURB_RANGER	拥有最远的攻击距离。<N>远远打击敌人，造成少量伤害。<N>对综合性单位有奇效！
$BLURB_KNIGHT	最慢的职业。<N>攻击单个目标，造成大量伤害。<N>可以造成护甲穿透或者破甲。<N>对血量高或护甲高的敌人有奇效！
$BLURB_MAGE	可以使敌人减速或冰冻。<N>攻击速度中等，造成少量伤害。<N>对快速的敌人有奇效！
$BLURB_DRAGON	伤害很高。<N>可以吞噬敌人，并让他们燃烧。<N>非常昂贵，但实力超群。
$BLURB_HEALER	治疗你的盟友。<N>具有一些轻型攻击手段。<N>好好利用，达到最大效果！
$COLOR_EYE	眼睛
$COLOR_SKIN	肤色
$COLOR_HAIR	发色
$COLOR_PANTS	裤子
$COLOR_WEAPON	武器
$COLOR_ARMOR	护甲
$COLOR_DETAIL	细节
$COLOR_TUNIC	外衣
$COLOR_CLOTHES	衣服
$COLOR_CLOAK	斗篷
$COLOR_ROBE	长袍
$COLOR_HIDE	兽皮
$COLOR_OUTLINE	轮廓
$END	结束
