flag	nick_name	flavor_name	flavor_text
$EN_SLUGWORM	快	虫	"敏捷的亡者小怪|这些像虫一般的生物有好几排利齿,敏捷。<N><N>目击者说它们是自腐烂了好几星期，发胀了的亡者之中，爆出来的怪物。"
$EN_NORMAL	正常	亡者	"可以重新活动的尸体|在坑中，很多尸体会在下葬几天后能动起来。<N><N>这些怪物被称为 <LQ>亡者,<RQ> 意思是, <LQ>从那边回来的<RQ>"
$EN_CULTIST_SECT			<LQ>狂血崇拜<RQ> 来自一个有血祭仪式的游牧民族。
$EN_CULTIST_ACCOUNT			相传这是来自革卡族大屠杀的幸存者，很多人见过这些邪教徒可以随意变微亡者。
$EN_CULTIST_BASIC			"<RE>[$EN_CULTIST_SECT_FLAVOR_TEXT]<N><N>很少人知道他们的信仰崇拜的对象， <LQ>艾斯理-特诺奇,<RQ>与他们一直狩猎新鲜的受害者的习惯<N><N><RE>[$EN_CULTIST_ACCOUNT_FLAVOR_TEXT]"
$EN_CULTIST	邪教徒	邪教徒	变形的邪教徒|<RE>[$EN_CULTIST_BASIC_FLAVOR_TEXT]
$EN_ARMORED CULTIST	邪教祭师	邪教祭师	异教祭师|<RE>[$EN_CULTIST_SECT_FLAVOR_TEXT]<N><N>残酷的宗教仪式就是有异教祭师来举行，他们也经常展现出大型的自残行为。<N><N><RE>[$EN_CULTIST_ACCOUNT_FLAVOR_TEXT]
$EN_INSANE CULTIST	发疯的邪教徒	高级祭师	邪教高级祭师|<RE>[$EN_CULTIST_SECT_FLAVOR_TEXT]<N><N>据奎德历史记录，这个宗教是一个母系结构的组织 ，<LQ>众魔之后<RQ> 。近几个世纪，这种中央集权的结构几乎消失，由寥寥数人的高级祭师逐渐控制了整个组织。
$EN_NORMAL_W	<RE>$EN_NORMAL_NICK_NAME	水中恶魔	游泳的亡者|这些亡者浑身都是粘液，让他们可以在水中移动。<N><N>让他们浮起来的是腹中的有毒气体。
$EN_ARMORED	武装	堕落骑士	武装起来的亡者|这些亡者都是在战场上牺牲的骑士。<N><N>虽然他们的理智和能力没有保留下来，但最少还有自己的盔甲。
$EN_SPEEDY	快	虫	"敏捷的亡者小怪|这些像虫一般的生物有好几排利齿,敏捷。<N><N>目击者说它们是自腐烂了好几星期，发胀了的亡者之中，爆出来的怪物。"
$EN_SPEEDY_W	<RE>$EN_SPEEDY_NICK_NAME	蛇	敏捷的游泳小怪| 这些游泳的虫子，来自于浮在水中的亡者。<N><N>也有人说_们是依赖鱼和河蛇的尸体生长。
$EN_ARMORED SPEEDY	<RE>$EN_SPEEDY_NICK_NAME	铁甲虫	敏捷的小怪|这些虫子亡者有一层厚厚的壳。<N><N>很多人认为这种硬壳来自尸体的骨头，经消化后而成。
$EN_ARMORED_SPEEDY_W	<RE>$EN_SPEEDY_NICK_NAME	铁甲蛇	敏捷的游泳武装小怪| 这些游泳的虫子亡者获得了厚厚的硬壳和游泳对能力。<N><N>腐烂骨头的恶臭与其他中人欲呕的臭味实在威力十足！
$EN_ATTACKER	战士	疯狂食尸鬼	好战的亡者|有些亡者就是比其他的更好勇斗狠。<N><N>普通的亡者会盲目地跟踪一个受害者，这些则会袭击进入眼中的所有事物。
$EN_DARK ATTACKER	暗影拳击手	暗黑食尸鬼	暗黑好战的亡者|亡者腹中的腐败气体，透过毛孔渗透出来，这层厚厚的毒气把怪物围绕起来，使受害者看不见它们。
$EN_ATTACKER_W	<RE>$EN_ATTACKER_NICK_NAME	河流食尸鬼	游泳的好战亡者|在坑的周围，不乏发臭尸体袭击打水村民的故事。<N><N>没有人够胆独自去打水，只要疯子才会去游泳。
$EN_ARMORED ATTACKER	<RE>$EN_ATTACKER_NICK_NAME	疯狂骑士	好战的武装亡者|这些堕落骑士都是又恶毒又强壮的。<N><N>它们阴沉的呼喊通过地下墓穴，穿过荒野。
$EN_RAPID_ATTACKER	迅速攻击	 	
$EN_APC	分裂体	怪物	小怪的宿主|这些发胀的尸体艰难地移动，看起来像要随时爆开一样。<N><N>牙齿不断在几张嘴巴中不断长出来， 它们太大了，要狼吞虎咽也难。
$EN_APC_W	<RE>$EN_APC_NICK_NAME	发臭的尸体	游泳的小怪宿主|这些亡者带着死鱼，污水与死亡气息混合恶臭。<N><N>它们浮在水上，看起来随时要爆开一样。
$EN_ARMORED APC	铁甲分裂体	铁甲巨兽	武装的小怪宿主|一团巨大的腐肉被一个巨甲保护着，<N><N>有人怀疑它一根骨头也没有。
$EN_DOUBLE APC	双分裂	憎恶	分裂小怪的宿主| 这个怪物颜色恶心，体型浮肿。<N><N>这代表什么呢？
$EN_RANGED ATTACKER_BASIC			随着日子过去，一些古怪的过程开始腐蚀和扭曲亡者的身体。<N><N>目击者回报受到没有眼睛的<LQ>蛇人<RQ>喷吐胆汁的攻击。
$EN_RANGED ATTACKER	远程	毒蛇食尸鬼	喷射型的亡者|<RE>[$EN_RANGED ATTACKER_BASIC_FLAVOR_TEXT]
$EN_ARMORED RANGED ATTACKER	<RE>$EN_RANGED ATTACKER_NICK_NAME	毒蛇食尸鬼	武装的喷射型的亡者|<RE>[$EN_RANGED ATTACKER_BASIC_FLAVOR_TEXT]
$EN_RANGED ATTACKER_W	<RE>$EN_RANGED ATTACKER_NICK_NAME	河社食尸鬼	游泳的喷射型的亡者|<RE>[$EN_RANGED ATTACKER_BASIC_FLAVOR_TEXT]
$EN_DARK	暗	影之虫	敏捷的暗黑小怪|这些虫子笼罩在厚厚的黑雾中，几乎不可能击中它们。
$EN_BRUTE	粗暴	死亡之虫	强壮的亡者小怪|这些苍白又像虫的怪物移动缓慢，具有坚韧，皮革的皮肤，而不是脆弱的外膜。<N><N>虽然很容易跑赢它，但是它们会用无情与无止休的追赶去捕获猎物。
$EN_ERROR	错误	错误	我是错误。|如果你读到这段文字，代表敌人的资料有问题。如果找不到目标敌人，这个就是你的敌人。
$EN_SHEEP	羊	羊	美味的哺乳类动物|龙可以多年不进食，但_们进食时，吃的量是_们自己体重的好几倍。这是牧羊人和他们的羊群最大的不安。
$EN_SPEEDY SHEEP	敏捷羊	敏捷羊	敏捷又美味的哺乳类动物| 部分羊适应了残酷的环境，发展了结实的腿部肌肉。虽然没有办法跑得比龙快，但最少跑赢其他羊。
$EN_SUPER SHEEP	超级羊	超级羊	传说中美味的哺乳类动物|龙族传说中，一提到这种罕见的羊，阿舍麻维特羊那瑟萨，都带着谦逊和虔诚的语气。为迎接这种羊的降临，神圣的龙族经文中详述了一个复杂的仪式。这经文被传统学者归类为宗教文本，但新的研究重新把它归类为食谱。
$EN_OZIMAL	奥斯蒙	奥斯蒙卡兹	亡者奴隶 l 它曾经是坑中的军阀，但现在不过是舍理米尔的无意识的手下。<N>不过他的长袍依然漂亮。
$EN_TWIN	双生子	双生子	亡者的兄弟| 巴啊啊呀呀嘎嘎恤哈
$EN_RIGHT_INDEX_FINGER	食指	食指	怪物手指|虽然被人从手中砍了下来，不过手指也是有意识活动的。
$EN_RIGHT_THUMB	拇指	拇指	怪物手指|虽然被人从手中砍了下来，不过手指也是有意识活动的。
$EN_RIGHT_MIDDLE_FINGER	中指	中指	怪物手指| 这只被砍下来的手指看起来就在比不文手势。下流！
$EN_RIGHT_RING_FINGER	无名指	无名指	<RE>$EN_RIGHT_INDEX_FINGER_FLAVOR_TEXT
$EN_RIGHT_PINKY_FINGER	尾指	尾指	<RE>$EN_RIGHT_INDEX_FINGER_FLAVOR_TEXT
$EN_RIGHT_EYE	艾斯理之眼	艾斯理之眼	怪物眼睛|这邪恶的眼睛闪耀着黑暗的力量，并快速地移动。
$EN_RIGHT_HAND	艾斯理之手	艾斯理之手	怪物手|邪教领袖称呼这个怪物为 <LQ>艾斯理-特诺奇的右手<RQ>鉴于对艾斯理-特诺奇的了解甚少，实在无法断定是否那恐怖巫师的手，或是仅仅是他黑魔法的一个产物。仔细一看，好像是一只左手。骗子！
$EN_ZELEMIR	舍理米尔	舍理米尔	死灵巫师| 舍理米尔的眼闪耀着坚定的决心。
$EN_EZTLI	艾斯理-特诺奇	艾斯理-特诺奇	上古传奇巫师|一股古老的力量，长年沉睡后，如今终于觉醒了。艾斯理-特诺奇曾统治这个世界，自称神王。他的力量与邪恶比起他坚定不移的耐心，有过则无不及。
$EN_ZELEMIR-CITADEL	<RE>$EN_ZELEMIR_NICK_NAME	<RE>$EN_ZELEMIR_FLAVOR_NAME	<RE>$EN_ZELEMIR_FLAVOR_TEXT
$EN_NORMAL_NOMONEY	<RE>$EN_NORMAL_NICK_NAME	<RE>$EN_NORMAL_FLAVOR_NAME	<RE>$EN_NORMAL_FLAVOR_TEXT
$EN_NORMAL_EXP	<RE>$EN_NORMAL_NICK_NAME	<RE>$EN_NORMAL_FLAVOR_NAME	<RE>$EN_NORMAL_FLAVOR_TEXT
$EN_NORMAL_EXP_PSI	<RE>$EN_NORMAL_NICK_NAME	<RE>$EN_NORMAL_FLAVOR_NAME	<RE>$EN_NORMAL_FLAVOR_TEXT
$EN_NORMAL_LOWXP	<RE>$EN_NORMAL_NICK_NAME	<RE>$EN_NORMAL_FLAVOR_NAME	<RE>$EN_NORMAL_FLAVOR_TEXT
$EN_CULTIST_LOWXP	<RE>$EN_CULTIST_NICK_NAME	<RE>$EN_CULTIST_FLAVOR_NAME	<RE>$EN_CULTIST_FLAVOR_TEXT
$EN_ARMORED CULTIST_LOWXP	<RE>$EN_ARMORED CULTIST_NICK_NAME	<RE>$EN_ARMORED CULTIST_FLAVOR_NAME	<RE>$EN_ARMORED CULTIST_FLAVOR_TEXT
$EN_NORMAL_W_LOWXP	<RE>$EN_NORMAL_NICK_NAME	<RE>$EN_NORMAL_W_FLAVOR_NAME	<RE>$EN_NORMAL_W_FLAVOR_TEXT
$EN_ARMORED_LOWXP	<RE>$EN_ARMORED_NICK_NAME	<RE>$EN_ARMORED_FLAVOR_NAME	<RE>$EN_ARMORED_FLAVOR_TEXT
$EN_SPEEDY_LOWXP	<RE>$EN_SPEEDY_NICK_NAME	<RE>$EN_SPEEDY_FLAVOR_NAME	<RE>$EN_SPEEDY_FLAVOR_TEXT
$EN_SPEEDY_W_LOWXP	<RE>$EN_SPEEDY_NICK_NAME	<RE>$EN_SPEEDY_W_FLAVOR_NAME	<RE>$EN_SPEEDY_W_FLAVOR_TEXT
$EN_ARMORED SPEEDY_LOWXP	<RE>$EN_SPEEDY_NICK_NAME	<RE>$EN_ARMORED SPEEDY_FLAVOR_NAME	<RE>$EN_ARMORED SPEEDY_FLAVOR_TEXT
$EN_ARMORED_SPEEDY_W_LOWXP	<RE>$EN_SPEEDY_NICK_NAME	<RE>$EN_ARMORED_SPEEDY_W_FLAVOR_NAME	<RE>$EN_ARMORED_SPEEDY_W_FLAVOR_TEXT
$EN_ATTACKER_LOWXP	<RE>$EN_ATTACKER_NICK_NAME	<RE>$EN_ATTACKER_FLAVOR_NAME	<RE>$EN_ATTACKER_FLAVOR_TEXT
$EN_DARK ATTACKER_LOWXP	<RE>$EN_DARK ATTACKER_NICK_NAME	<RE>$EN_DARK ATTACKER_FLAVOR_NAME	<RE>$EN_DARK ATTACKER_FLAVOR_TEXT
$EN_ATTACKER_W_LOWXP	<RE>$EN_ATTACKER_NICK_NAME	<RE>$EN_ATTACKER_W_FLAVOR_NAME	<RE>$EN_ATTACKER_W_FLAVOR_TEXT
$EN_ARMORED ATTACKER_LOWXP	<RE>$EN_ATTACKER_NICK_NAME	<RE>$EN_ARMORED ATTACKER_FLAVOR_NAME	<RE>$EN_ARMORED ATTACKER_FLAVOR_TEXT
$EN_RAPID_ATTACKER_LOWXP	<RE>$EN_RAPID_ATTACKER_NICK_NAME	<RE>$EN_RAPID_ATTACKER_FLAVOR_NAME	<RE>$EN_RAPID_ATTACKER_FLAVOR_TEXT
$EN_APC_LOWXP	<RE>$EN_APC_NICK_NAME	<RE>$EN_APC_FLAVOR_NAME	<RE>$EN_APC_FLAVOR_TEXT
$EN_APC_W_LOWXP	<RE>$EN_APC_NICK_NAME	<RE>$EN_APC_W_FLAVOR_NAME	<RE>$EN_APC_W_FLAVOR_TEXT
$EN_ARMORED APC_LOWXP	<RE>$EN_ARMORED APC_NICK_NAME	<RE>$EN_ARMORED APC_FLAVOR_NAME	<RE>$EN_ARMORED APC_FLAVOR_TEXT
$EN_DOUBLE APC_LOWXP	<RE>$EN_DOUBLE APC_NICK_NAME	<RE>$EN_DOUBLE APC_FLAVOR_NAME	<RE>$EN_DOUBLE APC_FLAVOR_TEXT
$EN_ARMORED RANGED ATTACKER_LOWXP	<RE>$EN_RANGED ATTACKER_NICK_NAME	<RE>$EN_ARMORED RANGED ATTACKER_FLAVOR_NAME	<RE>$EN_ARMORED RANGED ATTACKER_FLAVOR_TEXT
$EN_RANGED ATTACKER_LOWXP	<RE>$EN_RANGED ATTACKER_NICK_NAME	<RE>$EN_RANGED ATTACKER_FLAVOR_NAME	<RE>$EN_RANGED ATTACKER_BASIC_FLAVOR_TEXT
$EN_RANGED ATTACKER_W_LOWXP	<RE>$EN_RANGED ATTACKER_NICK_NAME	<RE>$EN_RANGED ATTACKER_W_FLAVOR_NAME	<RE>$EN_RANGED ATTACKER_W_FLAVOR_TEXT
$EN_DARK_LOWXP	<RE>$EN_DARK_NICK_NAME	<RE>$EN_DARK_FLAVOR_NAME	<RE>$EN_DARK_FLAVOR_TEXT
$EN_BRUTE_LOWXP	<RE>$EN_BRUTE_NICK_NAME	<RE>$EN_BRUTE_FLAVOR_NAME	<RE>$EN_BRUTE_FLAVOR_TEXT
$EN_APC_NOATTACK_LOWXP	<RE>$EN_APC_NICK_NAME	<RE>$EN_APC_FLAVOR_NAME	<RE>$EN_APC_FLAVOR_TEXT
$EN_CULTIST_NOATTACK_LOWXP	<RE>$EN_CULTIST_NICK_NAME	<RE>$EN_CULTIST_FLAVOR_NAME	<RE>$EN_CULTIST_FLAVOR_TEXT
$EN_PSI SHEEP	<RE>$EN_SHEEP_NICK_NAME	<RE>$EN_SHEEP_FLAVOR_NAME	<RE>$EN_SHEEP_FLAVOR_TEXT
$EN_3_11_BOSS	BOSS		
$EN_FINGER	艾斯理之指		
$EN_HEALIE	回复	回复	秘密Boss|说明
$EN_MEANIE	狂暴	狂暴	秘密Boss|说明
$EN_STEALY	潜行	潜行	秘密Boss|说明
$EN_CRAZY	疯狂	疯狂	秘密Boss|说明
