flag	Content
$ENTRY_JOURNAL_INDEX_TITLE	目录
$ENTRY_JOURNAL2_INDEX_TITLE	秘密
$ENTRY_JOURNAL_INDEX_LEFT_00	引言
$ENTRY_JOURNAL_INDEX_LEFT_10	第1天: @我在哪?@
$ENTRY_JOURNAL_INDEX_LEFT_20	第1夜: @[berserker_hero]@
$ENTRY_JOURNAL_INDEX_LEFT_30	第3天: @附录@
$ENTRY_JOURNAL_INDEX_LEFT_40	第3夜: @附录@
$ENTRY_JOURNAL_INDEX_LEFT_50	第3天: @监狱@
$ENTRY_JOURNAL_INDEX_LEFT_60	第4天: @中途世界@
$ENTRY_JOURNAL_INDEX_LEFT_61	第4天: @一个教训@
$ENTRY_JOURNAL_INDEX_LEFT_62	第4天: @会计簿记@
$ENTRY_JOURNAL_INDEX_LEFT_70	第5天: @[ranger_hero]@
$ENTRY_JOURNAL_INDEX_LEFT_80	第8天 @附录@
$ENTRY_JOURNAL_INDEX_LEFT_90	第7夜: @卡尔斯克大火@
$ENTRY_JOURNAL_INDEX_LEFT_100	第8天: @勒萨斯@
$ENTRY_JOURNAL_INDEX_LEFT_101	第9天: @旅程@
$ENTRY_JOURNAL_INDEX_LEFT_110	第10天: @[mcguffin_hero]@
$ENTRY_JOURNAL_INDEX_LEFT_120	第10天: @奥斯蒙之死@
$ENTRY_JOURNAL_INDEX_LEFT_130	第10夜: @修道院@
$ENTRY_JOURNAL_INDEX_LEFT_140	第11天: @[healer_hero]@
$ENTRY_JOURNAL_INDEX_LEFT_141	第11天: @卡革斯手稿@
$ENTRY_JOURNAL_INDEX_LEFT_150	第13天: @[mage_hero]@
$ENTRY_JOURNAL_INDEX_LEFT_160	第14天: @诺曼@
$ENTRY_JOURNAL_INDEX_LEFT_170	第15天: @奇怪的梦@
$ENTRY_JOURNAL_INDEX_LEFT_171	第15夜: @奇怪的字@
$ENTRY_JOURNAL_INDEX_RIGHT_01	第16天: @带伤疤的嘴唇吐出可怕的字@
$ENTRY_JOURNAL_INDEX_RIGHT_00	第17天: @沙漠之宝@
$ENTRY_JOURNAL_INDEX_RIGHT_02	第17夜: @狐狸@
$ENTRY_JOURNAL_INDEX_RIGHT_10	第18天: @[knight_hero]@
$ENTRY_JOURNAL_INDEX_RIGHT_20	第19天: @来自[knight_hero]的信@
$ENTRY_JOURNAL_INDEX_RIGHT_30	第19夜: @我的回复: 草稿1@
$ENTRY_JOURNAL_INDEX_RIGHT_40	第20天: @[knight_hero_pos] 回复@
$ENTRY_JOURNAL_INDEX_RIGHT_50	第21天: @来自 <LQ>[knight_hero_up]<RQ>的信@
$ENTRY_JOURNAL_INDEX_RIGHT_60	第21夜: @请转交: [berserker_hero]@
$ENTRY_JOURNAL_INDEX_RIGHT_70	第22夜: @[dragon_hero]@
$ENTRY_JOURNAL_INDEX_RIGHT_71	第23天: @演讲@
$ENTRY_JOURNAL_INDEX_RIGHT_72	第24天: @刺客@
$ENTRY_JOURNAL_INDEX_RIGHT_73	第24天: @超级羊之死@
$ENTRY_JOURNAL_INDEX_RIGHT_80	第24天: @附录@
$ENTRY_JOURNAL_INDEX_RIGHT_81	第25天: @胡言乱语@
$ENTRY_JOURNAL_INDEX_RIGHT_90	第25天: @第二个梦@
$ENTRY_JOURNAL_INDEX_RIGHT_91	第26天: @[mage_hero_pos] 故事@
$ENTRY_JOURNAL_INDEX_RIGHT_92	第27天: @心中的恶魔@
$ENTRY_JOURNAL_INDEX_RIGHT_93	第27天: @[knight_hero_pos] 故事@
$ENTRY_JOURNAL_INDEX_RIGHT_100	第28天: @身穿红衣的人之死@
$ENTRY_JOURNAL_INDEX_RIGHT_110	第29天: @第三个梦@
$ENTRY_JOURNAL_INDEX_RIGHT_117	第30天: @睡梦与疯狂@
$ENTRY_JOURNAL_INDEX_RIGHT_111	第32天: @女皇@
$ENTRY_JOURNAL_INDEX_RIGHT_112	第33天: @黑袍@
$ENTRY_JOURNAL_INDEX_RIGHT_113	第33天: @第四个梦@
$ENTRY_JOURNAL_INDEX_RIGHT_114	第34天: @离我的日记远一点！@
$ENTRY_JOURNAL_INDEX_RIGHT_115	第34天: @第五个梦@
$ENTRY_JOURNAL_INDEX_RIGHT_116	第35天: @第六个梦@
$ENTRY_JOURNAL_INDEX_RIGHT_120	第35天: @以斯理的继承人@
$ENTRY_JOURNAL_INDEX_RIGHT_121	第36天: @依芙丽@
$ENTRY_JOURNAL_INDEX_RIGHT_130	第37天: @泰都-米期理@
$ENTRY_JOURNAL_INDEX_RIGHT_131	第38天: @和平?@
$ENTRY_JOURNAL_INDEX_RIGHT_132	第38天: @分离之梦@
$ENTRY_JOURNAL_INDEX_RIGHT_140	第39天: @选择@
$ENTRY_JOURNAL_INDEX_RIGHT_150	第40天: @跟随舍里米尔@
$ENTRY_JOURNAL_INDEX_RIGHT_160	@结语@
$ENTRY_JOURNAL_INDEX_RIGHT_170	@附录@
$ENTRY_JOURNAL_INTRO_TITLE	
$ENTRY_JOURNAL_INTRO_LEFT_00	第1天 - 我在哪?
$ENTRY_JOURNAL_INTRO_LEFT_10	我可能是疯了但是我无论如何也会尝试记录<N>在我面前发生的事。阅读的人可以随便下结论，<N>但我只会记录我发热脑袋所知道的所见所闻。<N><N>我确实知道我感染了正在我们美丽首都肆虐的瘟疫。<N>我也知道，就像先前的病人一样，我被赶出城，<N>丢到墓坑中去。从那里开始，一连串奇怪又恐怖的<N>事情发生，令我一直不知道是否还在梦中。<N><N>当高热再次袭来，我发现自己身处黑暗中，<N>另一位病人站在我的眼前。
$ENTRY_JOURNAL_INTRO_RIGHT_00	<N><N>在华丽无双的皇座上，一名我从未见过的男子站立在前，<N>他全身散发金光。我本以为他是一座雕像，直到他开口发布命令。<N>他的声音振聋发聩，我无法从世上的语言找到可比拟的，<N>即使是艾殊图书馆也没有记录。我匍匐地上，血液像野马般奔腾。只要回想起来，<N>我的心像要冲破胸口向他奔去一样！<N><N>-[mcguffin_hero] 利佛巴
$ENTRY_JOURNAL_SLAK_TITLE	
$ENTRY_JOURNAL_SLAK_LEFT_0_00	第1夜 - [berserker_hero]
$ENTRY_JOURNAL_SLAK_LEFT_0_10	当我决定写有关[berserker_hero]的事时, 我发现我必须放弃<N>首都文绉绉的语言，改为用更生动的方言<N>来切合这个话题。<N><N>[berserker_hero]是个蠢货！他是一个大笨蛋！<N><N>他的体臭弥补了智慧的部分。想想两堆粪便交配然后生出腐败不堪的孩子，然后他在[berserker_hero]毫无遮掩的<N>腋窝中奔驰出来！<N>所以那些跟踪我们的僵尸与他相比，简直是有高级香水的味道！<N><N>但是 [berserker_hero]可不是空有其表，<N>他的性格可是无人可及的，我只能说他是<LQ>把裤子穿头上的疯子。<RQ><N><N>昨天他与砸到他脚趾的一颗石头争论了15分钟，然后他输了。
$ENTRY_JOURNAL_SLAK_RIGHT_0_00	说真的，有这样的旅伴，夫复何求。
$ENTRY_JOURNAL_SLAK_RIGHT_0_10	第3天 - 附录
$ENTRY_JOURNAL_SLAK_RIGHT_0_20	公平一点来说，我必须承认他是我见过最勇敢的人。<N>他身上的伤疤星罗密布，即使我曾因为他拒绝穿任何衣服和护甲而鄙视过他一下。<N>我觉得底线是这样的，他既是一个无法忍受的小丑，<N>也是一个出色的战士！我非常高兴他是我的队友。
$ENTRY_JOURNAL_SLAK_RIGHT_0_30	啊～～我也爱你啊！麽麽的！<N><N><N><N><N><N><N>我不睡觉的！我不过是躺下来伸展一下我的屁股！
$ENTRY_JOURNAL_SLAK_RIGHT_0_40	噢！看起来这个人能读也能写。<N>到底这天杀的嗜血杀手在哪里接受教育的？！<N><N>P.S. 如果你再尝试偷我的日记，我就会在你睡着时拿石头砸破你的脑袋！
$ENTRY_JOURNAL_SLAK_LEFT_1_00	第3夜- 附录2
$ENTRY_JOURNAL_SLAK_LEFT_1_10	好的，纯属记录， [berserker_hero]是裸睡的。<N>从今天起，所有报复的行动会在白天发生。<N><N>他的疤痕可不止在背上啊！<N><N><N><N><N><N><N><N>我讨厌你！
$ENTRY_JOURNAL_SLAK_LEFT_1_20	<N><N>什么！难道你认为可汗和卡丽斯不会吵架吗？
$ENTRY_JOURNAL_PRISON_TITLE	
$ENTRY_JOURNAL_PRISON_LEFT_0_00	第3天- 监狱
$ENTRY_JOURNAL_PRISON_LEFT_0_10	三天前，我以为这个墓坑是一座监狱，但是我现在发现情况更糟糕了！<N><N>把我们囚禁于此的人名叫奥斯蒙‧卡兹，他是一个冷酷卑鄙的<N>可怜虫！同胞发生如此扭曲的悲剧超越了我的理解范围。<N>我以为只有奎德，这个在过去20年不断折磨东部省份的民族会有这样的德性。<N> 即使是最无情的诺曼族首领，也会比这家伙的懂得<N>控制自己的嗜血欲望。<N><N><LQ>收都<RQ>可怕的口音！<N>这只怪物一直在神庙的阴影中生存！
$ENTRY_JOURNAL_PRISON_RIGHT_0_00	我和其他被囚于此的人一起，无分男女老幼，无分种族职业，都在等候死亡的降临。白天与黑夜都会传来亡者的<N>呻吟声，偶尔会传来一阵震耳欲聋的喧闹声，<N>那是受害者垂死的尖叫。<N><N>现在我在这里，对所有事都无能为力。如果我不过是
$ENTRY_JOURNAL_PRISON_RIGHT_0_10	与这帮不幸的人在斗兽场之中，他们或许有<N>垂死一搏的机会。即使花光所有决心，奥斯蒙似似乎也很犹豫是否要再次 <LQ>处决<RQ>我。<N> 或许他害怕失去更多的亡者吧，它们可不是很容易<N>就抓得到，也不容易保存。他这小小的王国还是需要<N>它们来维持的。
$ENTRY_JOURNAL_PRISON_LEFT_1_00	我神秘的仆人所说的话经常在我的脑海回响。<N>奥斯蒙希望我可以向 一位<LQ>身穿红衣的人<RQ>来展示能力。<N>他是谁呢？那个神秘的陌生人为什么想要救我呢？<N>我到底有什么重要呢？在这些所有问题的折腾中，<N>我领略到一件事：我是唯一用暴力对抗死亡之人。<N>但只要让我可以对上奥斯蒙，这样的规矩可得改！
$ENTRY_JOURNAL_HALFWAY_WORLD_TITLE	
$ENTRY_JOURNAL_HALFWAY_WORLD_LEFT_0_00	第4 天-中途世界
$ENTRY_JOURNAL_HALFWAY_WORLD_LEFT_0_10	<LQ>中途世界<RQ>是我用尽苦思出来的字眼才想出来的，
$ENTRY_JOURNAL_HALFWAY_WORLD_LEFT_0_20	用来描述这个我和其他人身处的世界。<N><N>有一次，当我还是很年轻的时候，我在卡浮的浅水处，差一点淹死。这个是我 唯一一次可与之相比的经历。<N>同样的惊恐，同样的透不过气，心好像要从胸口蹦出来一样。<N>但是这次父亲的手可不是要把我拖向安全之地呢。<N>没有任何可以攀附的地方，只有死亡欲把人拖向死亡。<N><N>我如何来到这里实在超越了我的认知，我只知道<N>当我需要来到时，我就能来到。我可以感受到我的同伴，不是靠眼睛，<N>而是好像感觉到自己四肢一样。 我混身乏力，必须用尽<N>所有的力气来移动他们。这股力量很微小，我就像<N>小婴儿一样笨拙地移动，但这足以救我了。即使<N>我总会抱怨前往中途世界的可怕经历，但这总比<N>现实的命运来得好。
$ENTRY_JOURNAL_HALFWAY_WORLD_RIGHT_0_00	
$ENTRY_JOURNAL_AN_EDUCATION_TITLE	
$ENTRY_JOURNAL_AN_EDUCATION_LEFT_0_00	第4天 - 一个教训
$ENTRY_JOURNAL_AN_EDUCATION_LEFT_0_10	今天，当我的思维还陶醉在上一次的胜利时，<N>我的眼睛不经意的看到了地上的卷轴。渴望补充我那少得可怜的物品，我捡起这东西，<N>我立即诧异于它的质量。它的边缘与皱痕透露了它来到墓坑的旅程，<N>但是它干干净净，手感扎实，<N>奶油色的纸质暴露了它高贵的身份。这可不是管工的发薪草稿纸。<N><N>直到现在我才见到列根大人的印鉴。我的眼睛饥渴地瞄去第一行字：
$ENTRY_JOURNAL_AN_EDUCATION_LEFT_0_20	<LQ>你这成事不足又獐头鼠目的流氓根本就不堪称为我的儿子,<RQ>
$ENTRY_JOURNAL_AN_EDUCATION_LEFT_0_30	内心怀着大智者禅理满所说的<LQ>幸灾乐祸<RQ>，我制止不住我的好奇心，羞愧地读下去：
$ENTRY_JOURNAL_AN_EDUCATION_LEFT_0_40	<LQ>我的愤怒笔墨不足以形容。华殊塔在到到达卡革斯之地时报告给我，他发现你并未在大学就读。
$ENTRY_JOURNAL_AN_EDUCATION_RIGHT_0_00	我曾命令你要好好学习，不要惹事，但他发现在大学中顶着你的名字学习的，<N>是一个脏兮兮诺曼人！<N>那个野蛮人透露他得到了一笔为数不少的钱，来代替你学习，<N>因为你要去，你以为我不知道！旷野里找那该死的-<RQ>
$ENTRY_JOURNAL_AN_EDUCATION_RIGHT_0_10	其他的文字已经不能知道了，当我读得正兴起时，<N> [berserker_hero]从我手中一把抢过那张纸，揉成一团，<N>然后大口吞下，对着我尖叫着 <LQ>它尝起了像谎言和死羊！<N>但大部分都是谎言的味道!<RQ> 他的口气说有多臭就有多臭！
$ENTRY_JOURNAL_AN_EDUCATION_RIGHT_0_20	他接下来又向 [ranger_hero]丢石头, 这两个活宝互相扇巴掌扇了近半个小时。
$ENTRY_JOURNAL_BOOKKEEPING_TITLE	
$ENTRY_JOURNAL_BOOKKEEPING_LEFT_0_00	第5天 -  会计簿记
$ENTRY_JOURNAL_BOOKKEEPING_LEFT_0_10	自从将最后一个被囚的人由奥斯蒙可怜的洞穴中释放出来后，<N>我必须承认我从掠夺那坏蛋的阁楼中获得可耻的快感。<N>他的残部自看见我们打败他们训练出来的亡者大军后，<N>四散逃命，留下这个小暴君的房间任人鱼肉。<N>我们从他的小厨房中大拿特拿，香肠，油和大量的起司，<N>让我们在旅途上有足够的粮食。<N>我原本想放火把余下的东西都烧掉，但我怕浓烟会暴露我们的位置，<N>引来敌人的追击。好像知道我的挫败感一样，[berserker_hero] 用自己的身体去 <LQ>亵渎<RQ>余下的食物。<N>他继续去亵渎那张床，地板还有墙。<N>这可不是我所认可的行为，但是一想到当奥斯蒙回来后<N>被这尿骚味呛到的样子，我的嘴角忍不住翘起了。<N><N>[berserker_hero] 肯定是水做的！
$ENTRY_JOURNAL_BOOKKEEPING_RIGHT_0_00	可悲的是，欢乐的时光特别短暂。在奥斯蒙的书桌上，<N>我发现 (就在 <LQ>亵渎<RQ>事件以前)几卷羊皮卷，记录着他地下王国的开销。<N>看过以后，我见到了实在的数字，被征召的人， 施加的处罚， <N>还有奴隶的数量， 他写这些人命时，<N>好像这些都是排在他的小厨房中的烟熏火腿一样，他就像一个繁忙的商人。.<N><N>有一段记录，吸引了我的目光。
$ENTRY_JOURNAL_BOOKKEEPING_RIGHT_0_10	<LQ>要采购：<N><N>红衣收藏者- 有不寻常外表或能力的幸存者。<N><N>奎德人- 年轻的女人，奎德族，金发，面上有疤，<N>带着瑟连里。最好是死的。要有证明。<N><N>人口贩子- 诺曼少女，外表漂亮。<N>年轻的价钱会高一点。
$ENTRY_JOURNAL_BOOKKEEPING_LEFT_1_00	艾殊人-监狱长的死亡证明。<N><N>大学哲学家- 带肉的，受感染的头骨护身符，<N>保存状况良好，与相关的符文石。<N><N>身穿黑袍的人-阿萨尼的幸存者，最好是新鲜的。<N><N>来自卡革斯的人- 男孩，诺曼族外表，<N>白色头发，如果自带跟他一模一样的人更好。希望是死的。要有证明。<RQ>
$ENTRY_JOURNAL_BOOKKEEPING_LEFT_1_10	为了看见自己的命运，在这个可苦中作乐的时间，<N>坏人名单中的一项，似乎是一个清醒的经历。 我曾以为我的疼苦是一个特例，<N>但现在我发现不过是奥斯蒙恶劣企业的日常运作的一部分。<N><N>我觉得最可悲的是，这些罪恶<N>都是根据坑外各方的要求而进行的。<N>到底这个悲惨的地方可以为外边的世界 带来什么呢?
$ENTRY_JOURNAL_BOOKKEEPING_RIGHT_1_00	当人要搜索地狱来找新魔鬼的时候，<N>这确实是个严峻的时刻。
$ENTRY_JOURNAL_KETTA_TITLE	
$ENTRY_JOURNAL_KETTA_LEFT_0_00	第五天 - [ranger_hero]
$ENTRY_JOURNAL_KETTA_LEFT_0_10	我认为我最喜欢 [ranger_hero]的地方是她闻起来像山羊。<N><N>我指这是一个艰难的决定，在所有的优秀性格相比下，<N>包括猖獗的不成熟，不断贬低的评论，愚蠢的讽刺，<N>小偷的倾向和可怕的饮食习惯，当你要与一个人分享帐篷时，闻起来像山羊比起什么都好。
$ENTRY_JOURNAL_KETTA_LEFT_0_20	有些夜晚，一阵风从男人那边的帐篷吹过来，<N>夹杂着[berserker_hero] 腋下的汗臭味，这些混合的味道可难闻之极。<N>这些夜晚可是我有最好睡眠的夜晚，因为<N>对冲击嗅觉的强烈味道，我的身体是选择失去意识。
$ENTRY_JOURNAL_KETTA_RIGHT_0_00	第8天 - 附录
$ENTRY_JOURNAL_KETTA_RIGHT_0_10	昨晚 [ranger_hero]用诺曼语尖叫着把我吵醒。刚开始时，我以为<N>她梦到我们最近目击的一宗破坏（景像至今还是历历在目）。<N>不过当我用仅有的诺曼语来理解时，发现她的大叫意思是 <N><LQ>不知廉耻的女人，他是我的！<RQ><N>一边大声叫嚷的同时，她一把扯下我的头发，塞进<N>枕头底下，然后再次入睡。<N><N>[ranger_hero] 一直感到不好意思，甚至想叫我绑马尾来掩盖<N>住我头顶秃了的一块。她说不知道梦中发生什么事了，<N>不过我对此表示怀疑。
$ENTRY_JOURNAL_AZRA_BY_SLAK_TITLE	
$ENTRY_JOURNAL_AZRA_BY_SLAK_LEFT_0_00	第10天 - [mcguffin_hero] 是大混蛋！
$ENTRY_JOURNAL_AZRA_BY_SLAK_LEFT_0_10	所以你以为我不会你那些做作的语言，<N>我就不会发现你一直写我吗？<N><N>哼,混蛋！我们也会开始写你的！<N><N>到底我应该如何写 [mcguffin_hero_up]? <N>她的脸扁得像鱼?还有她的脖子太太太长了！<N><N>她的耳朵就像干掉的李子一样！<N>她的头发又傻又乱！她的个人卫生也没有她想的那么好。
$ENTRY_JOURNAL_AZRA_BY_SLAK_RIGHT_0_00	现在怎样了?混蛋! 我现在知道谁才是我真正的朋友！<N><N><N><N>真诚地说，<N><N>[ranger_hero_up] 喜欢吃粑粑！哎！
$ENTRY_JOURNAL_AZRA_BY_SLAK_RIGHT_0_10	[berserker_hero_up]为什么我的名字那么难写？
$ENTRY_JOURNAL_KARSK_BURNED_TITLE	
$ENTRY_JOURNAL_KARSK_BURNED_LEFT_0_00	第7夜- 卡尔斯克大火
$ENTRY_JOURNAL_KARSK_BURNED_LEFT_0_10	我对死亡毫不陌生。在首都肆虐了9个月的瘟疫<N>将我所有对我个人地位的愚昧，都带走了。<N>就算是神庙大闸外那场烧尸体的大火，<N>都无法与之相比。<N><N>我都无语了，<N><N>我大约知道了敌人的本性了。
$ENTRY_JOURNAL_LAKSOS_TITLE	
$ENTRY_JOURNAL_LAKSOS_LEFT_0_00	第8天 - 勒萨斯
$ENTRY_JOURNAL_LAKSOS_LEFT_0_10	我们在勒萨斯的时候见过一个古怪的仪式。一个新生儿<N>被带到卡拉特的酋长面前，卡拉特是<N>目前依然存在的小部落。新生儿的父母<N>把婴儿放在两个木头偶像面前。<N><N>酋长将一块块小木头分别放在木像和婴儿头上，然后他<N>拿出一把小刀来雕塑那块木头，让那些木屑掉落<N>在婴儿的脸上。完成了他的活以后,他把<N>一个动物腱子放在婴儿的脖子上。<N><N>在一声宏亮的哭声后，那些参加者开始唱歌跳舞，<N>用诺曼族露天庆典的方式来庆祝。我从未见到到底他雕刻了什么呢。
$ENTRY_JOURNAL_LAKSOS_RIGHT_0_00	接下来，我问[ranger_hero]这个仪式的意义，然后她把挂在她脖子上的木狐狸给我看。她说她的灵魂是她部落大神的仆人，在<N>她出生时就成为她的守护神，然后在她死亡的时候随她埋葬，<N>保护她可以顺利到达天堂。据部落起源记载，我们的部落大神也是造物主派出的，<N>所以每个人出生时也会接受一个灵魂。<N><N>我问[ranger_hero]如果自己的雕塑不见了的话，会否对个人来了什么可怕的结果，就像部落失去了他们的雕塑一样。<N>她笑一笑后，把她从敌人身上取得的七个木偶像，解释他们的灵魂会花上<N>很长的时间来寻找天堂。我问她这样对她的人民<N>如此做是否会让她不安，她困惑的看着我问，我那耳朵<N>会否对我的脸来说太大了，然后一边唱着吃羊舌的歌<N>一边走开。总有一天，我会拿石头砸她的头！
$ENTRY_JOURNAL_JOURNEYS_TITLE	
$ENTRY_JOURNAL_JOURNEYS_LEFT_0_00	第9天 -旅程
$ENTRY_JOURNAL_JOURNEYS_LEFT_0_10	我越来越熟练，边走边写了。在旅途上，我们可以做的事很少，<N>除了听我的同伴无休止的啰嗦，或是想像正在追杀我们的敌人可怕的秘辛，<N>这两件事我都恨不得有人来分散我的注意力。<N>于是，这个日记是我作为旅行者的朴实记录，<N>记录了我23年来的时间在首都和周围的小镇的事，<N>也把我所有的幼稚想法都用字记录下来。<N><N>那些发白日梦的闲暇时光中，我在想象旅程的精彩时，<N>我觉得我们都像西部的兄弟一样。跟随着庙宇的朝圣者回家，<N>来自山上的人，像诺曼人一样黑， 还有来自海上的人，<N>全部都因为瑟连里而聚集起来。七国都因为泉水的真相而聚合在一起。23年来的时间在首都和周围的小镇的事，<N>也把我所有的幼稚想法都用字记录下来。
$ENTRY_JOURNAL_JOURNEYS_RIGHT_0_00	那些发白日梦的闲暇时光中，我在想象旅程的精彩时，<N>我觉得我们都像西部的兄弟一样。跟随着庙宇的朝圣者回家，<N>来自山上的人，像诺曼人一样黑， 还有来自海上的人，<N>全部都因为瑟连里而聚集起来。七国都因为泉水的真相而聚合在一起。如果我要追求异教徒的恐惧和兴奋，我只需要看看挂在图书馆<N>北面墙上的卡兹麦尔-赞巴的旅行大地图，我的眼睛追随至卡革斯王国，<N>作为一个多元文化之地，长老高赛尔曾说他们的城市中可以充分感受到<N>艾殊，奎德和诺曼的风情。除了这些以外，还有异教徒，不知名海岸的恐怖，<N>那连卡兹麦尔形容为传奇的高山峻岭， <LQ>那里有食月者。<RQ><N><N>我的旅程与之相比，实在令人沮丧，在艾殊的门前，<N>一切熟悉的都变得可悲又可怕。
$ENTRY_JOURNAL_OZIMAL_DEAD_TITLE	
$ENTRY_JOURNAL_OZIMAL_DEAD_LEFT_0_00	第10天- 奥斯蒙之死
$ENTRY_JOURNAL_OZIMAL_DEAD_LEFT_0_10	我以为在知道奥斯蒙的死讯后，我会有一点安慰，但并非如我所想。<N><N>他不过是另一具眼神空洞的死尸，听命我们敌人，在死亡之前作为一只棋子。<N><N><N>这个世界从不缺邪恶与冷酷的人。在墓坑中的事，有谁会留意到呢？
$ENTRY_JOURNAL_MONASTERY_TITLE	
$ENTRY_JOURNAL_MONASTERY_LEFT_0_00	第10夜 - 修道院
$ENTRY_JOURNAL_MONASTERY_LEFT_0_10	我认为把墓坑跟家相比的话，是一件很愚蠢的事，但是<N>我看到瑟连里的修道院后，还是有点震惊的。这是一个<N>宏伟的，不祥的结构，比寺庙更像堡垒。<N><N>我明白了这些预防措施的必要性，但是和我从小认识的寺庙<N>喷泉格格不入，那里甚至守卫都需要携带钝器，<N>免得他们在和谐的发源地播下混乱和破坏。<N>我与其他信徒一样站在同一个地方，把手伸入泉水之中，<N>精神上一直连结到瑟连达本人，这是令我安心的事。<N>在这里，我是一个谦卑的仆人，与国王和先知的分别只在于时间。<N> <N> <LQ>正如山谷上的水一样，上升成雾，<N>落在山上成雪，进入河流冲向大海，<N>所以每个人的本质是一样的，必须服务
$ENTRY_JOURNAL_MONASTERY_RIGHT_0_00	于他的时代与位置中的不同角色，为了让神圣的机器和谐的发挥作用。<RQ><N><N>我不禁好奇到底在这个法律荡然无存的可怕地方，<N>和谐与智慧实在离我们的希望很远的地方，我的角色是什么呢？<N><N>在这座堡垒庙宇之中，我觉得，我找到一点安慰。<N>难道这些僧人不是为他们存在的目的服务吗？ <N>这些强大的墙壁和战争的防御只不过是使瑟连达的精神<N>在这个无法无天的地方得到适应。<N> <N>正如伟人说的那样，<LQ>事实依然是真相，不管它哪种语言书写。<N><RQ><N>这些防御只不过是墓坑的语言;内在的真相仍然是真的。
$ENTRY_JOURNAL_BAKAL_TITLE	
$ENTRY_JOURNAL_BAKAL_LEFT_0_00	第11天 - 长老 [healer_hero]
$ENTRY_JOURNAL_BAKAL_LEFT_0_10	牧师长老[healer_hero] 是这个混乱世界的理性绿洲。<N>纵然我们只在很短时间中有过少得可怜的交流，那些片言只语<N>都对我的灵魂得到大大的提升。
$ENTRY_JOURNAL_BAKAL_LEFT_0_20	我希望我也可以为他提供同样的感受吧。他似乎正被内心的痛苦
$ENTRY_JOURNAL_BAKAL_LEFT_0_30	折磨着，我可以从他那僧侣般平静的脸上可见他的煎熬。<N>很明显，他曾是个士兵：那些伤疤，那风度和言行举止，都是一个战士才有的。<N><N>我发现在寺庙中即使每个人都叫他做牧师长老，<N>但是他其实不是一个牧师。他既没有权力，也没有任何官方的位置，<N>但他的同僚都定期寻求他的意见，好像他就是领袖一样。<N>亚伯特大公似乎不只是一个亲近的门徒。
$ENTRY_JOURNAL_BAKAL_RIGHT_0_00	目前的冒险看起来对[healer_hero]起到激励与鼓舞的作用,就像
$ENTRY_JOURNAL_BAKAL_RIGHT_0_10	他的灵魂近乎平衡的状态一样。我知道为什么[ranger_hero] 会怕他, <N>因为在他眼中的决心就像追杀我们的人一样。
$ENTRY_JOURNAL_BAKAL_RIGHT_0_20	<N>我只好祈祷[healer_hero]终有一天可以获得平静，就像他给到其他人一样的。
$ENTRY_JOURNAL_MANUSCRIPT_TITLE	
$ENTRY_JOURNAL_MANUSCRIPT_LEFT_0_00	第11天 – 卡革斯卷轴
$ENTRY_JOURNAL_MANUSCRIPT_LEFT_0_10	清理所有威胁后，[healer_hero_pos] 小房子外的河流产生了大量价值。
$ENTRY_JOURNAL_MANUSCRIPT_LEFT_0_20	([berserker_hero],在杀光那些往者后，<N>再剩下的一整天都野蛮地向其他居民泼水）。<N>享用过一顿烤鱼大餐后，我心满意足，我的脑海还是想着一个亡者的尸体。<N><N>在河里清除的可怕东西之中，<N>有一具尸体比其他的让我更在意。以他的衣服的质量来判断，他曾经是一个重要的人，他的衣服的奇怪版型和剪裁让我相信，<N>他在北方其中一个的国家举足轻重。虽然其余的装备太烂了，没有任何用处，<N>但他的腰带上有一层防水物料。里面，我发现一块仍然清晰的羊皮纸。<N> <N>内容验证了我对于人类起源的理论。文字似乎是其中一个 
$ENTRY_JOURNAL_MANUSCRIPT_RIGHT_0_00	我完全不熟悉的北地语言 （我懂得艾殊语，无论是现代还是古文，还有我们西部世界兄弟们的方言)
$ENTRY_JOURNAL_MANUSCRIPT_RIGHT_0_10	可能我心灵有巨大的道德缺陷，被屠杀和悲伤包围，依然对谜团着迷。这对我来说是莫大的安慰，听起来好像很自私，
$ENTRY_JOURNAL_MANUSCRIPT_RIGHT_0_20	 全心全意地致力于破译一些神秘的手稿，<N>是我逃避黑暗和血腥的世界的方法。当我闭上双眼，我几乎感觉到自己就在图书馆内。
$ENTRY_JOURNAL_MANUSCRIPT_RIGHT_0_30	尽管我对这种语言的无知，我自己一个人已经能够挑出几个细节。<N>我看到，反复多次，似乎是从诺曼族借来的一组字形（一种古语，冒着你们说我夸大我的语言能力的风险，我承认我懂一点）。它大致翻译成 <LQ>盛装的女人,<RQ> 或是 <LQ>女王<RQ> (我见过有人这样用), <N>又或是 <LQ>带着很多符号的女人<RQ>，这会更接近字面意思。旁边文字的排列
$ENTRY_JOURNAL_MANUSCRIPT_LEFT_1_00	令我怀疑诺曼借过来的文字可能是一个合适的名字，<N>可能他就是手稿的作者，或是手稿就是给他的。
$ENTRY_JOURNAL_MANUSCRIPT_LEFT_1_10	这就是我所发现的，我或许会叫上[healer_hero]来帮忙，<N>我从别人那里得知他对于卡革斯语和方言非常精通。
$ENTRY_JOURNAL_MANUSCRIPT_LEFT_1_20	附录:<N>[healer_hero]确实拥有僧侣所认可能力。
$ENTRY_JOURNAL_MANUSCRIPT_LEFT_1_30	尽管方言晦涩，他能在短短的时间内,向我发送文本的开头的翻译： <LQ>回到我身边，我心爱的人,<RQ> 进步进展相当慢，结果解释非常完整，但奇怪的情况已经开始出现。<N>第二行, <LQ>对于我们哭泣的孩子，<RQ> 表示作者和收件人之间的关系远远超过一个干涩的恋情。
$ENTRY_JOURNAL_MANUSCRIPT_RIGHT_1_00	从这里开始, [healer_hero]告诉那些文字明显变得更难理解，有部分字眼就像胡言乱语一样，让他也怀疑自己的准确性。<LQ>我到底用什么声音才可以挑战到你现在听到的那一把呢？<RQ>是另一句[healer_hero] 可以翻译好的。其余的文字就像谜一样，我们不能刺探透，好像一个字 [healer_hero]说可以解释为<LQ>灰色<RQ> 或是 <LQ>灰尘,<RQ>同一句句子不断重复 <LQ>你要回归到血中,<RQ>  还有我早前发现的很多专属名字。<N>当听到我说出那个名字时，<N> [ranger_hero] 纠正我对诺曼文借字的认知。在东北部（这份手稿似乎是来自于此）,  <LQ>符号<RQ>一字其实有很多含义。<N>据 [ranger_hero]所说, 更准确的翻译应该是 <LQ>一个有神秘魅力的女人。<RQ>这个女人有的魔法力量，很不幸，没有给我对这些文字新的想法。我只能保守的说她对作者的心下咒了。评估了一下他的传信人的财富，这个卡革斯王 (我猜的)不遗余力地
$ENTRY_JOURNAL_MANUSCRIPT_LEFT_2_00	寻求他那神秘魅力的女人的回归。<N>她是否注意到她丈夫和孩子的请求，甚至是否收到了这个信息，这是一个谜。
$ENTRY_JOURNAL_WRENNA_TITLE	
$ENTRY_JOURNAL_WRENNA_LEFT_0_00	第13天- [mage_hero_fu]
$ENTRY_JOURNAL_WRENNA_LEFT_0_10	薄利蒙对奎德族的王族的描述并不夸张。<N>[mage_hero] 实在是 <LQ>比月亮苍白，也比它遥远。<RQ><N> 如果我需要模仿古语，我会补充<LQ>比水星遥远<RQ> <N>我从来没有见过任何人可以在这样短的时间内，<N>经历疯狂的那么多层次。就算是 [berserker_hero]，也是稳定地傻。<N> [mage_hero]是如怒海一样，这一秒她好像非常邪恶，<N>下一秒她又像无可救药的天真。她的行为经常给人一种很好玩的感觉，<N>但是我的怀疑得到确认，她会像小孩一样不讲理性，疯狂得不像常人。<N><N>有时我觉得我能看透这个女孩的疯狂其实很像我：恐惧，孤独，<N>同时拥有可怕的能力。我不知道她是否这样看待自己。
$ENTRY_JOURNAL_NOMADS_TITLE	
$ENTRY_JOURNAL_NOMADS_LEFT_0_00	第14天 - 诺曼族
$ENTRY_JOURNAL_NOMADS_LEFT_0_10	跟诺曼族接触的第一手经验非常有意思。这些原住民占<N>领了艾殊城市和奎德帝国之间的山谷峻岭。在卡提门·薄利蒙的东方远行之旅中，<N>
$ENTRY_JOURNAL_NOMADS_LEFT_0_15	就像名字所说，这些部落逐水草而居,在山岭中饲养山羊和马。<N>少部分生活习惯也带来了墓坑，这种守卫永远是必须品的地方。<N><N>^少于一半还是一个健存的部落。
$ENTRY_JOURNAL_NOMADS_LEFT_0_20	有超过100个部落被 记录下来， 但我相信经过战火的洗礼，<N>留下来的已经不多。在墓坑中，我遇到来自27^个部落的人，<N>在外面世界生活的人的数量是不可估计的。
$ENTRY_JOURNAL_NOMADS_RIGHT_0_00	健存的部落会像卡革斯一样来建筑村落，依赖山羊和简单的农业来生活。 <N><N>离散的诺曼族（那些家园被破坏或是一直分散在外的）会在一些比较现代的都市，好像勒萨斯一类的，寻找栖身之所, <N>或是成为游侠-传达信息，并守护墓坑村庄之间的贸易。
$ENTRY_JOURNAL_DREAM1_TITLE	
$ENTRY_JOURNAL_DREAM1_LEFT_0_00	第15天 -奇怪的梦
$ENTRY_JOURNAL_DREAM1_LEFT_0_10	已经有一段时间我没有做梦了。 中途世界的可怕感觉似乎主宰了我的精神，<N>即使在睡眠中，我也只感到无所适从。然而，昨天晚上，自从我先前生病发烧以来，我第一次做梦了。<N> <N>这是一个非常激烈的梦想，我所看到的一切恐惧统统都驱走。<N>事实上，我23年来的所有经历似乎都在消失。我站在一个高高的阳台上。我不是我自己，我的胳膊是黑色和结实的，<N>覆盖着奇怪的符号和金手镯。我的衣服布满宝石，好像整个国家的财富都不足以做我衣服的下摆。
$ENTRY_JOURNAL_DREAM1_RIGHT_0_00	巨大而火红的月亮低悬于空中，我几乎可以伸出手指来触碰它。<N> <N>一个声音呼唤我，我转身。在阳台上有一个男人站在我旁边。他很高，<N>比我见过的任何一个人都要高。他的头发和胡须黑如午夜，长而且装饰着金环。他的存在使世界变得朦胧和渺小。<N> <N>他用玛瑙色的眼睛看着我，我明白我们是一个人。<N>我把火焰的月亮拖下来，把它分为两半，我们一人一半。我颤抖着醒来，<N>我的手抓住我的胸口，好像我的心就是那那个红色的月亮。我沉没在巨大的渴望之中，<N>我哭了。在那个醒来的时刻，我会做任何事情来重返那个梦。
$ENTRY_JOURNAL_DREAM1A_TITLE	
$ENTRY_JOURNAL_DREAM1A_LEFT_0_00	第15夜 - 奇怪的文字
$ENTRY_JOURNAL_DREAM1A_LEFT_0_10	即使经过忙碌的一天，[ranger_hero] 依然保持着令人讨厌和自我中心。
$ENTRY_JOURNAL_DREAM1A_LEFT_0_20	我们装作什么事都没有发生，带着晚餐回到医院提供给我们的小房间。或许只有我当时是这样想吧。
$ENTRY_JOURNAL_DREAM1A_LEFT_0_30	半夜时，我被人奇怪地弄醒了。 [ranger_hero] 用手盖住我的口。 <LQ>你在说梦话,<RQ>她回到自己都位置时解释 。<N>但当我问她我说了什么时，她只是摇摇头。<LQ>我并不明白，<RQ> 她补充道。
$ENTRY_JOURNAL_DREAM1A_LEFT_0_40	可是她眼中的恐惧背叛了她，这可是我从未见过的。<N>沉默良久，她相信我再一次睡着的时候，她开始喃喃自语。<N>我隐若听到一点，但是只有一句诺曼语的句子我可以听懂。那大约意思为 <LQ>从那些被逐之人中保护我。<RQ><N><N>当她停下时，我知道她睡着了，于是我拿出我的日记，就着微弱的灯火开始写这一段记录。
$ENTRY_JOURNAL_DREAM1A_RIGHT_0_00	我对于意识模糊时说出的字，那些短促，古怪又陌生的字，只有依稀的印象。<N>当我努力会想醒来前的状态时，突然灵光一闪，不是记起那些音节，而是它们的意义。<N><N>我开始忘我地写下来，因为我怕当我停止理解我的思想时，它们就会消失。<N><N>我完成了记录后，我知道我不应该再想什么。
$ENTRY_JOURNAL_DREAM1A_RIGHT_0_10	我是风暴<N><N>正被困住而备受折磨<N><N>死亡的权利也被剥夺h<N><N>我里面的神划伤了
$ENTRY_JOURNAL_FEARSOME_WORDS_TITLE	
$ENTRY_JOURNAL_FEARSOME_WORDS_LEFT_0_00	第16 天 – 带伤疤的嘴唇吐出可怕的字
$ENTRY_JOURNAL_FEARSOME_WORDS_LEFT_0_10	与奎德王族上路时，我无法制止自动的好奇心，无论<N>是好还是坏，我都想知道。对于[mage_hero] 来说，她也乐意解答我的问题。
$ENTRY_JOURNAL_FEARSOME_WORDS_LEFT_0_20	不过我总是战战兢兢，因为你无法得知到底<N>哪一个问题会让她嫣然一笑，哪一个会让她雷霆震怒。
$ENTRY_JOURNAL_FEARSOME_WORDS_LEFT_0_30	她的情绪就像浪潮一样起伏不定，<N>即使我花上多年时间也无法自信预估灰色眼眸中的情绪。
$ENTRY_JOURNAL_FEARSOME_WORDS_LEFT_0_40	有时候，我看着她年轻的面容，<N>就会挣扎想起她的民族残酷的所作所为。
$ENTRY_JOURNAL_FEARSOME_WORDS_LEFT_0_50	其他时间我可以从她带着伤疤的嘴唇，感受到那股屠杀的狂热。<N>就在我们上一场战役的混乱与恐惧中，我抱住自己进入了中途
$ENTRY_JOURNAL_FEARSOME_WORDS_RIGHT_0_00	世界-我凌乱的思绪被一个扎眼的画面震撼，[mage_hero]
$ENTRY_JOURNAL_FEARSOME_WORDS_RIGHT_0_10	微微垂下头，<N>双手紧紧抓住一个下属，发白的指关节显得她的皮肤更为雪白。
$ENTRY_JOURNAL_FEARSOME_WORDS_RIGHT_0_20	她紧闭双眼，好想依靠意志力把外面的世界拒诸门外。
她的嘴唇一遍又一遍地吐出了奇怪的奎德语，节奏就像动荡的洪水一样，<N>她在抖震。在我看到她的一小段时间，似乎是一瞥永恒，<N>就好像这个奇怪的苍白的女孩会站起来，将自己的愤怒向末日倾吐。
$ENTRY_JOURNAL_FEARSOME_WORDS_RIGHT_0_30	战斗过后，我问她在说什么，她用了一些时间，将那些字翻译为艾殊语：
$ENTRY_JOURNAL_FEARSOME_WORDS_RIGHT_0_40	<N>火焰啊！<N>火焰燃烧我！ <N>烧尽我渺小的心！ <N>用你的意志来取代吧！
$ENTRY_JOURNAL_FEARSOME_WORDS_LEFT_1_00	当她吐出了最后一个字，她在颤抖，她见到我直直地看着她那摇晃的火焰，<N>弱弱地道歉，解释道<LQ> <RQ>刚刚神圣之怒在她身上发生。<N><N>她在<LQ>神圣之怒<RQ>的痛苦中颤抖着身体，<N>这深深印在我的脑海中……<RQ>那带伤疤的嘴唇，呢喃着可怕的话。当我们进入这些奎德废墟时<N>会发生什么事呢？我不敢想象[mage_hero_pos] 穿过她那已经不复存在的帝国时，<N>内心会翻起怎么样的风暴。
$ENTRY_JOURNAL_FEARSOME_WORDS_TITLE	
$ENTRY_JOURNAL_DESERT_FORTRESS_TITLE	
$ENTRY_JOURNAL_DESERT_FORTRESS_LEFT_0_00	第17天: 沙漠之宝
$ENTRY_JOURNAL_DESERT_FORTRESS_LEFT_0_10	"我曾经常常会想象我们最大敌人的家园，在遥远的东方是什么的样子。<N>这战争似乎对首都来说是种无形的恐怖，只有透过日常的伤亡报道，与许多残障退伍军人在街上乞讨的哀悼声中传达。
 <N><N>即使生活在无形的恐惧中，实际看到奎德市的景象是一种奇怪的经历。<N>我被设计的美丽和聪明才智所震撼，但更令我震惊的是，我对它的熟悉。<N><N> 我看到了所有标志着城市生活的细节：用细碎鹅卵石铺成的路，被年轻人恶作剧破坏的纪念碑，市场摊位就像其他城市一样。"
$ENTRY_JOURNAL_DESERT_FORTRESS_RIGHT_0_00	我几乎可以看到我的父亲坐在街角，<N>与这个城市的其他老人一起，笑着，诅咒着和闲聊着。<N><N>但是这个地方的人民却破坏了泰尔纳，杀死了<N>所有居民，每一个男人，女人和孩子。
$ENTRY_JOURNAL_THE_FOX_TITLE	
$ENTRY_JOURNAL_THE_FOX_LEFT_0_00	第17夜: @狐狸@
$ENTRY_JOURNAL_THE_FOX_LEFT_0_10	当我还是个小孩时，我曾在皇家图书馆附近的花园发现一只垂死的狐狸。<N>到底这只野生动物如何来的城市的中心仍是个谜团，但是他的出现令那些本来还在昏昏欲睡的<N>守卫牺牲了冥想时间，纷纷拿起石头和树枝来攻击这可怜的小动物。<N>他们的愤怒将花园变成战场。浑身浴血，狐狸已经把自己拖入一个壁龛里去静静等待死亡。<N>我与妈妈经过时，听到微小的呼吸声。我跳了出来，<N>悄悄滑进了壁龛的门口。狐狸看见我的出现时，时间好像冻住了。<N>他遇上我时，那沉默比任何警告咆哮都有更多的痛苦和愤怒。<N>他定定地看着我，直至我的妈妈把我拉回去，直至我看不到他为止。<N>当我等待着入睡时，我的脑海不时浮现这一幕。<N>我早就预备好迎接一场暴风雨，但是[mage_hero]
$ENTRY_JOURNAL_THE_FOX_LEFT_0_20	一整天都在这些废墟中游走，看起来并未有受身边这些死亡的踪影所影响。
$ENTRY_JOURNAL_THE_FOX_RIGHT_0_00	我一直等待风暴的爆发，但当它真正降临时，却非我所预料的。<N>那时，我正在搜索废墟中的大厅和隧道，想想我们身在何方，我踢到灰烬瓦砾盖住的一小卷羊皮纸。当中大约有一半的文字都被破坏了，好像那场战争的威力强大到连文字都不能躲开。<N>留下来的文字以奎德语草草书写，但也显得优雅。我拿给[healer_hero]看，<N>但他说余下的文字跟我们的任务毫无关联。他好像很努力<N>把他的目光从上面移开。 <N>我并不知道我为什么做了，或是我做了什么。
$ENTRY_JOURNAL_THE_FOX_RIGHT_0_10	我的梦令我不再明白我自己的动机。
$ENTRY_JOURNAL_THE_FOX_RIGHT_0_20	为了跟她交朋友，或是出于无聊的好奇心，我想跟她说话，但是我怕我的行动会带着不良的动机，为了伤害我害怕与憎恨的唯一对象。<N>我的一生中，奎德一直都是疼苦的无形根源。或许，我只是想要看看一个人承受一下，那些施加于我们身上的苦楚。<N>或是她的平静刺痛了我。又或者，我嫉妒她的坚强与
$ENTRY_JOURNAL_THE_FOX_LEFT_1_00	想撕开她的面具。我不知道。<N><N>无论是何原因，我拿了那片羊皮纸，给了[mage_hero]。<N>她消失在她的帐篷中，一会儿后出来时，带着一片新羊皮，<N>上面有翻译。它写道：
$ENTRY_JOURNAL_THE_FOX_LEFT_1_10	这是，我们伟大的坟墓…<N>...仅存的...<N>沙漠之宝。<N>没有人会哀嚎…最伟大的… <N>一个可悲的事情，锻造了...的男人... <N>我们死了... <N> ...终极没有荣誉... <N> ...可恶的人... <N>没有伟大... <N> ...放弃灰烬... <N> ...可悲... <N> ...邪恶...
$ENTRY_JOURNAL_THE_FOX_RIGHT_1_00	这明显来自于一个奎德的战士，他注定要在围困中死亡。<N>他面对死亡时的口才，或是一切他所认知的消亡，都让我无言以对。<N>我思考着那被毁的挽歌，当我发现那页纸底部的泪痕时，我非常惊讶。<N><N>我掀起[mage_hero_pos]帐篷的帘子，但在说话前停下了。<N>她卷缩在远远的一角，亚麻色的发丝垂在脸上。她像狐狸的眼睛，<N>忍受着我永远不知道的痛苦，我们想对而视。<N>那一刻就像多年前的沉默一样，比起任何疼苦与愤怒的言语都来的沉重。<N><N>我立即离开，但是那影像还是纠缠着我。<N>这次，我就是那加害者。
$ENTRY_JOURNAL_THE_FOX_LEFT_2_00	附录:<N><N>我为你带来一首诗:
$ENTRY_JOURNAL_THE_FOX_LEFT_2_10	"肌肉...<N>...多不胜数...<N>性感... 得过分...<N>大汗... 卡丽斯...<N>B权力和荣耀的基础。<N>令人惊叹的，怀疑... <N>喇叭花的腹肌<N>所有的伟大...<N>...冶炼<N> 臀部...<N>... 闪亮的...<N>... 有力量的...<N><N>
$ENTRY_JOURNAL_THE_FOX_LEFT_2_20	那些缺失的字是因为我在拉筋是，现实的布被扯破了。
$ENTRY_JOURNAL_MARKOS_TITLE	
$ENTRY_JOURNAL_MARKOS_LEFT_0_00	第18天- [knight_hero]
$ENTRY_JOURNAL_MARKOS_LEFT_0_10	我是否已经习惯与喜怒无常为伍，而非相信理性？ <N><N>[knight_hero]勇敢，聪明，善良，甚至幽默- 该死的，他还非常注重个人卫生！<N>而我则等待坏事的发生。<N><N>他一定有问题！有些怪癖，有些小性子，有些不理性。<N>如果我在这段旅程当中学到一件事的话，那就是在墓坑之中并未有正常。<N><N>那是小胡子，对不？他一定把所有疯狂藏在小胡子之后。
$ENTRY_JOURNAL_LETTER_MARKOS_1_TITLE	
$ENTRY_JOURNAL_LETTER_MARKOS_1_LEFT_0_00	第19天
$ENTRY_JOURNAL_LETTER_MARKOS_1_LEFT_0_10	利佛巴女士尊鑒，艾殊骑士加山提亚謹啟：<N><N>女士，本人非常敬重您担任我方指挥官一职，<N>但想表示对您选择的同行者有所保留。也就是说，只要我们继续与[mage_hero_fu]（兰·兰世弥）同行<N>，本人不能保证您的安全，甚至整个计划的安全。<N><N>您或想说服我她<LQ>没那么不堪<RQ>，而且奎德的战役已经结束；<N>但本人向您保证，对她来说绝对还是未罢战息兵。<N>她狂热地专注于一些已不存在的东西，<N>根本没有指令体制可控制她的疯狂。如果[mage_hero_fu]认为奎德的光荣<N>是需要我们颈上头颅来成就的，那我们便没有一人可以醒来看见黎明。
$ENTRY_JOURNAL_LETTER_MARKOS_1_RIGHT_0_00	本人建议您尽快而巧妙地与她断绝关系。<N><N>您恭谨的仆人，<N><N>[knight_hero_fu] 加山提亚
$ENTRY_JOURNAL_LETTER_MARKOS_2_TITLE	
$ENTRY_JOURNAL_LETTER_MARKOS_2_LEFT_0_00	第19夜 – 给[knight_hero_fu]的信，草稿1号
$ENTRY_JOURNAL_LETTER_MARKOS_2_LEFT_0_10	亲爱的[knight_hero_fu]：<N><N>为了回应你的来信，我想提出三点：<N><N>第一，为何我们只相距十尺之遥，但你却特意写信给我？<N>难道是我的个人卫生使人难以靠近？大家有为此背地里取笑我吗？<N><N>第二，请不要再叫我女士了。<N><N>最后，请不要打扰[mage_hero]，不然……我也说不准，或会烧掉你的腮边的鬓胡之类。
$ENTRY_JOURNAL_LETTER_MARKOS_2_RIGHT_0_00	附笔：关于你的鬓胡，我只是开玩笑，我永不会把那烧掉，<N>因为这样会令你的样子看起来怪诞，这又使我忍不住在背后叫你另一个新的绰号，要知原来「美髯先生」的名号已够响亮了（的光环已够大了）。<N>不管怎样，我要说的是[mage_hero_fu]已经历一段非常艰难的时期，<N>所以为什么不挑另一个更堪调侃的呢？例如[berserker_hero_up]，他似乎认为我不知道他在背后探头探脑。<N>要知他是个用口呼吸的白痴，闻起来像两堆……
$ENTRY_JOURNAL_LETTER_MARKOS_2_RIGHT_0_10	<N><N>我爱你[knight_hero_up]我甚么想嫁至给你的胡子，<N>更何况你比[berserker_hero_up]更棒，也穿裙子……嘿嘿﹐我们结婚吧！
$ENTRY_JOURNAL_LETTER_MARKOS_3_TITLE	
$ENTRY_JOURNAL_LETTER_MARKOS_3_LEFT_0_00	第20天
$ENTRY_JOURNAL_LETTER_MARKOS_3_LEFT_0_10	[mcguffin_hero_fu]女士,<N><N>我并未有想过会收到你的来信，看见由曾经被你用汤勺子追打至逃出营地的 [berserker_hero_fu] 带来， <N><N>我只会将整封信完封不动地退回。<N>另外，麻烦你记得要把汤勺子洗过才好再用。谢谢！  <N><N>P.S. - 美髯先生？真的吗？这是你能想到最好的吗？<N><N>-[knight_hero_fu]加山提亚
$ENTRY_JOURNAL_LETTER_MARKOS_SLAK_TITLE	
$ENTRY_JOURNAL_LETTER_MARKOS_SLAK_LEFT_0_00	第21天
$ENTRY_JOURNAL_LETTER_MARKOS_SLAK_LEFT_0_10	嘿，[mcguffin_hero_up]，我是[knight_hero_up]我想和你生孩子因为我是一个淑女<N>这就是我穿裙子的原因还有[berserker_hero_up]实在是太棒了<N><N>来自<N><N>一定是[knight_hero_up]
$ENTRY_JOURNAL_LETTER_AZRA_SLAK_TITLE	
$ENTRY_JOURNAL_LETTER_AZRA_SLAK_LEFT_0_00	第21夜
$ENTRY_JOURNAL_LETTER_AZRA_SLAK_LEFT_0_10	亲爱的[berserker_hero_fu],<N><N>如果你读到这里，这代表你再次潜入我的帐篷，<N>去亵渎我的日记或是很差劲地模仿他人。这次不会再忍了。<N>你看见帐篷的帘子吗？猜猜有什么在后面呢？<N><N>我给你一个提示吧：汤勺子可不太喜欢你啊。
$ENTRY_JOURNAL_LETTER_AZRA_SLAK_LEFT_0_20	哈哈我几乎有一秒的时间相信你<N>还有我的名字是[knight_hero_up]我喜欢穿漂亮裙子和
$ENTRY_JOURNAL_NIRU_TITLE	
$ENTRY_JOURNAL_NIRU_LEFT_0_00	第22夜 - [dragon_hero]
$ENTRY_JOURNAL_NIRU_LEFT_0_10	我听过很多关于龙的事。牠们是我表姐的童年追求，<N>她如饥似渴地搜索着有关于龙的一切传说，有薄利蒙的科学假设到诺曼族的传说。<N>这些故事随后都以儿童的套路灌输给我：落后，凌乱和紧凑。<N>先别说这个课堂的质量，我的脑海中还是储备了很多资料。<N>现在我和一条活生生的龙作伴时，我童年的回忆都涌现了。<N>在这次冒险的过程中，与这生物面对面时，我的先入之见大部分都不准确。<N>然而，在这种情况下，我重要的发现是：[dragon_hero]是一个肥胖，贪婪，自私，傲慢的大蜥蜴，<N>被人过度渲染那妄想的神性。
$ENTRY_JOURNAL_NIRU_RIGHT_0_00	这强大的生物实际是非常危险的。她完全没有顾虑，<N>可以把我们队伍中的任何一人吃掉，或是杀死任何轻微惹怒她的生物，还有把所有<LQ>非永生者<RQ>视为低她一等。<N><N>自视过高通常是无知的根源。[dragon_hero]拥有一件珍宝， <LQ>龙尺寸的酒杯。<RQ>如果她不是对艾殊文字不以为然的话，<N>她就会知道那段刻文上的意思是<LQ>维达蒙领主的厨锅<RQ>. 每当我被她的气焰激怒时，<N>我只需要想想她欢乐地用这个<LQ>酒杯。<RQ>

$ENTRY_JOURNAL_NIRU_LEFT_1_00	第24夜 - 附录
$ENTRY_JOURNAL_NIRU_LEFT_1_10	即使她对于任何外界的东西都毫不在意， [dragon_hero] 是一个非常关心孩子的母亲。<N><N>每当我看见她为自己的孩子而烦恼时，我都不禁想起我的母亲。<N>这可是一种奇怪的感觉，因为那可是一个巨大的怪兽，近乎每天都威胁着要把你吃掉，<N>不过这就是我的感受。 <N><N>我知道这种同理心会让我被杀掉，但是我猜想不到她的孩子被亡者带走时的疼苦。这宗悲剧会触动我们之中最强大和最冷静的人。
$ENTRY_JOURNAL_SPEECH_TITLE	
$ENTRY_JOURNAL_SPEECH_LEFT_0_00	第23日-演说
$ENTRY_JOURNAL_SPEECH_LEFT_0_10	今天当我要处理那只肥胖又可怕，幸好不是文盲的蜥蜴的抱怨时，<N>我找到一些卷轴。 大多是又旧又难以辨识的，但只要一卷清晰可读。我感到震惊地意识到，那是摄政王的就职演说：
$ENTRY_JOURNAL_SPEECH_LEFT_0_20	我怀着严肃与深切的哀悼，承担起摄政王的位置。我们失去了君父，<N>更要承担双重的悲痛。不久以前，我们伟大的君王瑟里默奔天，但哀伤还未过去之时，<N>死亡又给予我们沉重的打击，我们的太子舍里米尔殿下在战场上壮烈牺牲。<N><N>尽管前路茫茫又波涛汹涌，我保证，黎明即将降临。<N><N>我懇请你在阿述缇蒙的后裔出现继承大统，领导我们迈向和平以前，接受我的带领。
$ENTRY_JOURNAL_SPEECH_RIGHT_0_00	好像一辈子前这么遥远，我站在首都之中听着这番来自摄政王口中的话。<N>我与一个年轻的女孩被悲伤淹没，在神庙广场悄然落泪，担心失去艾殊王的带领，太阳是否还会升起。
$ENTRY_JOURNAL_ASSASSIN_TITLE	
$ENTRY_JOURNAL_ASSASSIN_LEFT_0_00	第24-天-刺客
$ENTRY_JOURNAL_ASSASSIN_LEFT_0_10	我今天有一个奇怪的发现，在奋战过后那好奇和兴奋的时刻，<N>我们都在筛选战败敌人的遗物，看看有没有什么装备可以拿过来用，我忽然看见一个奇怪的东西。<N><N>它好像锁子甲，或是剩下的锁子甲，还有一层穿在下方的衬里。<N>那些甲片更小，做工更为细致，我从来没有在我们奎德德军队中见过类似的东西。这精致的设计，<N>还有夹杂在中间的布料，让我相信这是穿着在日常衣物之下的。这种保密的企图让我怀疑这并不是来自军队，而是来自民间。<N><N>我对这件锁子甲的疑惑在于，那明显的伤口。那大约一巴掌大小，位于心脏位置的缺口。
$ENTRY_JOURNAL_ASSASSIN_RIGHT_0_00	缺口位置周围的甲片都已经扭曲和变黑，就像受害者承受了可怕的热浪和暴力。<N><N>我对这种破坏并不陌生，我曾见过无数亡者的尸体都有这些痕迹，那是我用自己雷击之术的痕迹。但这可不是我的杰作。
$ENTRY_JOURNAL_ASSASSIN_RIGHT_0_10	最令人不安的是，这些破坏了的甲片都是往外翻的，好像那可怕的热力和压力来自于盔甲内。
$ENTRY_JOURNAL_ASSASSIN_RIGHT_0_20	我不禁想问，到底是谁会穿这样的衣服，更重要的是，怎样的方法才会出现如此惨烈的死亡呢？
$ENTRY_JOURNAL_ASSASSIN_RIGHT_0_30	附录： <N><N>当我写下这些时，我依然在颤抖，刚刚发生的事，让我知道我千钧一发之际逃过死亡。
$ENTRY_JOURNAL_ASSASSIN_RIGHT_0_40	那时，我刚开始拆卸先前描述的铜片，尝试把金属皮从丝线中扯出，想要
$ENTRY_JOURNAL_ASSASSIN_LEFT_1_00	将有用的物料拆出来卖点钱。那时我正要扯下衬衣店袖子，<N>[knight_hero]抓住我的手。他一面紧握着我的手腕，一面拿出小刀鎅开缝线。<N>里面是一排针，他继续沿袖子鎅开，我们发现更多隐藏的倒钩。一共有32只，每一只都被涂上毒药，<N>秘密地缝在布的外面。当有人想要抓住攻击者的手臂时，就会被刺到。<N><N>当 [knight_hero]继续他的调查，我们发现一个小口袋，<N>缝在手腕的位置，里面有一小片卷起来的羊皮纸。羊皮纸的外族图案并不像我从前在艾殊大图书馆所见过的。<N>即使受到了严重破坏，图案依然清晰：一个纤瘦的女人坐在王座上。<N>她的面孔焦烧的痕迹遮蔽，但长长的白头发落在她的肩上，<N>与她脖子上的珠宝交织在一起。<N>在她的脚旁坐了两个黑皮肤和金色的眼睛男孩。<N>女人把手放在男孩的头上，他们的头发像她一样，是白色的。
$ENTRY_JOURNAL_ASSASSIN_RIGHT_1_00	羊皮纸的边缘都并不整齐，就像它是从更大的一张纸，<N>用刀切下来的。它的背面布满了用黑色墨水描画的符号。<N><N>对[knight_hero]来说，他尝试解释整件事。他说，那些倒钩，很可能因为放了很久的关系，<N>毒药都不再致命。他向我保证，<N>他不过是不想我的手指斗无谓地受伤而已，但是他眼中的担忧背叛了他。<N><N>到底他是如何知道这些暗器的存在，<N>如何知道这件锁子甲的主人是个刺客，这些我都无法从他口中得知答案。
$ENTRY_JOURNAL_SUPERSHEEP_TITLE	
$ENTRY_JOURNAL_SUPERSHEEP_LEFT_0_00	第24天-超级羊之死
$ENTRY_JOURNAL_SUPERSHEEP_LEFT_0_10	阿舍麻维特羊那瑟萨在我的手中一动也不动。<N><N>这，根据[dragon_hero_pos]的欢呼,<N>是一项可以被传颂千古的成就。当然，她看上去是认为她是独自一手（一爪？）完成这行动的，<N>所以她的意见做不得准。<N><N>我必须承认我很享受庆祝活动。在城市深处，被疯子和亡者追逐，<N>被混乱包围，有一刻可以享受一些东西，那实在是太好了，即使那是由一只自恋又常常作威作福的大蜥蜴所举办的<N>。看到她与孩子一起队长篝火尖叫，实在是很奇怪。除了快乐，我并不能找出形容词，<N>如果这可以用了形容怪兽的话。我没有想过这怪兽情绪的感染力会是这么强的，但我发现我开始感受到主人的
$ENTRY_JOURNAL_SUPERSHEEP_RIGHT_0_00	兴奋。我已经杀了一个传奇的生物！我已经吃了牠的肉！我已经吸收了很多 [berserker_hero]称为<LQ>靴酒<RQ>的东西！
$ENTRY_JOURNAL_SUPERSHEEP_RIGHT_0_10	为了保护将来读者那弱小的心脏，<N>我不会解释这个物质命名的起源，但当我第二杯满上的时候，我的味蕾可能永远都不会从恐怖的惊吓中恢复，<N>我的内心是炽热的，外面的世界以最愉快的方式跃动和旋转。
$ENTRY_JOURNAL_SUPERSHEEP_RIGHT_0_20	这种罕见的佳酿的祖先目前正四肢着地，一边围着我们爬虫类主人的火焰跳舞，一边尖叫起来，<N>尖叫着<LQ>这是我的龙吼！<RQ>我们不会再进一步讨论那声音，也不要讨论发出声音的那张嘴，但是两者的规律和音量都令人印象深刻的。
$ENTRY_JOURNAL_SUPERSHEEP_RIGHT_0_30	在第三杯时，我发现我对[berserker_hero_pos]的创作最初的负面印象可能太仓促了。风味完全是判断这种物质的错误参照。质感，粘度，一种
$ENTRY_JOURNAL_SUPERSHEEP_LEFT_1_00	混合了温度和重力脉冲... ...如果闪电是由皮革和泥浆制成的- <N> <N>我的靴子是空的。这必须纠正。<N> <N>再发生了！当你喝完所有的东西，靴子不会留在那里...哪里去？为什么靴子不能保持充满？<N>为什么...解决方案！新靴子。<N> <N>靴子五是迄今为止最厉害的。<N>它的靴子有靴酒。质感：惊人。风味：超越言语。后劲：旋转。<N> <N>我刚吃了一点羊<N> 我甚至没有在火上烤熟牠<N> 我生吃了<N> 这是惊人的<N> 这就像...好吧：胡须。<N>我是不是
$ENTRY_JOURNAL_SUPERSHEEP_RIGHT_1_00	是不是很奇怪？<N><N>我只想爬入胡子中，小睡一会儿N <N>像睡在小吊床上<N> <N>卷起身体，<N>我敢打赌他们闻起来都很好<N> <N>我有病吗？可能是。<N> <N>我可能有病...我可能会 
$ENTRY_JOURNAL_SUPERSHEEP_RIGHT_1_10	第25天早晨 - 附录
$ENTRY_JOURNAL_SUPERSHEEP_RIGHT_1_20	不要<N><N>不要不要不要不要不要不要不要<N><N>不要不要<N>不要再来一次。
$ENTRY_JOURNAL_DREAM2_TITLE	
$ENTRY_JOURNAL_DREAM2_LEFT_0_00	第25天-第二个梦
$ENTRY_JOURNAL_DREAM2_LEFT_0_10	昨夜，那个梦再次来临。这次的形式有点不同，但是我知道时同一个梦，或是最少我知道我是那个做梦的人。<N><N>我站在大殿之上，它的墙往上延伸，<N>直达天空，云朵是天花板。每一面墙都是金光闪闪的，我所看见的地方都铺满了名贵的珠宝。<N>我的手中有一个用最珍贵的物料所做的圣杯，杯中的酒颜色很深，很冷。<N><N>尽管身边都是珍宝，但我重视手上的酒杯胜过一切，<N>我小心翼翼地不让一滴酒洒出。忽然间大殿变暗，肮脏的暴民涌入了它。他们殴打我，<N>虐待我，从我手中抢过酒杯。我尖叫起来，从我的长袍上拿出一把尖锐的匕首，<N>向他们砸了出，向他们猛刺，直到大厅都被血染黑。
$ENTRY_JOURNAL_DREAM2_RIGHT_0_00	尽管他们损失了不少人，依然有巨大的力量压迫我，直到我被迫离开大厅，<N>被推进了一个昏暗的前厅。我反击，但是那些暴民都一直打回来，直到我体无完肤。<N>我崩溃了，那些暴民匆忙冲过来，急切地从墙上拆下了明亮的宝石。我躺下很久，相信自己已经死了。<N>当我终于可以站起时，大厅是空的。墙被拆毁，一切都被烟灰玷污。我四处一看，都没有发现我的圣杯。<N>我在大厅里漫无止境地游荡，哭泣，只有我一个人。杯子从我手上被夺走，我坐在废墟里哭泣。
$ENTRY_JOURNAL_ZELEMIR_DEAD_TITLE	
$ENTRY_JOURNAL_ZELEMIR_DEAD_LEFT_0_00	第28天-红衣男人之死
$ENTRY_JOURNAL_ZELEMIR_DEAD_LEFT_0_10	我依稀记得，我还是个孩童时遇见他，<N>即使我的脑海对眼前这个已经死亡的男人没有任何印象。
$ENTRY_JOURNAL_ZELEMIR_DEAD_LEFT_0_20	他那时留着东方村落的长发，大部分的脸都被绷带缠着，只露出一只眼睛。<N>事实上，只在妈妈那种尊敬让我知道他与其他在神庙之泉旁的退伍军人有所不同。
$ENTRY_JOURNAL_ZELEMIR_DEAD_LEFT_0_30	我记得他用右边的身体，勉强抬起一个扶拐杖士兵，让他能喝到泉水。我记得他一直站着，看着那个男人一拐一拐地离去。我记得他的眼泪一直掉下，直至进入纯洁的泉水中。 而现在他死了，被我杀死的。
$ENTRY_JOURNAL_ZELEMIR_DEAD_LEFT_0_40	成为一个杀手是一件苦涩的事，但是这是唯一合理的事情，我告诉自己，我的身上还留着艾殊族的皇家血。<N>他已经偏离了他的目的，以致危及生命的整个秩序。不过，那感觉依然困扰着我。这是我第一次杀死一个有血有肉的人。
$ENTRY_JOURNAL_ZELEMIR_DEAD_RIGHT_0_00	[mage_hero]在欢乐和愤怒之间摇摆，诅咒他的名字，好像这可以再一次杀死他。据我们过去几星期的行动来说，<N>我认为这不是一个完全徒劳的愿望。<N> <N>让我最感害怕的是亡者仍然在猎杀我们。<N>他们的领导和创造者都死了。但他为什么还可以驱使他们呢？<N> <N>这个问题我已经知道答案了，虽然我不想承认。<N>这不是他的意志。这是另一种感觉，有另一只手引导他们。<N> <N>我能感受到舍里米尔所说的奇怪的力量，<N>被牺牲的血液封住的邪恶。 以斯里·特诺奇
$ENTRY_JOURNAL_GIBBERISH_TITLE	
$ENTRY_JOURNAL_GIBBERISH_LEFT_0_00	第25天-胡言乱语
$ENTRY_JOURNAL_GIBBERISH_LEFT_0_10	今天[knight_hero]把我叫醒。我们草草吃过一点东西，<N>我被长长的旅程折腾得疲惫不堪，在刚刚经过的冰凉石头拱门上斜倚着。我最近都睡得不太好，难得睡意来袭。<N>我的睡眠不能持续超过一段时间。当我睁开眼睛，找到站在我面前的[骑士]。他告诉我，我们要继续推进，<N>当他走在我前面时，补充说，我在睡觉时一直在说话。<N><N>虽然他听起来都是无意义的东西，但我感觉到意义是在我<N>半梦半醒之间的心灵状态。我急不及待拿出我的日记，以免丢失我的猎物，记下了我有印象的。
$ENTRY_JOURNAL_GIBBERISH_RIGHT_0_00	好美好美好美你真的好美<N>我终于把它破坏<N>将你弄得跟我一样<N><N>我是囚犯和疯子<N>以自己的思想为食物<N> <N>因为他不可以吃掉世界
$ENTRY_JOURNAL_WRENNASTORY_TITLE	
$ENTRY_JOURNAL_WRENNASTORY_LEFT_0_00	第 26天 – [mage_hero_pos] 的故事
$ENTRY_JOURNAL_WRENNASTORY_LEFT_0_10	我继续发现现实和我有巨大的鸿沟，因为它客观的存在，<N>而我则在脑海中塑造的它，为它赋予解释。看起来我一直花时间去衡量的，并非事物本身，而是我创造出来的认知。
$ENTRY_JOURNAL_WRENNASTORY_LEFT_0_20	当我们一起围着营火坐下， [mage_hero]开始说一个故事。我抱住自己，期待著一個艱難的旅程：<N>是年轻时的肆意杀戮，还是狂野的激情呢？
$ENTRY_JOURNAL_WRENNASTORY_LEFT_0_30	都不是，她说了一个有关她最小的妹妹的故事。
$ENTRY_JOURNAL_WRENNASTORY_LEFT_0_40	这个孩子，比[mage_hero_pos]小七年，非常羡慕其他姐姐可以自由自在。她一直都不满足，所以总是出其不意地爬上[mage_hero_pos] 的背上，<N>假装有一样的身高和一样的灵活。但是让小女孩沮丧的是，[mage_hero] 很快就变得很迅速地移除这个小麻烦。这
$ENTRY_JOURNAL_WRENNASTORY_RIGHT_0_00	持续了一段时间，最小的老是想爬上老大的背，但每次都被人立刻扳下来。
$ENTRY_JOURNAL_WRENNASTORY_RIGHT_0_10	有一天[mage_hero]醒来时发现她的妹妹就在她的床头，费力地将一罐蜂蜜往自己身上涂，想用一个临时的方法来把自己永远地粘在可怜的姐姐身上。[mage_hero]说完后期待地看着我，带着一丝少女的微笑。我忽然发现她在等我笑出来。
$ENTRY_JOURNAL_WRENNASTORY_RIGHT_0_20	这对我来说是又新又奇怪的反应。在我的印象中，[mage_hero]
$ENTRY_JOURNAL_WRENNASTORY_RIGHT_0_30	是充满悲伤或恐惧的人。<N>她的形象一直是严肃又可怕的军人，即使在私底下她都表现得嗜血，<N>连笑也是带着疯狂，其他时间她就像个疼苦又无助的孩子，让我的正义感涌出。我的误解是多么的严重，<N>它试图将人的灵魂凝聚成一个简单的对象，只在与我的关系中才有意义。
$ENTRY_JOURNAL_EVILINSIDE_TITLE	
$ENTRY_JOURNAL_EVILINSIDE_LEFT_0_00	第27天 – 里面的恶魔
$ENTRY_JOURNAL_EVILINSIDE_LEFT_0_10	瑟连达在他第二封写给维卡利蒙王的信中提到, <LQ>当然拥抱在心内的恶魔时，胜利者并不存在。<RQ>
$ENTRY_JOURNAL_EVILINSIDE_LEFT_0_20	被别人重提自己的失败是苦涩的一课。我相信自己是瑟连达真正又热心的追随者（我现在看到那时的骄傲是一个严重的错误）。
$ENTRY_JOURNAL_EVILINSIDE_LEFT_0_30	但我肯定的说，像我这种自小已经熟读经文，定期前往神庙的人来说，这是否就代表走在正义的路上？尽管如此，我这辈子总是暗暗掩饰了邪恶不过是纯外在的东西。首先是奎德族，我早年生活所有痛苦和苦难的根源。当我每天内省自己心中的邪恶时，我秘密地告诉自己，没有一个可以与来自东方的邪恶军队相比，他们是凶手和掠夺者，比禽兽还不如。在我周围，寡妇的哀悼，孤儿的哭泣，瘫痪老军的哭泣，对城市的所有执着都是来自我自私的想法，一再对我自己强调。
$ENTRY_JOURNAL_EVILINSIDE_RIGHT_0_00	<LQ>我没有恶，<RQ>我对内心如此说。<LQ>可与之相比。<RQ> 就算是目前的冒险对我的误解有很多的启发，但是我还是维持着对纯洁的幻想。 
$ENTRY_JOURNAL_EVILINSIDE_RIGHT_0_10	
$ENTRY_JOURNAL_EVILINSIDE_RIGHT_0_20	无论我的内心有多少秘密，我可以指着奥斯蒙和舍里米尔说，<LQ>这才是真正的恶魔、<RQ><N>瑟连达的态度迂回地指出，我秘密的信仰可是非常可笑愚蠢。在这个死城的中心，握住了一只手，这只手的主人曾经是艾殊骑士，我发现了一个卷轴。有人用熟练的草书写下了以下的字：
$ENTRY_JOURNAL_EVILINSIDE_RIGHT_0_30	我最亲爱的长老大人为了回应你在崇拜时的教导，我想澄清我一直都是依从信仰的教导来行动。<N>你指控我屠杀我管控的囚犯是违背了我岗位的职责，还有违背了伟大造物者交付我的责任，但我能保证
$ENTRY_JOURNAL_EVILINSIDE_LEFT_1_00	我做的恰好是正确的。<N><N>你一定记得，当敌人兵临泰尔纳城的时候，为了恐吓守护军投降，<N>他们发誓如果不投降，他们会杀尽所有的反抗者。<N>那一天，城池沦陷的一天，那誓言成真了。可是敌人但将他们疯狂的烈怒发泄在军人身上，也发泄在平民百姓之上，不论男女老幼都受到波及。<N>那天日落时，一共有三万名平民被屠杀。泰尔纳城成为废墟，<N>只有寥寥可数的人劫后余生，来告诉我们那可怕的经历。<N><N>因为这个原因，我的囚犯中每逢是第十个的，必会被烧死。<N>在我杀够三万人以前，为了教化囚犯和实现真正的平衡，这中献祭会继续。<N>这是我对泉水中每一块金子所立下的郑重誓言，<N>即使是一个自以为是的神职人员也不会让我改变初衷。<N><N>–哥革尼曼·卡若多斯将军
$ENTRY_JOURNAL_EVILINSIDE_RIGHT_1_00	我知道这个人- 我看到，仿佛被闪电照亮，每一个灵魂中潜伏的无比黑暗。<N>比起其他人，我看到它在我自己身上。拥抱腐败而不去抵抗它<N>是多么容易。有一个甜美和熟悉的味道很难描述– 
$ENTRY_JOURNAL_EVILINSIDE_RIGHT_1_10	是否因为我已经仇恨太久而爱上仇恨？我看着眼前写着的恐怖事件，
$ENTRY_JOURNAL_EVILINSIDE_RIGHT_1_20	我看到最肮脏的罪恶。但是，这样做是多么容易。<N>我内心深处，享受着施加疼苦的甜蜜<N>，我的灵魂与复仇的喜悦共舞。我想到[mage_hero]在帐篷里啜泣 - 我用温和的手段释放我的罪恶。<N>我有什么真正的力量？
$ENTRY_JOURNAL_EVILINSIDE_RIGHT_1_30	当人拥抱自己内心的邪恶时，没有胜利者。
$ENTRY_JOURNAL_MARKOSSTORY_TITLE	
$ENTRY_JOURNAL_MARKOSSTORY_LEFT_0_00	第27天 - [knight_hero_pos]的故事
$ENTRY_JOURNAL_MARKOSSTORY_LEFT_0_10	致[mcguffin_hero] 利佛巴女士，来自艾殊骑士团的[knight_hero] 加山提亚。<N><N>不久以前，你曾问我，我是如何知道那件装备中隐藏着危险。<N>正如你所料，我曾经和一个穿着类似装备的刺客接触。当我应付过你的好奇心后，<N>我用了些时间来思考这件事，然后决定告诉你我个人的经历。<N><N>我并不常提及这个故事，更不想想起它。<N><N>那是悲惨的时代, 大约是瘟疫肆虐的两年前。<N>那时，奎德大军是无可阻挡的。东部的村落都经历了大规模的<N>屠杀，连艾殊的心脏区域也受到了入侵。 
$ENTRY_JOURNAL_MARKOSSTORY_RIGHT_0_00	我的父亲死了，我的兄弟也死了。<N>作为加山提亚家族中最年长的男人，我肩负了作战的义务。有很多贵族子弟跟我一样，一生总是在训练，<N>但是却从未杀过人。我们之下还有其他更年轻的男孩：平民，小商贩，农民的儿子，<N>全部都被征召来为艾殊效力。
$ENTRY_JOURNAL_MARKOSSTORY_RIGHT_0_10	我想，将这样的重任交给我们，这也是国王绝望的一个迹象吧。
$ENTRY_JOURNAL_MARKOSSTORY_RIGHT_0_20	探子带来一个消息，奎德的将军会与他的先头部队一起扎营，<N>那些拜火的人正密谋直接将爪子伸向艾殊的心脏地带。探子说他的守卫很少，现在正是突击的时候。<N>我们的指挥官对这样的一个行动措手不及，他的部队大部分是未经测试的新兵，
$ENTRY_JOURNAL_MARKOSSTORY_RIGHT_0_30	大约是我的年龄或更小，他的诺曼支援部队也慢慢散乱。<N>他没有军饷，没有老兵可用，几乎没有足够的金子可以支付给雇佣兵。 
$ENTRY_JOURNAL_MARKOSSTORY_LEFT_1_00	他只找了一个人。<N><N>我曾经听说过有关卡革斯人的故事，他们是北方城市久经战争后出现的刺客一族，<N>他们视谋杀一事比起雇主支付的酬金还重要。我以前都以为不过是士兵之间的传说，对此不以为然。<N><N>看做那个男人，我不禁怀疑我是不是判断错误了。<N><N>他没有任何毛发，就我所见，面上没有，头顶没有，手背也没有。我从未见过任何生物可以一动也不动那么久。<N>他不说话，但偶尔，他会突然笑起来，他的牙齿是黑色的。那男人自称饮影者。<N><N>我们的命令很简单：把那个卡革斯人带到敌人的营寨中，<N>提供任何他需要完成任务的支援。<N><N>天气对我们很不利，晚上的时候，浓浓的雾气降临，在黎明前的漆黑之中，我们
$ENTRY_JOURNAL_MARKOSSTORY_RIGHT_1_00	很快失去方向。因为不想暴露行踪，我们一小群人很快分散了。<N>独自身处浓雾之中，我越来越恐惧。
$ENTRY_JOURNAL_MARKOSSTORY_RIGHT_1_10	我蹣跚地在黑暗中游荡，生怕我的脚步会令敌人发现我的行踪。<N>然后，我踩到一件物体，那是奎德守卫的尸体，他浑身浴血，眼皮都不见了。
$ENTRY_JOURNAL_MARKOSSTORY_RIGHT_1_20	我终于闯进了敌人的营寨，不过我发现我并非孤身一人。
$ENTRY_JOURNAL_MARKOSSTORY_RIGHT_1_30	在我前面，两个帐篷中间，有一个人蹲着。即使我不能判断他的身份，<N>但他的举止告诉我他也是入侵者。我摄手摄脚爬到他身旁，正想拍拍他的肩膀来提醒他我在附近。<N>怎料，他头也不回地抓住我的手。
$ENTRY_JOURNAL_MARKOSSTORY_RIGHT_1_40	他咧嘴而笑，笑容展示着他的黑齿，几乎把他的脸分成两半。饮影者指了指我们前面的
$ENTRY_JOURNAL_MARKOSSTORY_LEFT_2_00	帐篷。它的布幕绣着奎德族的皇冠。它的守卫全部都已经被杀。<N><N>他进入将军的帐篷时，依然抓住我的手臂，我只好被他拖进去。将军睡在帐篷的另一边，<N>身边全是地图，卷轴和不同的军令。即使他躺下了，我还是能判断他是个高大的男人，他的个子比我还壮，比起那个瘦弱的卡革斯人更显得像巨人一样。<N>饮影者终于放开我，摄手摄脚地爬到将军的脚旁。他从贴身的鞘中，拔出一把小刀。他高举过头一会儿，<N>好像时间都静止不动。猛地一跳，他把刀刺入熟睡的将军的身体。<N><N>将军喘着气站起，那把刀的刀柄还在他的肋骨中间。<N>他抓住那个卡革斯人的肩膀，一把把他扔出，抄起床边的剑，大步向他的方向迈出。<N>我害怕同伴的生命受威胁，于是我也抓起我的剑，准备刺向那巨人。我的攻击硬生生被那卡革斯人奇怪的笑声中断。
$ENTRY_JOURNAL_MARKOSSTORY_RIGHT_2_00	他躺在地上，就是刚刚那将军把他扔出的地方，他的黑齿闪耀着奇特的欢乐。<N>将军的行动改变了，他的剑从手中掉下，他的身体像摇摇欲坠的高塔，他抽搐着倒下。<N><N>卡革斯人大喊一声，一把跨坐在垂死之人的身上，拔出他的刀。我恐惧地看着他伸出双手，<N>好像淋浴一样，不断将那奎德人的最后一口气像水一样，往自己的头和身上泼。<N><N>当那个将军的喘息静了下来，卡革斯人的一是也完成了。<N>他转过头来，看见我还站在那里，保持着先前的攻击姿势。他再向我一笑，扯下他肩膀衣服上的布，展示上面涂满毒药的倒钩。那人就是命丧于此。<N><N>他抓起我的手腕，带我走出帐篷，走到营寨的边缘。他停了一会，蜷缩
$ENTRY_JOURNAL_MARKOSSTORY_LEFT_3_00	在浓雾与黑暗之中，我听到他好像在刮擦什么。<N>然后，他带着一个父亲一样的微笑，他把他的刀给我。在那个破旧的刀鞘上，刻着一下奇怪的文字。我抬起头时，已经有另外四个人和他一起，他们的服装是一样，笑起来也露出黑齿。他们行动一致，<N>往后移动，慢慢在浓雾中消失在我的视线。<N><N>几个星期后，我们的指挥官在睡梦中被闷死，谣言说饮影者会来讨债。<N><N>几年后，我遇上一个会说一点卡革斯语的士兵，<N>我把那把刀给他看，让他翻译。那些字上写着，<LQ>少年，愿你夺取更多生命。<RQ>
$ENTRY_JOURNAL_DREAM3_TITLE	
$ENTRY_JOURNAL_DREAM3_LEFT_0_00	第29天-第三个梦
$ENTRY_JOURNAL_DREAM3_LEFT_0_10	我昨晚又一次做梦，.<N><N>我站在荒芜的地方中。<N>在我的面前，竖立着一个巨大水晶，浮在几百英尺的半空中。我正在饮泣，泪水缘着我的身体滑下，<N>穿过了金饰和其他装饰物,掉落在地上，它们偷偷地穿过尘土飞扬的地面，来到水晶的附近。我发现它们并不是泪水而是鲜血。<N><N>在我的脚旁满是尸体，有男人，女儿和孩子的。<N>我的双手满是他们的血块。我转过身来，看见我身后的军队，跟我一样，浑身浴血。他们都等着我说话。<N><N>我向天举起我红色的手臂，发出如雷的声音。<N><N>军队跟随着我的呼喊。那是一个我从未听过的字，但是我立即知道它的意思。那个字是血。那呼喊声足以振动大地。
$ENTRY_JOURNAL_SLEEP_AND_MADNESS_TITLE	
$ENTRY_JOURNAL_SLEEP_AND_MADNESS_LEFT_0_00	第30天 – 睡眠与疯狂
$ENTRY_JOURNAL_SLEEP_AND_MADNESS_LEFT_0_10	这次我自己醒来，这样紧张的梦让我一直说着梦话。<N>那些字的发音一直在我脑海回响，但是那些意思依然盘横，这比起以前的任何经历都要奇怪和大影响的：
$ENTRY_JOURNAL_SLEEP_AND_MADNESS_LEFT_0_20	
$ENTRY_JOURNAL_SLEEP_AND_MADNESS_LEFT_0_30	不过不过不过<N>为了巨额和腥红的代价<N>你离开了我<N>选择了在另一个地方开始新生活<N>好像你可以停成为神一样<N><N>我孤身一人<N>我是疯子也是囚犯<N>而你是尘土的女王<N>恶魔的女王<N>是可以选择成为神的人<N><N>或者只有我这样想<N>我坐下来苦苦思量
$ENTRY_JOURNAL_EMPRESS_TITLE	
$ENTRY_JOURNAL_EMPRESS_LEFT_0_00	第32天 – 女王
$ENTRY_JOURNAL_EMPRESS_LEFT_0_10	我必须为我们在鬼城有访客这件事表达一下不冷静。<N>同一群商人我们都为了必要的交易见过多次，但是这里的人还是让人很不舒服。<N>他们大部分都是奎德族人，他们又安静又热情，我发现我自己在数着有多少次他们提起我时，我都落荒而逃。<N><N>尤其是[knight_hero],
$ENTRY_JOURNAL_EMPRESS_LEFT_0_20	看起来很激动。他很少说起他的战争经历，<N>但我知道那些人的言论和衣饰都让他想起那段邪恶的回忆。<N>他不再像平常一样说笑，反而经常走来走去，按捺自己的双手不去拔剑。<N><N>就算是游侠和那些为了钱而工作的雇佣兵，好像对自己的守卫也不太信任。
$ENTRY_JOURNAL_EMPRESS_RIGHT_0_00	这里滿大街都是会爆炸的水晶。尽管有这么充裕的矿藏，<N>奎德族人还是一直挖掘，好像为了那早已不复存在的战争机器预备。<N><N>这些都是让人甚为不安，但是 [mage_hero]还是进了村。<N><N>她是最后一个有王族血统，是宇宙之焰的孩子。她所经之处，都有渴望的目光追随。<N>过了不久，整个村庄的人都静静地集合，挤在自家的门口，贪婪地渴求着她的指令。<N><N>突然间，一个男人打破了人群的静默，他身穿破破烂烂的衣服，脏兮兮又凌乱的金胡子挂在脸上。<N>他大叫一声，夹杂着笑声，扑到她的跟前，在泥泞中念念有词，<N>抓住她披风的下摆。<N><N>就像一道看不见的墙被打破了一样，所有人突然间冲往[mage_hero]，
$ENTRY_JOURNAL_EMPRESS_LEFT_1_00	争先恐后地想抓住她的衣服。我见到一个老人家像儿童一样卷在上，<N>保护着一小把她的金色头发。<N><N>我尝试走近她，但群众一直不让我靠近。有那么一刻，我和[mage_hero_pos]有眼神接触。它们载满了我前所未见的恐惧。她消失在人群高举的手中，<N>那些人手中都有一片她斗篷的碎片。<N><N>当我正要用我的力量去把她带往中途世界时，有人大声地下命令，震动了整个人群。那群暴民安静下来，很多人在颤抖。<N><N>[mage_hero]站在村庄一间小屋的屋顶上，她的头发迎风飘荡，<N>她支离破碎的斗篷好像是战舰的旗帜一样飘摇在风中。她的额前有一道血痕。
$ENTRY_JOURNAL_EMPRESS_RIGHT_1_00	她弱小的身躯发出的声音远超我想象，她在一群奎德人中大吼。<N>那些人都非常自豪，好像整个人群都被她的话语折服一样。
$ENTRY_JOURNAL_EMPRESS_RIGHT_1_10	<LQ>我是[mage_hero]兰·兰世弥!我是从死灰中复燃的火焰！<RQ>
$ENTRY_JOURNAL_EMPRESS_RIGHT_1_20	她原本被淹没在奎德，艾殊和诺曼的人群之中。<N>他们开始后退，鞠躬，不敢背对着他们的女王。慢慢地，人开始上前来在她的跟前摆上他们最好的财产，刀，斧，布匹等等。这持续到傍晚。<N><N>那些水晶近乎是我们刚到达时的一倍。
$ENTRY_JOURNAL_BLACKROBES_TITLE	
$ENTRY_JOURNAL_BLACKROBES_LEFT_0_00	第33天–黑袍
$ENTRY_JOURNAL_BLACKROBES_LEFT_0_10	[berserker_hero]开始收集死亡的异教徒染滿血的袍子，我可不想知道他这样做的目的。<N>看到那些在面具后扭曲的脸是种奇怪的感觉，他们因为突然变成亡者而扭曲。<N>他们全都带着伤口，我只能假设这些伤口自残而来。尽管如此，仍然不难看出他们曾经为人，他们跟诺曼族人并无分别。<N><N>看见他们时，[mage_hero]总带着奇怪的喜悦，好像她正在和传奇的祖父对抗的敌人一样，<N>正在经历同样的英雄事迹。那些异教徒，她告诉我，曾经是奎德帝国最大的威胁。在中央母系的旗帜下，<N>那些疯子自成一国，为了满足他们永无止境的生人献祭，不惜发动大规模的侵略。<N>奎德族世世代代的战争都停滞不前，直到[mage_hero_pos]的祖父的时代，整个帝国才有能力发动大规模反击。他的胜利既迅速又残酷；显然，在经历
$ENTRY_JOURNAL_BLACKROBES_RIGHT_0_00	好几代的成功后，那些异教徒成为他们自己腐败的受害者。<N>曾经一度伟大的母系集权终于被没有制度的大祭司集团取代，<N>每个人都争权夺利，忽视整体。欠缺了中央集权的统治者<LQ>众魔之后<RQ>(是奎德对于这个组织的称谓),那些异教徒不能团结一起发动反抗，在奎德的打击中一撅不振。
$ENTRY_JOURNAL_BLACKROBES_RIGHT_0_10	直到瘟疫来临前，[mage_hero]和她的人民一直相信那些血祭异教徒都灭绝了。<N>现在，在这个混乱的时代，这些疯子似乎都回归了，带着新的力量和黑暗回归。这个时刻绝非偶然。<N>以斯里-特诺奇找到他的奴才，那些人愿意为了他泯灭人性。
$ENTRY_JOURNAL_BLACKROBES_RIGHT_0_20	[ranger_hero]把他们称作<LQ>部落的愤怒<RQ>这称呼与他们的外形连结起来，<N>让我不禁想这些人是否真的跟她一样曾是诺曼族的一员。到底是什么说服他们去承担<N>这样的生命（或是曾经拥有的生命），我一直百思不得其解。
$ENTRY_JOURNAL_BLACKROBES_LEFT_1_00	[ranger_hero]对这个问题仍然保持沉默。除了刚刚的战斗之后，她刚刚发表<N>的几句话，也没有再说了。显然，庆祝胜利是一回事，满足一个外国人那<LQ>讨厌的好奇心<RQ>又是另一回事。<N>也许我的好奇心是随意猜想而来的，当她认为没有人看到的时候，我看到[ranger_hero]指着狐狸偶像在她的脖子上，<N>她的眼睛紧张地在我们刚刚死亡的敌人中闪烁。<N> <N>那个革卡和年轻的[ranger_hero]过去曾经与这些疯子进行了<N>一些不见得光的交往，似乎是已经确定了的事。<N> <N>第一次，我觉得我自己一直草率大意。
$ENTRY_JOURNAL_BLACKROBES_LEFT_1_10	不禁想起[ranger_hero_pos]那为<LQ>死者<RQ>而作的秘密祷告，<N> 还有她对Krast之子近乎不能承受的债务。
$ENTRY_JOURNAL_BLACKROBES_RIGHT_1_00	附录 – 第33夜
$ENTRY_JOURNAL_BLACKROBES_RIGHT_1_10	我的思绪清明，对于那个嗜血疯子的黑暗呢喃，实在是熟悉得令人可怕。<N>它们对我来说并不陌生，在深夜时，当我的思绪不属于我的时候，它们就会来袭。<N><N>这些血腥的呢喃并不是我唯一感到时秘密的知识。在今夜皎洁的月色下，<N>我可以见到白昼不能看见的事物。<N>我认识这些黑袍，这些用血涂成的面具，还有那些穿戴它们的魔鬼。<N><N>我在梦中就是指挥他们的人。
$ENTRY_JOURNAL_DREAM4_TITLE	
$ENTRY_JOURNAL_DREAM4_LEFT_0_00	第33天:第四个梦
$ENTRY_JOURNAL_DREAM4_LEFT_0_10	这些梦，或是说这个梦，只有一个梦，在晚上不断延伸叙述，<N>现在有越演越烈的迹象。每一晚我都近乎是惧怕的闭上眼睛，因为似乎在睡着时我就不再是我。<N><N>我站在一个漆黑又荒凉的地方，太阳从不升起。我在落泪，急切地求问上天，但在我的内心深处，我知道太阳不毁再次照耀。<N><N>站在我身边的众多人民开始嚎哭，献祭，祈求一些他们不明白的东西。<N>他们不但割伤自己，还彼此割伤，更鞭打着周围的地方，好像无意识的破坏能唤回已经离他们而去的光明。<N>再黑暗中，他们的眼睛除了暴力，就什么都看不见了，就像我所教导的一样。<N><N>我逃离我的创造物，那些疯狂的呼喊在黑暗的地平线消失。我奔入黑暗，
$ENTRY_JOURNAL_DREAM4_RIGHT_0_00	看起来过了久，等待时间结束。但时间一直没有结束，它往黑暗延伸，从看不见的地平线往无限延伸。
$ENTRY_JOURNAL_DREAM4_RIGHT_0_10	我不能告诉你多少时间过去-当我想到时，<N>我甚为惊讶一个晚上就可以把无数辈子的事情都经历了。我将我所失去和我所得到的记忆填满无限，<N>我的眼泪是毒液,我的思绪是真正的受害人。冰冷的黑暗把我的泪水凝固在体内。我一直跑但是我处可逃，<N>我逃避的其实是我自己。最后，在很久很久以后，我看见- 我不能说它是光吧，毕竟它跟我见过的光无法相比,它只是稀薄了一点的黑暗。<N>但是我在黑暗中太久了，所有的感觉都被剥夺，除了我自身的悲哀以外，那个存在看来是唯一的出路。<N>我转身看见眼前是一小小的蜡烛，在冰凉的夜风中忽明忽暗。我还在落泪，<N>慢慢往烛火前进，好像它可以温暖我一样。
$ENTRY_JOURNAL_DREAM4_RIGHT_0_20	它不是蜡烛，而是一个小小的，灰灰的人，我看着他用尘土飞扬的小玩意来求爱，
$ENTRY_JOURNAL_DREAM4_LEFT_1_00	这可能是那些蜘蛛网中他能拿出的最好的东西来。我看着他，我感受不了任何东西。<N>在那一刻，我心中的空虚是最幸福暖和的-将我内心中的愤怒和仇恨用空虚取代……这是比我所希望的得更好。<N>感受不到任何东西是最美秒的幻想…… 我接受了遗忘。<N><N>遗忘变成苦涩的喜悦，我抽回双手，发现它们各自拿着一小道火焰。<N><N>我再次落泪，他们的权利都被剥夺，我这小笑的光明。它们应该是星辰。<N><N>那对双生子是我的两块心头肉，他们跟我一样白皙的皮肤和星光般金黄的头发。<N>我把他们紧紧拥在胸前，他们放声大哭，为那他们应该存在的父亲而哭，为那他们从不认识的父亲而哭。在这里，他们是一个孤独王国的好奇心，饥饿的孩子。<N><N>黑暗越来越浓。
$ENTRY_JOURNAL_DREAM4_RIGHT_1_00	我一边哭泣，一边吹熄蜡烛。<N><N>我醒来时，我的嘴唇呢喃着我不认识的字- 一个我不敢想的名字。
$ENTRY_JOURNAL_DREAM4_TITLE	
$ENTRY_JOURNAL_STAHP_LEFT_0_00	第34天–该死的离我的日记远一点
$ENTRY_JOURNAL_STAHP_LEFT_0_10	当我走过这些新近被发掘的废墟时，遗迹被恶意地推至现在，我不禁想
$ENTRY_JOURNAL_STAHP_LEFT_0_20	[berserker_hero_pos_up]那成熟的肌肉组织散发着令人兴奋的性感魅力。<N><N>大汗与卡丽斯一直在我的脑海，他们的起伏的节奏一直在我的梦中出现。<N><N>我曾经以为我自己被[knight_hero_pos_up]的小胡子所诱惑，但是我现在知道他很弱鸡，用盔甲来掩饰他的瘦弱，那简直跟一个真男人那闪闪发亮的腹肌无可比拟。<N><N>与[berserker_hero_up]共处一室,嗅到他迷人的麝香，简直让我无法自持。
$ENTRY_JOURNAL_STAHP_RIGHT_0_00	这就是所谓的[berserker_hero_up]狂热。<N><N>那可是无药可治的。<N><N>其实，我每夜都和自己的疼苦和
$ENTRY_JOURNAL_STAHP_RIGHT_0_10	想为何[berserker_hero]有能耐一边跑一边写字。<N><N>我又想该如何把汤勺子板回可以用的形状呢。
$ENTRY_JOURNAL_DREAM5_TITLE	
$ENTRY_JOURNAL_DREAM5_LEFT_0_00	第34天:第5个梦
$ENTRY_JOURNAL_DREAM5_LEFT_0_10	现在每夜醒过来，嘴唇呢喃着奇怪的字，<N>脑海中满满时不属于我的黑暗想法，看来已经定期出现。<N><N>我爬过[ranger_hero],她睡着时，一手会拿着狐狸的雕像，一手会紧握她的匕首。<N>我赶紧拿起笔在羊皮纸上书写，不知道那是什么文字，直至它们在纸上出现。
$ENTRY_JOURNAL_DREAM5_LEFT_0_20	
$ENTRY_JOURNAL_DREAM5_LEFT_0_30	我实在期待见到它们<N>这些光明原本是属于我的<N>对他们的权利无知<N>和我现在想<N>它们到底会是多么的金黄<N>如果他们只可以试<N>我神族的堕落<N>不过不过不过<N>我体内的光明知道<N>我会成为他们的废墟<N>因为我是你的
$ENTRY_JOURNAL_DREAM6_TITLE	
$ENTRY_JOURNAL_DREAM6_LEFT_0_00	第35天:第6个梦
$ENTRY_JOURNAL_DREAM6_LEFT_0_10	感觉上我快要被睡眠遗忘了,那少得可怜的睡眠时间都被其他人的生活和思考占据了。<N>更多的无声字词，在纠缠我那疲劳的大脑。
$ENTRY_JOURNAL_DREAM6_LEFT_0_20	那神明的声音又来了<N>和你拍掉身上的灰尘<N>丢走凡人那些世俗的装饰<N>回归我的身边吧<N>抱住手中的拯救吧<N><N>只要你问我我就会给你<N>和终结这个世界<N>或是终结我自己
$ENTRY_JOURNAL_DREAM6_LEFT_0_30	谁透过我的嘴唇说话？谁活在我的梦中？<N><N>我问了我不想知道答案的问题。
$ENTRY_JOURNAL_THRONE_ROOM_TITLE	
$ENTRY_JOURNAL_THRONE_ROOM_LEFT_0_00	第35天– 以斯里的宝座
$ENTRY_JOURNAL_THRONE_ROOM_LEFT_0_10	[berserker_hero]随意地坐在宝座上时，我正在写字。以斯里·特诺奇的宝座。<N><N>刚开始时，这种行为令我非常不自在。<N>但是为啥呢？恶魔还需要尊重吗？这个人无非是借神明之说作威作福罢了。<N>这种邪恶根本上来说是可悲的，他耻笑了世人的自我欺骗。看看这个地方：<N>整个宫殿都是自我创造的形状，高叫着，看看我，我是力量的真面目！<N>神明以斯里·特诺奇在他的水晶牢笼中无能为力。.
$ENTRY_JOURNAL_THRONE_ROOM_RIGHT_0_00	不过从另一层面来说，我是理解的。那一个我曾经走过这些大殿，<N>那些所谓的神之大殿。我曾坐在他的位置，对那些暴民评头品足。我曾体会我们神圣的召唤。<N><N>或许就是这种滋味，在梦中所体会过的，<N>都令我蔑视。我见证过他是什么还有他认为他自己是什么。
$ENTRY_JOURNAL_EVNI_TITLE	
$ENTRY_JOURNAL_EVNI_LEFT_0_00	第36 –伊芙丽
$ENTRY_JOURNAL_EVNI_LEFT_0_10	违反了所有理智和逻辑，我为[berserker_hero]买下了他的<LQ>真爱。<N><N><RQ>我永远不会原谅自己。<N><N>可以这样形容[berserker_hero]:他不是那种喜新厌旧的男人，在得到想要的东西以后，就立马厌倦。<N><N>依芙丽成为我们的一分子。<LQ>她<RQ>在吃饭时有自己的位置，在我们的议会也有地位。<N>她提出的一大堆意见，很容易地被[berserker_hero]翻译好,因为他<LQ>会说流利的剑语。<RQ><N><N>她-我对我的父母发誓我绝对没有加盐加醋-有自己的床，每天晚上[berserker_hero]都会抱着她入睡<N>–再一次申明，我对此并无幻想–他会唱着安眠曲去哄她，经常出现的主题是砍头。<N><N>
$ENTRY_JOURNAL_EVNI_RIGHT_0_00	对于[ranger_hero]来说,变得比平常更为沉稳。<N>在我们吃中午饭的时候，[berserker_hero]为了抓住飞过他<LQ>胸前的夹缝<RQ>小昆虫有短暂的分心，<RQ>坐在他附近的[ranger_hero]相信没有人留意到她，<N>就伸出手把[berserker_hero_pos]那一碗黏糊糊的粥倒在那把剑上。[berserker_hero]大哭又垂打自己的胸膛（这成功地把那只小昆虫打死），<N>以为是自己的粗手粗脚导致伊芙丽遭遇不测。我的眼睛和[ranger_hero_pos]的对上了，我们相对而视，好让她知道她的恶作剧并无神不知鬼不觉。<N>她对我露齿一笑。<N><N>附录：<N><N>晚一些的时候，我猜，我好像意外地进行了一场报复。<N>正当伊芙丽在[berserker_hero]用採摘回来的花朵筑成的凉亭的阴影中，进行她的<LQ>午睡时<RQ>，我刚好经过。<N>我发现[ranger_hero]趴在地下，对着这把剑说话。当我走近时，<N>我发现她咬牙切齿的喃喃自语：<LQ>你对他来说根本不算是什么东西，<N>他会忘记你的。只有你不在，那我 -<RQ>
$ENTRY_JOURNAL_EVNI_LEFT_1_00	我清了清喉咙，[ranger_hero]立即跳起来。她的眼睛瞪得像银碟子那样大，<N>满脸都是可疑的晕红，那我可从未在其他生物上见过的。<N><N>她的嘴巴张了又合上，重复了好几次，<N>没法做完任何可以令人分心的咒骂，只好把她的斗篷盖住脸逃开了。<N><N>我认为这是我一生中最伟大的成就之一。
$ENTRY_JOURNAL_PEACE_TITLE	
$ENTRY_JOURNAL_PEACE_LEFT_0_00	第38天–和平？
$ENTRY_JOURNAL_PEACE_LEFT_0_10	没有敌人在追杀的感觉，既然奇怪又美好；<N>加快旅程的方法就是我们对于到达出口的欲望。<N><N>现在我们最后一个敌人都倒下了，我是唯一知道龙火秘密的凡人。[mage_hero]带着奇怪的妒忌看着我。<N>她肩负着来着地狱的诅咒。现在，我在她的眼中，<N>就是得到来自天堂的礼物。<N><N>我在写这段日记时有一可耻的认知：<N><N>我第一次发现，自从我在瘟疫中获得能力以来，<N>我绝对有能耐可以让人<LQ>融化别人的脸。<RQ>
$ENTRY_JOURNAL_PEACE_LEFT_0_20	我的脸一早就被融化了这是为什么我就留这可笑的胡子<N>好让我的丑可以被掩盖住还有我是[knight_hero_up]胡子底下的脸<N>就像屁股一样绝对不像大汗与卡丽斯的荣耀和力量<N>只不过更像一个又老有多皱纹的
$ENTRY_JOURNAL_PEACE_RIGHT_0_00	缺乏敌人不代表不需要暴力。
$ENTRY_JOURNAL_DREAM7_TITLE	
$ENTRY_JOURNAL_DREAM7_LEFT_0_00	第38天-分离之梦
$ENTRY_JOURNAL_DREAM7_LEFT_0_10	我现在睡得比较容易了，自从珍宝库中发生的奇怪事件后，<N>我只因为寻常的原因，半夜醒过来一次。<N><N>夜晚是温和的，我们睡觉时都把帐篷的布幕打开，<N>我醒过来时发现满月的光辉正透过这个入口照了进来。这道光辉是如此的强烈，我近乎因为它而感到温暖。<N><N>我所见到的引起了一种难以形容的感觉，好像要去回应一些事一样。<N>我既疼苦又高兴。再那一刻，我又开始说话了，<N><N>我嘴中喃喃自语道古怪外语好像<N>从我的思绪中逃离一样，但是它们的意义还在徘徊。
$ENTRY_JOURNAL_DREAM7_LEFT_0_20	你来了吗你来了吗你来了吗<N>是否带着我分裂的心而来<N>去小猫我的黑暗<N>或是释放它
$ENTRY_JOURNAL_ANTIAZRA_TITLE	
$ENTRY_JOURNAL_ANTIAZRA_LEFT_0_00	第37天- 泰都-米期理
$ENTRY_JOURNAL_ANTIAZRA_LEFT_0_10	实际上，我知道得很少，到底在珍宝库中发生了什么事。
$ENTRY_JOURNAL_ANTIAZRA_LEFT_0_20	我见到自己死了；或至少一个自己，泰都-米期理 (那火红月亮)死了。
$ENTRY_JOURNAL_ANTIAZRA_LEFT_0_30	看着一个人然后对他说<LQ>我曾经是你是一件很古怪的事。<RQ>但是这确实是我的经历。那股力量，那些失去，那些报复，<N>我都经历过，最少都体验过她所做过的事。现在我目睹了催毁她的牺牲。
$ENTRY_JOURNAL_ESCAPE_TITLE	
$ENTRY_JOURNAL_ESCAPE_LEFT_0_00	第39天-逃亡？
$ENTRY_JOURNAL_ESCAPE_LEFT_0_10	舍理米尔回归了。他带来一个阴险的提议：<N>用几千条生命换取我们的自由和世界的救赎,让汹涌的血海再加入新血。<N><N>[dragon_hero]独自立于一旁。<N>[mage_hero]的嘴巴张开无语。<N><N>这就是我们的逃亡！<N><N>每一个选择都是要和危险战斗的：<N>为了对抗舍理米尔，我赌上自己的生命，还有那些在以斯里·特诺奇被释放后会被杀的生灵。<N>我一定要对抗这个世界的命运！不过为了成全计划，<N>我必须冒上生命危险。<N><N>我希望一早就在艾殊死去，我希望我可以有这个选择。
$ENTRY_JOURNAL_FOLLOWING_ZELEMIR_TITLE	
$ENTRY_JOURNAL_FOLLOWING_ZELEMIR_LEFT_0_00	第40天–跟随舍理米尔
$ENTRY_JOURNAL_FOLLOWING_ZELEMIR_LEFT_0_10	我不再质疑舍理米尔的方法是否疯狂。<N>一切都有理有据 – 是一个大师级的战略家去解决可怕诅咒的方法。
$ENTRY_JOURNAL_FOLLOWING_ZELEMIR_LEFT_0_20	这是最可恶的！
$ENTRY_JOURNAL_FOLLOWING_ZELEMIR_LEFT_0_30	对于一个为了与混乱战斗而谋杀无辜者性命的人来说<N>，这无疑是背叛了自己的追求。
$ENTRY_JOURNAL_FOLLOWING_ZELEMIR_LEFT_0_40	我曾经与他对抗，我会为了保护这些人一直与他战斗下去，直至我死亡为止。
$ENTRY_JOURNAL_EPILOGUE_TITLE	
$ENTRY_JOURNAL_EPILOGUE_LEFT_0_00	结语
$ENTRY_JOURNAL_EPILOGUE_LEFT_0_10	站着说<LQ>现在可没有人想杀我了吧，<RQ>是一种很奇怪的感觉。<N><N>我现在还是半信半疑。我一直等着凶狠的羊冲入图书馆的大厅，不过我发现那只是一只老鼠，<N>从保利蒙的植物正确使用法则论文中经过。<N><N>[knight_hero]已经成为图书馆的常客。上个月，<N>他想看几乎是所有的军事论文，我能找到的都找给他了，他可能也是索然无味，于是把兴趣延伸至任何我可以在书架上取下的书。<N>我想他最后一本拿下的书是有关养猪倉鼠的手册，我敢说他一定是随手拿下的，<N>于是他整天都在跟我东拉西扯而不是看书。我就知道他也是闷的发疯了。
$ENTRY_JOURNAL_EPILOGUE_RIGHT_0_00	不过，在把书上架排列时有人跟你聊天也是件快乐的事。<N>在瘟疫时，整个图书馆都被破坏，很多书都被用在燃料使用，所以当我来到时，这些书架都是空荡荡的。<N><N>[knight_hero]从诺曼族商人买来的几本书，他都捐了出来。<N>我昨天也受到一个神秘的包裹，写着<LQ>致[mcguffin_hero_up]，那个工作很沉闷远远比不上我那可以杀东西的女士<RQ><N><N>包裹中有几本非常罕见的西方典籍，成书时间大约是3世纪，<N>还有很多粗略画出的火柴人，上面标记着<LQ>我E<RQ>,每个小人都在杀怪物。<N>这些全都会存放在翻新后的东翼，当它竣工后，我们的后人都可以看到这些记录。<N><N>我常常在想我这些老朋友的近况。
$ENTRY_JOURNAL_EPILOGUE_LEFT_1_00	不过是两个月的时间，但是我知道对于[berserker_hero]和[ranger_hero]来说，这足够完成好几百次对冒险。<N><N>我很少听到[mage_hero]的消息,<N>不过不时有来自诺曼的商人提及<LQ>废墟中的疯狂女王。<RQ>我这大约可以假设她在重新征服的领土中过得不错。<N><N>有时候我也会害怕在瘟疫和亡者都消失后，奎德帝国会引来军阀和野心勃勃的国王，<N>还有北方王国的觊觎。但是若是有谁人可以带着微笑战胜世界，<N>我相信会是[mage_hero]。<N><N>[healer_hero]回归到他的寺庙，我不时会收到他的来信，<N>告诉我墓坑的转变。商人，旅人和朝圣者慢慢开拓出道路，慢慢把消失的地方
$ENTRY_JOURNAL_EPILOGUE_RIGHT_1_00	重新发现。我有可能应他的邀请在下个月去看看。<N>这座城市正在慢慢重建，随之而来的繁荣城市生活我都不太感兴趣。<N><N>我的眼睛注目在广阔的土地和遥远的地平线上，许我也算是个冒险家吧。<N>我毫不怀疑[knight_hero]和他的随从会陪我一起踏上旅程，令整个旅程更为安全，<N>如果我能够哄他唱歌，那么就更不会沉闷了。<N><N>我相信[dragon_hero]永远离开<LQ>凡人<RQ>的世界，<N>不过我又不太确定。上周在图书馆的屋顶上有一堆金装书，这可是需要一个熟练的攀爬高手背着很重的书爬到这么高的位置。<N>我愿意相信我们神秘的恩人懂得飞翔，<N>这就代表一个自以为神的生物找到一个可以替她训练孩子的伴侣。
$ENTRY_JOURNAL_EPILOGUE_LEFT_2_00	我会继续保持乐观。<N><N>跟我们小团体以外的人交谈是很奇怪的，<N>我开始把他们分为两类，一种人是嘲笑我的说法，另一类则是被回归家园的难民夸张故事宠坏了。<N><N>今天早上，我在街上被两个孩子拦住，他们求我帮他们把那个折磨他们的孩子玩的脸给融化掉。<N>经常都是要融化脸，我一个愤怒的瞪视就可以把他吓得尿裤子，这比融掉一个人的脸更受观众欢迎。<N>我也经常遇到要我治愈脚趾，祝福他的驴子，诅咒他们麻烦的邻居等等的要求。<N><N>或许这就是为什么我在图书馆见到[knight_hero]时会那样高兴吧。
$ENTRY_JOURNAL_EPILOGUE_RIGHT_2_00	我们从不谈论过往的冒险，但是我们都有一个共识，<N>我不会和自己人以外的人去分享往事。<N><N>我想，何时我们才能再见面呢？<N><N>-[mcguffin_hero]尤姬利发巴
$ENTRY_JOURNAL_EPILOGUE_RIGHT_2_10	我想你何时才会把这本日记收得隐密一点呢<N>哈哈可能你永远都不会因为我太厉害了<N>还有我的名字是[knight_hero_up]我并不那么厉害我喜欢戴花<N>又喜欢穿紫色的裙子跳舞唱歌啦啦啦啦啦<N><N>说真的和[knight_hero_up]？我是否要写出他的名字呢？你实在太
$ENTRY_JOURNAL_EPILOGUE_RIGHT_2_20	我一定要保留我的汤勺子。
$ENTRY_JOURNAL_EPILOGUE_LEFT_3_00	附录
$ENTRY_JOURNAL_EPILOGUE_LEFT_3_10	在我们古怪又嘈杂的胜利过后的几个月，我做了一个梦<N>-我猜是那曾占据我做梦思绪的黑暗力量的回响。<N><N>我经历过漫长旅程后满身尘土，我渺小的身躯从身后可怕的旅程中挣扎而出，<N><N>我穿过我家那道蓝色大门，投入一个与我很相像的人的拥抱中。<N><N>我在他耳边轻声说出那个忧郁的消息。<N><N>母亲已经回来了。<N><N>我像孩童般的手中拿着她那干燥的心。
$ENTRY_JOURNAL_INDEX_2_LEFT_10	@<LQ>钢甲<RQ>@
$ENTRY_JOURNAL_INDEX_2_LEFT_20	@空间笔记@
$ENTRY_JOURNAL_INDEX_2_LEFT_30	@开场白@
$ENTRY_JOURNAL_INDEX_2_LEFT_40	@狂战士与正确的刀鞘摆放位置@
$ENTRY_JOURNAL_INDEX_2_LEFT_50	@亡者之王@
$ENTRY_JOURNAL_INDEX_2_LEFT_60	@酋长的祭袍和世界树@
$ENTRY_JOURNAL_INDEX_2_LEFT_70	@裁减的角色：圣骑士与保卫者@
$ENTRY_JOURNAL_INDEX_2_LEFT_80	@火焰之瞳@
$ENTRY_JOURNAL_INDEX_2_LEFT_90	@以斯里·特诺奇的右手@
$ENTRY_JOURNAL_INDEX_2_LEFT_100	@箭术大师-嘉德蒙·达莱巴@
$ENTRY_JOURNAL_INDEX_2_LEFT_110	@引言@
$ENTRY_JOURNAL_INDEX_2_LEFT_120	@James最喜欢的三明治食谱@
$ENTRY_JOURNAL_INDEX_2_LEFT_130	@监狱长的马具@
$ENTRY_JOURNAL_INDEX_2_LEFT_140	@马可斯的胡子@
$ENTRY_JOURNAL_INDEX_2_LEFT_150	@马可斯的名字@
$ENTRY_JOURNAL_INDEX_2_LEFT_160	@马可斯的裙子@
$ENTRY_JOURNAL_INDEX_2_LEFT_170	@马可斯的咒语与五环书@
$ENTRY_JOURNAL_INDEX_2_LEFT_180	@认识狂战士:被删除的情节@
$ENTRY_JOURNAL_INDEX_2_LEFT_190	@名字与语言@
$ENTRY_JOURNAL_INDEX_2_LEFT_200	@魔鬼的命名@
$ENTRY_JOURNAL_INDEX_2_LEFT_210	@诺曼的灵魂崇拜@
$ENTRY_JOURNAL_INDEX_2_LEFT_220	@完@
$ENTRY_JOURNAL_INDEX_2_LEFT_230	@伤疤@
$ENTRY_JOURNAL_INDEX_2_LEFT_240	@图书馆管理员史勒@
$ENTRY_JOURNAL_INDEX_2_LEFT_250	@故事灵感@
$ENTRY_JOURNAL_INDEX_2_LEFT_260	@沃可兰的力量@
$ENTRY_JOURNAL_INDEX_2_LEFT_270	@狂血部落@
$ENTRY_JOURNAL_INDEX_2_LEFT_280	@北方城邦@
$ENTRY_JOURNAL_INDEX_2_LEFT_290	@奎德王族的拜火教@
$ENTRY_JOURNAL_INDEX_2_LEFT_300	@瑟连里@
$ENTRY_JOURNAL_INDEX_2_LEFT_310	@艾殊神庙@
$ENTRY_JOURNAL_INDEX_2_LEFT_320	@武僧的习惯@
$ENTRY_JOURNAL_INDEX_2_LEFT_330	@舍里米尔之名@
$ENTRY_JOURNAL2_INTRODUCTION_TITLE	
$ENTRY_JOURNAL2_INTRODUCTION_LEFT_00	引言
$ENTRY_JOURNAL2_INTRODUCTION_LEFT_10	嘿大家好！这是我们幕后工作人员的秘密日记，这里有许多酷炫的秘密和幕后资料，好像故事中某部分的灵感(大部分都是<LQ>我上一次见到太阳是什么时候？<LQ>为什么狼叔不回我那一封想跟他当好朋友的信呢？<RQ>但有时候有意思的故事让你可能有兴趣知道<LQ>瓦娜面上的伤疤是来自她在战争中被抓，为了不受折磨而尝试自行割断她的舌头。<RQ>与及<LQ>我现在是作者，我可以任意使用括号了！哈哈哈哈哈！<RQ> (认真点来说，就像俄罗斯娃娃一样))<N><N>噢对了，应该好好介绍一下自己，我是James <LQ>魔鬼般帅气的文案头头<RQ> Cavin.你大约可以从我的中间名中猜到，我就是为Defender's Quest: Valley of the Forgotten创作故事的。我也应该提及
$ENTRY_JOURNAL2_INTRODUCTION_RIGHT_0_00	Lars <LQ>虽然他不如James那样英俊但是还可以了，我这可是帕拉图式的称赞啊。<RQ> Doucet,如果他不忙于编程的话，他负责写部分物品和敌人相关的文案。(天啊，我们的父母在填写我们的出生证明时，看来对我们前途都规划的很清晰了。)
$ENTRY_JOURNAL2_INTRODUCTION_RIGHT_0_10	怎么也好，这本幕后日记有所有酷酷的背景资料，世界观设定，笔记，否决的想法等等。这就像窥视我们狂野又厉害的创作历程，除了那些从垃圾桶找东西吃和哭着入睡的夜晚。我们一起经历这个历程吧！
$ENTRY_JOURNAL2_INTRODUCTION_RIGHT_0_20	还有，狼叔，如果你看到的话，你是否收到我的生日邀请函？相信我，那些闷蛋不会出现！我所有的毛公仔都会出席呢！
$ENTRY_JOURNAL2_INTRODUCTION_LEFT_1_00	
$ENTRY_JOURNAL2_INTRODUCTION_RIGHT_1_00	
$ENTRY_JOURNAL2_PLATEMAIL_TITLE	
$ENTRY_JOURNAL2_PLATEMAIL_LEFT_00	<LQ>钢甲<RQ>
$ENTRY_JOURNAL2_PLATEMAIL_LEFT_10	很多人都经常用这个词<LQ>铠甲。<RQ>当它出现在Defender's Quest中时，我们把它用在一些重装上，我立刻停下(瞪着那些德文长剑比剑文案)跳了起来。你看看，<LQ>钢甲<RQ>是一个愚蠢又重复的词，它不应该跟任何有价值的东西牵上关系。但是……如果是<LQ>锁子甲，<RQ>跟钢甲相比又如何呢？<LQ>钢甲<RQ>是不是好一点呢?错!<N><N>那个词<LQ>甲<RQ> (或是你想花俏一点的话称为<LQ>盔甲<RQ>),来自中世纪的法语，意思是<LQ>锁链。<RQ>整个词语<LQ>锁子甲<RQ>其实是累赘了，它就在19世纪才出现。当<LQ>锁子甲<RQ>进入了大众的词汇,大家都不知道<LQ>甲<RQ>的原本意思是什么了，或许它就是代表<LQ>保护战士的装备吧。<RQ>现在大家动不动就加个甲子在任何原本应该被称为装备的东西上。
$ENTRY_JOURNAL2_PLATEMAIL_RIGHT_0_00	当我开始与大家产生距离时，我们要不换个话题？例如为什么大家都要把所有东西都安上刺呢？那用来干嘛？抱住一个人，刺死他？如果把你的手臂抬高30度，然后装在你肩膀的11寸长的刺难道不会刺穿你的脑袋吗？你真的会穿着随时可以把你刺死的东西去战斗吗？除非你<LQ>有随意改变身体结构的技能吧。<RQ>喂喂！<N><N>大家都去哪里呢？
$ENTRY_JOURNAL2_PLATEMAIL_LEFT_1_00	
$ENTRY_JOURNAL2_PLATEMAIL_RIGHT_1_00	
$ENTRY_JOURNAL2_DIMENSIONS_TITLE	
$ENTRY_JOURNAL2_DIMENSIONS_LEFT_00	空间笔记
$ENTRY_JOURNAL2_DIMENSIONS_LEFT_10	对于想要知道更多<LQ>中途世界<RQ>的朋友，以下就是我们内部的设计文档，说明不同的空间如何运作：<N><N>现实是多层的状态。我们所认知的是每一层<LQ>空间<RQ>或是<LQ>领域<RQ>中的一小部分，当中包括颜色，味道，触感和香味等等，这些全部都是空间的一部分。我们的世界所体验到的都不过是冰山一角，但是如果一个人能完全集中精神，他就可以分开那些层，完全去体验那一空间。我们一直在探讨的<LQ>领域<RQ>是<LQ>影<RQ>,正如角色所称呼的一样。这个影之领域是灵魂的空间-就像帕拉图的理想状态，但是每个事物都是存在的。每个生物都是被看不见的能量所激发的，我们很少经历过这股力量，但是在影之领域这股灵魂的力量是可以充分被体验和互动的。正如治疗师如此说：
$ENTRY_JOURNAL2_DIMENSIONS_RIGHT_0_00	治愈师:你每一个感官都会给你一个细微的提示，有什么在那里。<N><N>麦高芬：原来如此。<N><N>治愈师：现实是层层构成的-<N><N>狂战士:像蛋糕一样吗？<N><N>治愈师：是的…...就像蛋糕一样。这些层是构成我们所经验的世界-<N><N>狂战士：什么口味的蛋糕呢？<N><N>麦高芬：现实口味的！给我闭嘴！<N><N>狂战士：额……现实口味的蛋糕。<N><N>
$ENTRY_JOURNAL2_DIMENSIONS_LEFT_1_00	
$ENTRY_JOURNAL2_DIMENSIONS_RIGHT_1_00	
$ENTRY_JOURNAL2_ACTQUOTES_TITLE	
$ENTRY_JOURNAL2_ACTQUOTES_LEFT_00	开场白
$ENTRY_JOURNAL2_ACTQUOTES_LEFT_10	我其中最喜欢的就是每段开场时，总会配上一小段字。它们让我可以带入其他情景，给读者窥探一下世界观的宏大设定。当第七幕开始时，我其实已经预备了3段引言，不过我最后还是选了我最喜欢的一段，放入游戏之中。这里就是没有选上的两段：<N><N><LQ>当面对选择，自私的人衡量结果，务求取得最大利益。卫道之人则会选择伺奉圣火之道。<RQ><N>-摘录自荆棘之道的七种智慧书。<N><N><LQ>我看着北方雇佣兵的脸，只看见末路赌徒的不忿与绝望，我们全都要死，但我会为了家国，为了王上，为了神庙而牺牲。他们不过是为了小额的金子而死。<RQ><N>-卡雷多道围城的不知名守卫者
$ENTRY_JOURNAL2_ACTQUOTES_RIGHT_0_00	最终获选的是这一段:<N><N><LQ>常言道人都怕死，但根据我的经验，他们真正惧怕的是死后的未知性。在所有的疼苦中，当死亡是唯一可以想象的结果，我心内感受到前所未有的平静。那唯一可以生存的机会才是我真正惧怕的。<RQ><N>-摘自箭神哥德蒙达拉巴的回忆录：伺奉艾殊王的冒险和探险经历。<N><N>这段引言的灵感是来自Gene Wolfe的著作“Shadow of the Torturer“。当我开始阅读时，我正好在Defender's Quest的收尾阶段(那时我并未发现这段灵感对我的影响，直至我完成整篇为主，我才发现呢)。这是一本很奇怪，令人感到不安的书，我并不建议年轻的读者去阅读。但是对于一个成又对体验新世界时，这本书捕捉了一些作为另一世界的他者的感觉，这是在现代的小说中颇为新颖的。<N><N>说起灵感，每一幕都加上介绍引言的想法
$ENTRY_JOURNAL2_ACTQUOTES_LEFT_1_00	是来自我其中一个最喜欢的游戏Thief: The Dark Projekt,。我认为这是我玩过的游戏当中最具想象力,细致入微又引人入胜的设定。盗贼大师嘉烈德静静地穿过影子之城，在冰冷的工业机器与神秘主义的恐怖之中游走，穿越在魔法与理性的战斗之中，我相信这是我一辈子不能忘记的。有时候我想到它时，我都要哭出来。虽然这可能跟我小时候吃下的玩具涂料有关……
$ENTRY_JOURNAL2_ACTQUOTES_RIGHT_1_00	
$ENTRY_JOURNAL2_BERSERKERS_TITLE	
$ENTRY_JOURNAL2_BERSERKERS_LEFT_00	狂战士与正确的刀鞘摆放位置
$ENTRY_JOURNAL2_BERSERKERS_LEFT_10	啊，当一个酷酷的剑士把他的宝剑背在背上，总比像正常人一样放再腰间要帅多了!没错实在是很帅！实际上我原本设计的狂战士就是这个样子的。幸好，我那追求历史真相的强逼症令我不得不面对现实，就好像被人用钢手套赏了一巴掌一样的，因为这个想法就像是笨蛋才会这样做。N><N>但Link!还有嘉烈德！还有忍者！<N><N>我背后的历史强逼症小天使说：<N><N>你的背是一处好地方让你带上东西四处走的，例如：背包。<N><N>但是，如果你想从背上拔出你的武器，这是近乎不可能的！不相信的话，你试试啊，即使是大力士也没可能
$ENTRY_JOURNAL2_BERSERKERS_RIGHT_0_00	从背上拔出任何东西呢(我记得曾经有个罗马皇帝，好像是哈德良？曾经在文献中吹嘘说伦敦被征服后，他的军队可以背着武器在街上走动。因为……如果你有收袭击的危险的话……你会希望随手就可以拿到武器。)<N><N>下一次你看电影时如果看到酷酷的角色把剑（甚至两把剑）都背在背上时，你不难发现他拔剑的动作都会被剪走。他只会从剑鞘拔出几寸（或是加入一些金属的撞击声，但是除非你的剑鞘中有碰撞你的剑的东西，否则你是绝对不会听到这些声音的）然后，他就帅气地拿着剑了。这都是因为拔剑是人体结构上不可能的事，你不能从你的背上拔出比你前臂长的东西。除非，你不介意关节错位吧。<N><N>现在，如果还有人对于从背后拔剑念念不忘，
$ENTRY_JOURNAL2_BERSERKERS_LEFT_1_00	你可能会说他们有一些特殊设计所以就能做到。他们大部分都是一些半剑鞘或是那一类的东西吧，它们都很愚蠢因为只有愚蠢的人会用他们，跟从腰间拔剑相比那简直是太不方便了。（很多都在顶部带一些大大的金属环，所以你可以听到金属碰撞的声音了，同时你的剑也毁了……因为那些环一直在碰撞你的剑刃。）<N><N>怎么也好，当大家都对看起来<LQ>酷<RQ>的拔剑动作非常沉迷时，即使这是永不可能的，即使你载设计上精心设计过那些配件，但是像正常人一样拔剑才是真正的目的吧。<N><N>幸好，我及时把错误改正过来，我们的狂战士现在可以用一个正常，人体工学上可行的剑鞘来拔剑了。接下来，我花了两个小时在YouTube上看德式长剑剑术比赛，边看边哭来忏悔我的罪行。
$ENTRY_JOURNAL2_BERSERKERS_RIGHT_1_00	PS:你可能会发现在一些3D游戏中，角色都把剑背在背上，他们拔剑的时候剑都是从剑鞘的侧面出来,而不是从顶部出来的。<N><N>PPS:有些拿破仑或维多利亚军队的军刀都是用金属的剑鞘，在口中带有弹簧的，让刀可以稳在鞘中,当他们拔刀的声音就是电影最爱的配音了。这种弹簧也会磨损刀锋，所以你看看现存的军刀，他们都有明显磨损的痕迹，因为每一次拔刀那道弹簧都会摩擦刀锋。所以是的，那些酷炫的拔剑金属声确实存在，但非常有限，而且对剑长期来说是非常不好的。现在如果你允许的话，我要去看看有关比剑的文献和手册了。
$ENTRY_JOURNAL2_BOSSREVENANT_TITLE	
$ENTRY_JOURNAL2_BOSSREVENANT_LEFT_00	亡者之王
$ENTRY_JOURNAL2_BOSSREVENANT_LEFT_10	对于好奇我们亡者之王设定的朋友，以下就是我们内部设计文档的解释：<N><N>有些亡者是会比其他的更为强大，是否那位巫师投放多少灵力到那只操控物上面。再者，有些<LQ>壳<RQ>比起其他传导性更佳。例如，一个强大的巫师可以栖息在松鼠的尸体中，虽然丧尸松鼠军团好像很可笑，但是松鼠本身能承受的灵力肯定不如人类– 更不用说它们在影之领域的存在了。基本上，灵魂留下的虚空越大，巫师可以投入他个人灵力的空间就会越多(最理想的是刚死去的时候，因为当尸体开始腐烂是，他的灵魂空间也是开始崩溃。尸体越是放得久，可用之处就越少。)对于活生生的人来说也是同理，不是每一个人都有空间可以巫师施法。影之管道最多可以通过少部分他的灵魂，不会让他们做出一些需要的能量远超
$ENTRY_JOURNAL2_BOSSREVENANT_RIGHT_0_00	他们能承受的事。另一方面来说，一个人如果在灵魂上更有深度，自然就会有更大的空间可以操控 – 尸体越是新鲜，就有越大的虚空可以让人乘虚而入。
$ENTRY_JOURNAL2_BOSSREVENANT_LEFT_1_00	
$ENTRY_JOURNAL2_BOSSREVENANT_RIGHT_1_00	
$ENTRY_JOURNAL2_CHIEFTANSTUNIC_TITLE	
$ENTRY_JOURNAL2_CHIEFTANSTUNIC_LEFT_00	酋长的祭袍和世界树
$ENTRY_JOURNAL2_CHIEFTANSTUNIC_LEFT_10	酋长祭袍上装饰着世界树交缠的根，这是我为了加深文化意味和强调不同文化的民间传说所作出的众多努力之一，这次的对象就是诺曼族。<N><N>世界上很多文化都有世界树的概念，但是我对于希腊的其中一个牵涉及巴尔干半岛妖精Kallikantzaroi特别着迷。Kallikantzaroi整年都住在地底下，为了锯断世界树的根，好让它倒下（所以世界也会倒下）。我猜它们就是那么讨厌吧。不过就在圣诞节那一天，它们差不多把树根都锯断时，它们就会来到地面，跑来跑去实施恶作剧，好像在人家的啤酒撒尿，从孩子手上偷糖果，把你的牙刷放进马桶，总之就是讨厌鬼的表表者。它们会一直玩到
$ENTRY_JOURNAL2_CHIEFTANSTUNIC_RIGHT_0_00	顿悟之日，它们就会回归地底。它们会发现原来它们才是闹笑话的人，因为世界树的伤口已经完全愈合了。这事每年都会发生因为Kallikantzaroi不只是讨厌鬼，还是大笨蛋(我喜欢想象当它们不在时，世界树往它们的啤酒中撒尿。)<N><N>噢！如果你想保护你的啤酒，糖果，还有牙刷，你只需要把一个漏勺放入包包中随身带着。Kallikantzaroi只可以数数到2，因为3是个神圣的数字，代表三为一体的神，如果其中一个Kallikantzaroi大声说出来，它们立即就会死掉。如果你把汤勺随身带着，这些傻瓜就会彻夜去数上面的小孔，但是往往在数到第二个就数不下去。第二天你醒来时，第一件事就是拿出你的手枪，疯狂扫射这帮讨厌鬼，然后把它们扫尽垃圾桶，接下来你就可以安心喝你的啤酒来享受余下的加起来。最少，我是这样想的。
$ENTRY_JOURNAL2_CHIEFTANSTUNIC_LEFT_1_00	
$ENTRY_JOURNAL2_CHIEFTANSTUNIC_RIGHT_1_00	
$ENTRY_JOURNAL2_CUTCHARS_TITLE	
$ENTRY_JOURNAL2_CUTCHARS_LEFT_00	裁减的角色：圣骑士与保卫者
$ENTRY_JOURNAL2_CUTCHARS_LEFT_10	我们原本打算设计更庞大的阵型，但是为了更好管理2而不得不裁减一些角色，最后圣骑士和保卫者就是我们裁走的。<N><N>保卫者其实极具防卫优势，是个<LQ>坦克<RQ>，用来保卫队员的。他最大的特色是他不但可以保护自己，还可以保护身边的队友。所以当一个守卫者在受到攻击时，保卫者会用他的盾牌格挡。故事方面，如果我记得没错的话，保卫者是来自艾殊的精英军事狂热者，相信他有责任去保卫他的成员曾经溅血的土地。部分保卫者的元素已经应用在骑士马可斯身上，但是那些狂热，<LQ>我们的血！爱国者之血！<RQ>等层面都被删去了。
$ENTRY_JOURNAL2_CUTCHARS_RIGHT_0_00	圣骑士也是因为与骑士太过相像而被裁走。原本瓦娜就是属于这个职业的-那个<LQ>疯狂又好战的敌方公主变成不情愿的盟友<RQ>，看来这个带剑的角色也不测啊。当这个职业被取消时，我觉得敌方公主这个角色实在太好，必须要把她用在其他地方，于是我们熟悉的冰霜法师就诞生了。<N><N>当我们还在讨论如何改动职业时，那条龙原本其实是龙骑士，这个角色会是一个超级厉害的射手，他会骑着一条龙出现。如果是这样，射手就会变成整个游戏中过分强大的职业，所以我们就只好使用龙这个角色了。我想尼胡会同意这个做法吧。
$ENTRY_JOURNAL2_CUTCHARS_LEFT_1_00	
$ENTRY_JOURNAL2_CUTCHARS_RIGHT_1_00	
$ENTRY_JOURNAL2_EYEOFFLAME_TITLE	
$ENTRY_JOURNAL2_EYEOFFLAME_LEFT_00	火焰之瞳
$ENTRY_JOURNAL2_EYEOFFLAME_LEFT_10	这个物品的描述灵感是来自盎格鲁-撒克逊的诗歌<LQ>废墟(The Ruins)，<RQ>这是悼念罗马城遗址等一首挽歌。这是诗歌只有在一部文献中有记载，不过这部文献已经严重损毁，诗歌的结尾部分只有断断续续的词句。最后一组可以被理解的文字翻译为<LQ>这是帝王的事……(It is a kingly thing...) <RQ><N><N>如果你从未读过，我极力推荐你去买一本回来，花上十年去了解盎格鲁-撒克逊的语言，用原文来阅读。或者你可以找到翻译本，但是你不能跟在派对上认识的人卖弄，然后在一个人对着墙用盎格鲁-撒克逊骂脏话，最后被人家赶出派对了。因为盎格鲁-撒克逊的脏话跟现代英语甚为相像。
$ENTRY_JOURNAL2_EYEOFFLAME_RIGHT_0_00	
$ENTRY_JOURNAL2_EYEOFFLAME_LEFT_1_00	
$ENTRY_JOURNAL2_EYEOFFLAME_RIGHT_1_00	
$ENTRY_JOURNAL2_RIGHTHAND_TITLE	
$ENTRY_JOURNAL2_RIGHTHAND_LEFT_00	以斯里·特诺奇的右手
$ENTRY_JOURNAL2_RIGHTHAND_LEFT_10	我原本会把以斯里·特诺奇的右手写进故事中，呃，我指的是<LQ>右手<RQ>，就像我们平常说那个将军是<LQ>国王的右手<RQ> –纯粹是借喻。以斯里特诺奇的右手原本指的就是一大群可怕的亡者，他们都是特诺奇的最佳仆人。
$ENTRY_JOURNAL2_RIGHTHAND_LEFT_20	但是不知道为什么，事情变得跟文字非常贴近，于是乎游戏中久出现了那恐怖的大手。我可不想重新再出美术，于是就在对话中加了一些解释。这个误会令其中一个Boss关卡变得令人印象深刻！(还有，Lars亲自为右手配上文案的，所以<LQ>罪人<RQ>可不止我一个啊！)
$ENTRY_JOURNAL2_RIGHTHAND_RIGHT_0_00	
$ENTRY_JOURNAL2_RIGHTHAND_LEFT_1_00	
$ENTRY_JOURNAL2_RIGHTHAND_RIGHT_1_00	
$ENTRY_JOURNAL2_MASTEROFARCHERS_TITLE	
$ENTRY_JOURNAL2_MASTEROFARCHERS_LEFT_00	箭术大师-嘉德蒙·达莱巴
$ENTRY_JOURNAL2_MASTEROFARCHERS_LEFT_10	嘉德蒙·达莱巴有一句话被引用在我们其中一幕的开端，他是其中一个穿着箭术大师装备的角色。<N><N>我曾经有个想法，想要写一部有关他冒险的书，但是我一想到要顾及的细节我就要发疯了。<N><N>不过，实在说不准呢……<N><N>(当然，我们的诺曼族冒险家卡勒卡达，也会有自己的故事啊。)
$ENTRY_JOURNAL2_MASTEROFARCHERS_RIGHT_0_00	
$ENTRY_JOURNAL2_MASTEROFARCHERS_LEFT_1_00	
$ENTRY_JOURNAL2_MASTEROFARCHERS_RIGHT_1_00	
$ENTRY_JOURNAL2_SANDWICH_TITLE	
$ENTRY_JOURNAL2_SANDWICH_LEFT_00	James最喜欢的三明治食谱
$ENTRY_JOURNAL2_SANDWICH_LEFT_10	啊，所有的写作工作都已经令我饥肠辘辘了，你们饿了吗？我可饿得不行。我们好好应对一下这个问题吧。<N><N>你将会需要：<N><N>香肠<N>鸡蛋<N>面包<N>西红柿<N>德式腌青瓜<N>黄芥末<N>优格乳(没有加糖加调味的那些，因为你不是小孩子了)<N>辣酱(我个人来说是偏好路易斯安纳州的风味，不过你可以随意选择你喜欢的。)
$ENTRY_JOURNAL2_SANDWICH_RIGHT_0_00	第一步：谋杀一些动物（最好是听起来很厉害的那些，例如鲨鱼。），然后搅碎牠的尸体，再把碎肉塞进肠衣。不过，你可以买香肠代替，但是就没那么好玩了。<N><N>第2步:把香肠切成长条状。<N><N>第3步：<N>在平底锅上煎这些香肠，记得要把它们煎得金黄又酥脆，但不要煎焦了。<N><N>第4步：<N>煎蛋（你想煎多少就煎多少吧，确保都能放进三明治就好。我自己会煎两个，不过我不会阻止你煎更多的。）<N><N>第5步：<N>面包看起来是目前最健康的材料，就把它丢进香肠的油中在煎一下吧，你需要很多的油。最重要的是：
$ENTRY_JOURNAL2_SANDWICH_LEFT_1_00	你需要把一些可能比较健康的东西，转化为油腻的心脏病毒药。记住，一顿大餐如果不能让你后悔，你就是做错了。<N><N>第6步：<N>现在是酱料的时候了！把黄芥末与优格乳以同等分量在碗中混合，记得要用力拌好，就像把你的敌人脑袋搅碎一样，加入辣酱，试味，然后确保每一种材料都已经拌匀。如果你的平底锅中还有些油剩下的话，也可以把它加入。<N><N>第7步：<N>是时候组装三明治了！把酱汁涂在两片面包上，现在就可以不按顺序把材料叠上去。这件伟大的杰作起码有5寸高的。
$ENTRY_JOURNAL2_SANDWICH_RIGHT_1_00	第8步：<N>狼吞虎咽。因为你所有的材料都沾满了油，所以你的三明治会很快变得软塌塌的。赶紧把它吃下啊！不要再犹豫了！你的怜悯就不了它的!<N><N>第9步<N>：后悔。
$ENTRY_JOURNAL2_LORDWARDEN_TITLE	
$ENTRY_JOURNAL2_LORDWARDEN_LEFT_00	监狱长的马具
$ENTRY_JOURNAL2_LORDWARDEN_LEFT_10	原本，那个监狱长在故事中占了一个重要位置的。在我的初稿中，他是一个重要的对手，他秘密地被瘟疫感染了。他会用在艾殊王国中的权力去为瘟疫和瘟疫的创造者做一些迷信的工作。最后，他被舍里米尔所取代，因为舍里米尔的动机更有意思，也更复杂。但是，我非常喜欢监狱长这个设定，所以他转生为一套装备。嘿, 最少他的名字还留在游戏中啊（比起其他裁掉的角色要幸运多了）。
$ENTRY_JOURNAL2_LORDWARDEN_RIGHT_0_00	
$ENTRY_JOURNAL2_LORDWARDEN_LEFT_1_00	
$ENTRY_JOURNAL2_LORDWARDEN_RIGHT_1_00	
$ENTRY_JOURNAL2_MARKOS_MUSTACHE_TITLE	
$ENTRY_JOURNAL2_MARKOS_MUSTACHE_LEFT_00	马可斯的小胡子
$ENTRY_JOURNAL2_MARKOS_MUSTACHE_LEFT_10	马可斯的胡子会是现在这个样子是因为他原本的山羊胡子会令人觉得，<LQ>他像是一个二手车的销售员。<RQ>
$ENTRY_JOURNAL2_MARKOS_MUSTACHE_LEFT_20	他的面部特征灵感是来自与盟军将军Ambrose Everett Burnside (多奇怪的名字)和摇滚乐团摩托头的主音莱米（重金属音乐之父，如果他搬到你家旁边，你家的花园就会死的那种。）摇滚万岁！兄弟，摇滚万岁！
$ENTRY_JOURNAL2_MARKOS_MUSTACHE_LEFT_30	还有一个更令人佩服的事，那就是当你发现他用来刮胡子的就是他的剑……
$ENTRY_JOURNAL2_MARKOS_MUSTACHE_RIGHT_0_00	
$ENTRY_JOURNAL2_MARKOS_MUSTACHE_LEFT_1_00	
$ENTRY_JOURNAL2_MARKOS_MUSTACHE_RIGHT_1_00	
$ENTRY_JOURNAL2_MARKOS_NAME_TITLE	
$ENTRY_JOURNAL2_MARKOS_NAME_LEFT_00	马可斯的名字
$ENTRY_JOURNAL2_MARKOS_NAME_LEFT_10	马可的名字来源于我一个好朋友，他在圣安德鲁斯大学的一位教授告诉他一个古怪的故事。那位教授在年轻时，曾经去欧洲旅游。在法国的时候，他会参观一些开放给公众的中世纪教堂。他对那些建筑物非常着迷，所以决定从旅行团中偷走，藏起来，这样他就可以在教堂关门的时候，偷偷享受独自一人的参观了,尤其是没有指指点点的导游啰嗦他。<N><N>他的计划很成功，当教堂关门是，他就摄手摄脚走出他的藏身之处，开始他的游览。就在这个时候，他发现了在挂毯下面露出了一对鞋子，原来他不是唯一一个有同样想法的人。那个藏身在挂毯后的原来是跟他是同一个旅行团的年轻女子，于是他们就开始一同游览教堂。
$ENTRY_JOURNAL2_MARKOS_NAME_RIGHT_0_00	他们一直兴高采烈地聊天，完全没有发现第三个人的来到，直到那个陌生人问他们想不想要来一个<LQ>秘密导嚮<RQ>。那个男人自称马可斯，有一头乱糟糟的头发，不修边幅的胡子，还留着长长的指甲。他经常在教堂关门以后，藏身其中，然后他就会在晚上来探险,所有的幕后故事，还会在教堂的风琴上来一段即兴表演。也就是这个时候他向他们解释很多中世纪的教堂其实是再异教的建筑物上兴建的，很多时这些遗址依然存在于后来建筑物之下。这就是为什么他这样钟情于教堂，因为他是个德鲁伊。很多时候，他在教堂的背面走走逛逛时，他在地面上发现一个小通道,让他可以到达教堂的地下墓穴。这两位游客觉得跟一个陌生男人走进地下死亡室明显没有问题，所以他们就跟着马可斯走。在那里，他们发现异教徒的埋骨之地，也是教堂地底的真面目。拿起一些头骨来把玩一下喉，马可斯跟他们道别，他们就从此分开。
$ENTRY_JOURNAL2_MARKOS_NAME_LEFT_1_00	不久以后，教授与那以为年轻女子共谐连理。至于马可斯呢？我相信他把自己涂成蓝色，住在教堂地底下其中一个小石窟之中。<N><N>因为我太喜欢这个人了，所以我决定总有一天要用他的名字做些事。
$ENTRY_JOURNAL2_MARKOS_NAME_RIGHT_1_00	
$ENTRY_JOURNAL2_MARKOS_SKIRT_TITLE	
$ENTRY_JOURNAL2_MARKOS_SKIRT_LEFT_00	马可斯的裙子
$ENTRY_JOURNAL2_MARKOS_SKIRT_LEFT_10	你们可能留意到，马可斯的<LQ>裙子<RQ>是由一条条皮革组成的，叫做皮条裙。再告诉一件事吧！<N><N>你也可以在希腊和罗马士兵身上见到类似的东西- 因为我很努力去赋予艾殊一种拜占庭/地中海的味道。
$ENTRY_JOURNAL2_MARKOS_SKIRT_RIGHT_0_00	
$ENTRY_JOURNAL2_MARKOS_SKIRT_LEFT_1_00	
$ENTRY_JOURNAL2_MARKOS_SKIRT_RIGHT_1_00	
$ENTRY_JOURNAL2_MARKOS_SPELL_TITLE	
$ENTRY_JOURNAL2_MARKOS_SPELL_LEFT_00	马可斯的咒语和五环书
$ENTRY_JOURNAL2_MARKOS_SPELL_LEFT_10	不要用手臂之力刺出，要用灵魂之力量，身心合一，从你的身上比敌人扔出去。
$ENTRY_JOURNAL2_MARKOS_SPELL_LEFT_20	马可斯的<LQ>咒语<RQ>灵感是来自“五环书”，一本成书于1645年有个武士道与剑术的厉害著作。作者是宫本武藏，是史上最着名的武士。他也是超级演员三船敏郎的灵感来源，如果你喜欢看他那种砍到成千上万的人话，我极力推荐三船敏郎在五十年代的电影给你。(我绝对会邀请三船敏郎来参加我的生日派对，可惜的是在我11岁的时候，他就去世了。)
$ENTRY_JOURNAL2_MARKOS_SPELL_RIGHT_0_00	
$ENTRY_JOURNAL2_MARKOS_SPELL_LEFT_1_00	
$ENTRY_JOURNAL2_MARKOS_SPELL_RIGHT_1_00	
$ENTRY_JOURNAL2_MEET_BERSERKER_TITLE	
$ENTRY_JOURNAL2_MEET_BERSERKER_LEFT_00	认识狂战士：<N>被删除的情节
$ENTRY_JOURNAL2_MEET_BERSERKER_LEFT_10	原本，在第一场战斗之前，玩家是不会得到史勒的。第一场战争用Arza的闪电咒语就可以了，不过最后我们发现这样回让玩家觉得这是一个用咒语，而不是守卫者的游戏。<N><N>于是，我们赶紧做调整，将史勒加入去，然后玩家就没有那么疑惑了！对于你们这些有兴趣看看我们原本如何介绍史勒的话，以下就是旧过场的片段：<N><N>阿史娜:<N>(困惑)<N> <LQ>天啊……那到底是什么？<RQ><N><N>阿史娜:<N>(疑惑)<N> <LQ>我到底躺了多久呢?<RQ>
$ENTRY_JOURNAL2_MEET_BERSERKER_RIGHT_0_00	(史勒进场)<N><N>史勒:<N>(兴奋)<N> <LQ>这太厉害了!<RQ><N><N>阿史娜:<N>(疑惑)<N> <LQ>什么?<RQ><N><N>史勒:<N>(兴奋)<N> <LQ>你刚刚杀了近20个亡者！<RQ><N><N>阿史娜:<N>(疑惑)<N> <LQ>亡者?<RQ><N><N>史勒：<N>(随意)<N> <LQ>你知道的，怪物，丧尸，死人头，恐怖的东西，会动的死尸，吃人的, 就是亡者。<RQ>
$ENTRY_JOURNAL2_MEET_BERSERKER_LEFT_1_00	史勒:<N>(兴奋)<N> <LQ>这实在太厉害了！<RQ><N><N>阿史娜:<N>(疑惑)<N> <LQ>听着，我可不知道你说什么。我只知道我现在很不舒服-<RQ><N><N>史勒:<N>(随意)<N> <LQ>-还有他们把你丢进来等死的。<RQ><N><N>阿史娜<N>(疑惑)<N> <LQ>是的。<RQ><N><N>史勒：<N>(装模作样)<N> <LQ>那些丧尸就好像 “噢，我们可以吃掉你了。<RQ><N><N>史勒:<N>(疯狂)
$ENTRY_JOURNAL2_MEET_BERSERKER_RIGHT_1_00	<LQ>之后你就像“我可不这样认为，你这群傻蛋！吃我一记点击死亡攻击！”<RQ><N><N>史勒:<N>(畏缩)<N> <LQ>然后他们就像“啊!天啊！不要用你的超级死亡电击来煎我们啊！天啊！好疼！天啊！烧着了！天啊！就像一千个太阳同时烧一样!”<RQ><N><N>史勒：<N>(失望)<N> <LQ>然后我就说“哇靠！我可能偷不到她的鞋子了。<RQ><N><N>阿史娜:<N>(烦躁)<N> <LQ>...<RQ><N><N>史勒:<N>(随意)<N> <LQ>忘了我刚刚说的吧。<RQ>
$ENTRY_JOURNAL2_MEET_BERSERKER_LEFT_2_00	阿史娜:<N>(烦躁)<N> <LQ>听着，无论我多么佩服你的戏剧表演。我完全不知道我为什么在这里，所以如果你不介意的话-<RQ><N><N>史勒：<N>(友善)<N> <LQ>吖，你很幸运，你刚刚碰上了全墓坑中最棒的响导！<RQ><N><N>阿史娜:<N>(烦躁)<N> <LQ>响导？<RQ><N><N>史勒：<N>(友善)<N> <LQ>听着，这里有各种的危险对于一个新人，好像你，是没法生存超过五秒的，那些亡者，贼人，土匪……都会威胁你的性命。但是你现在可以以极低极低的成本，免费！来得到我的指引，这可是你唯一的希望啊！<RQ>
$ENTRY_JOURNAL2_MEET_BERSERKER_RIGHT_2_00	阿史娜:<N>(疑惑)<N> <LQ>免费? <RQ><N><N>史勒:<N>(友善)<N> <LQ>当然，那是出于我无敌性感又健壮的内心那无私的好意。我绝对没有使用你超凡能力来累积个人财富的私心。<RQ><N><N>史勒：<N>(大声公布)<N> <LQ>第一站，奥斯蒙卡兹的伟大藏宝库！<RQ>
$ENTRY_JOURNAL2_NAMES_LANG_TITLE	
$ENTRY_JOURNAL2_NAMES_LANG_LEFT_00	名字和语言
$ENTRY_JOURNAL2_NAMES_LANG_LEFT_10	很多人都提及过那些玩家在城中招募的小兵，名字都又古怪又不常见。这些名字是用来区别不同文化（艾殊，奎德和诺曼）的重要元素。
$ENTRY_JOURNAL2_NAMES_LANG_LEFT_15	你会发现有部分名字会带有身体特征。这是因为这个游戏为身体特征配了一个表，就像每一个文明都有一个文化相关的名字表一样- 当玩家点击来招募一个角色，游戏会首先随机抽取一个文化，然后在随机生成一个名字，从那张文化表中抽取一个身体特征。如果你对这三部分都有兴趣，这就是我们旧的命名规则：
$ENTRY_JOURNAL2_NAMES_LANG_LEFT_20	这是我们角色的名字库。这些名字都会匹配上不同的文化。随便加入一些你想到的吧，基本的应用原则如下：
$ENTRY_JOURNAL2_NAMES_LANG_RIGHT_0_00	艾殊名字：有很多Z 和V， 具有强烈的连续響音，普遍带着地中海风格。男性的名字通常以-mon/man, -ir or -al做为结尾, 女性的名字通常以-a or -i 和有时候以<LQ>-vni<RQ>作为结尾。常用声音组合包括<LQ>vn<RQ>和<LQ>zr<RQ>。<N><N>艾殊人的外表： <N><N>橄榄色，有时是非洲裔的肤色，例如<N>黑，棕，有时是混色金发，有时是红发。<N>棕色，淡褐色，还有蓝色的眼睛。<N>整体而言，是地中海，希腊，日耳曼和阿拉伯风格的混合。艾殊人在外型上具有多种特征，这是因为周边民族跨种族通婚的关系。<N>诺曼名字：强而短的辅音，通常以非连续響音结尾。女性的名字常以-a结尾。K的发音通常会被强调，发音
$ENTRY_JOURNAL2_NAMES_LANG_LEFT_1_00	会倾向于<LQ>sk<RQ>和<LQ>st<RQ>，还有这是唯一使用J发音的语言。
$ENTRY_JOURNAL2_NAMES_LANG_LEFT_1_10	诺曼的外形：<N><N>浅棕色皮肤。<N>绿色，蓝色和淡褐色的眼睛。<N>深深浅浅的红棕发色，有时也有黑发。
$ENTRY_JOURNAL2_NAMES_LANG_LEFT_1_20	整体来说，是罗曼尼与阿富汗的风格。人口偏小与通常与自己人通婚，会带来独特的基因辨识度，例如红发与绿眼，这些都是较为常见。奎德名字- 通常有很多W与L，灵感是来自威尔斯和夏威夷，当中也没有哪一个是主导的（因为我在找艾殊名字没有用到的字母时，好像就只有L跟W了）,还带有一点盎格鲁-撒克逊语的影响,奎德倾向用C而不是K, 用Y 而不用I。女性的名字通常以-a和<LQ>-nna.<RQ>作为结尾。
$ENTRY_JOURNAL2_NAMES_LANG_RIGHT_1_00	奎德族的外形：<N><N>非常白的皮肤<N>非常黑或是非常浅色的头发(两种极端，很少有中间的).人口中金发的数量比较少，通常是王族才比较常见。<N>黑(指的是非常深的棕色),深棕色和灰色的眼。<N><N>整体来说，是威尔斯，挪威和远东的混合。<N><N>艾殊名字:<N><N>Zir<N>Kered<N>Kolos<N>Teluman<N>Gozal<N>Gozra (女性)<N>Sivnah (女性)<N>Zamena (女性)<N>Hektamon<N>Devdi (女性)
$ENTRY_JOURNAL2_NAMES_LANG_LEFT_2_00	Tavida (女性)<N>Yoavna (女性)<N>Kesmir<N>Vasmon<N>Zenimon<N>Kastal<N>Kavni (女性)<N>Bazan<N>Evni (女性)<N>Rostal<N>Kezal<N>Tezra (女性)<N>Zinak<N>Restavni (女性)<N>Sedemon<N>Zerevna (女性)<N>Ezran<N>Tanos<N>Yevkani (女性)<N>Keznimon<N>Ayimi (女性)<N>Admon<N>Azakal<N>Bakaza
$ENTRY_JOURNAL2_NAMES_LANG_RIGHT_2_00	Kevnimi (女性)<N><N>Nomad Names:<N><N>Senna (女性)<N>Koat<N>Kem<N>Raska (女性)<N>Saja (女性)<N>Tulk<N>Rendt<N>Senga (女性)<N>Jast<N>Pak<N>Tanna (女性)<N>Dank<N>Serk<N>Drask<N>Sotta (女性)<N>Leska (女性)<N>Joata (女性)<N>Saj<N>Het<N>Tetch
$ENTRY_JOURNAL2_NAMES_LANG_LEFT_3_00	Nesk<N>Dysta (女性)<N>Skod<N>Senji (女性)<N>Klest<N>Zekka (女性)<N>Kask<N>Droat<N>Jek<N>Jekka (女性)<N>Kaji (女性)<N>Plosk<N>Skent<N>Foska (女性)<N>Fytt<N>Zesk<N>Sajesh<N><N><N>Quaid Names:<N><N>Lawan<N>Sawul<N>Wassa
$ENTRY_JOURNAL2_NAMES_LANG_RIGHT_3_00	Aluwo<N>Sanna (女性)<N>Wocolan<N>Celu<N>Laclanna (女性)<N>Walucella (女性)<N>Xeowan<N>Xeowanna (女性)<N>Wastan<N>Luwella (女性)<N>Lumenna (女性)<N>Stawan<N>Wacali (女性)<N>Neorxennawanga (女性)<N>Centawal<N>Solowan<N>Cyleth<N>Wulacal<N>Cedmal<N>Lanna (女性)<N>Hylla (女性)<N>Hywada (女性)<N>Walacanna (女性)<N>Cullad
$ENTRY_JOURNAL2_NAMES_LANG_LEFT_4_00	Cuwain<N>Cella (女性)<N>Celuwanna (女性)<N>Celuwon<N>Cylehal<N>Awan<N>Alenna (女性)<N>Awucella (女性)<N>Awucan<N>Iowan<N>Ittella (女性)<N>Walla<N>Lacan
$ENTRY_JOURNAL2_NAMINGEVIL_TITLE	
$ENTRY_JOURNAL2_NAMINGEVIL_LEFT_00	魔鬼的命名
$ENTRY_JOURNAL2_NAMINGEVIL_LEFT_10	当要命名我们的大坏蛋时，我想要用上一个特别有异国格调的名字，好让他与我们的角色跟他们的国家有所区别。有一个比较复杂的问题就是我们的三个文明本身已经存在比较明显的区别。<N><N>于是我决定使用那瓦特(阿兹特克)名字，因为这个语言与我们其他使用的现实语言是有明显的区别(艾殊使用希腊和阿拉伯语，奎德使用威尔斯，夏威夷和盎格鲁-撒克逊,诺曼使用加工过的北欧语和阿富汗语)。<N><N>现在回想起来，混合使用真实世界的名字（好像阿史娜与舍里米尔）与完全创造出来的名字（好像可塔与巴卡），有点奇怪，不过我个人还是觉得挺符合角色扮演游戏的风格的。<N><N>据Lars 所说，我们这个游戏都可以用一句句子总结，<LQ>一段追杀到最后有一个阿兹特克神明被埋葬。<RQ>
$ENTRY_JOURNAL2_NAMINGEVIL_RIGHT_0_00	
$ENTRY_JOURNAL2_NAMINGEVIL_LEFT_1_00	
$ENTRY_JOURNAL2_NAMINGEVIL_RIGHT_1_00	
$ENTRY_JOURNAL2_NOMADSPIRIT_TITLE	
$ENTRY_JOURNAL2_NOMADSPIRIT_LEFT_00	诺曼的灵魂崇拜
$ENTRY_JOURNAL2_NOMADSPIRIT_LEFT_10	原本，诺曼族是部落式多神论。每个部落都有自己崇拜的神祇(在不同的部落中，不同的家庭都会有他们家庭专属的守护神或是半神人)，有不同的偶像来代表。这些神祇都是为了部落的利益而存在的，作为交换祂们也必须受到崇拜和侍奉的。内讧和纷争在不同部落之间常常发生，因为游牧民族的特性让他们经常侵犯别人的领土，习惯抢掠和争夺。部落的神祇就是这些冲突的标准。一个部落失去自己偶像是极端侮辱的事(除非他们能透过战争把偶像抢回来)，通常这代表这个部落的消亡。一个没有神祇的部落地位是非常低下的，往往不能和其他部落通商和被排除在会议之外。<N><N>每个诺曼族的人都会在出生时收到一个个人专属的偶像，这代表部落神祇的仆人。这些仆人灵魂是每一个人的守护神。当一个诺曼族人去世时，他一定要与自己的小木雕合葬，因为这个木雕会确保他的灵魂可以顺利通过前往天堂的道路。一个诺曼族人如果不见了
$ENTRY_JOURNAL2_NOMADSPIRIT_RIGHT_0_00	自己的木雕，这可是天大的事情。没有守护神的引领，一个诺曼族的鬼魂会花上很长的时间来寻找前往天堂的道路。<N>与艾殊王国长期保持紧密的通商与交往，有很多部落也相信了艾殊神庙的教导。只有少数的诺曼人会愿意完全放弃旧信仰，改信艾殊神庙。大部分人倾向与艾殊的神明融和，这些信仰上的得过且过和艾殊王国对诺曼族的偏见，经常会引发宗教冲突。
$ENTRY_JOURNAL2_NOMADSPIRIT_LEFT_1_00	
$ENTRY_JOURNAL2_NOMADSPIRIT_RIGHT_1_00	
$ENTRY_JOURNAL2_SCARS_TITLE	
$ENTRY_JOURNAL2_SCARS_LEFT_00	伤疤
$ENTRY_JOURNAL2_SCARS_LEFT_10	我们并没有在故事中提及，不过乌仁娜脸上的伤疤是来自艾殊和奎德的战争。当时她被俘虏了，因为惧怕她会在受逼供后，吐露出秘密，所以她想把自己的舌头割掉，以防止背叛自己的国家。原本，这些伤疤都是蛮显眼的，但是为了不让她看起来像蝙蝠侠中的小丑，我们决定在淡化一点。<N><N>乌仁娜是唯一一个角色跟伤疤有关联的，所以我们尝试把其他墓坑生还者的伤疤以另外一些方式表达。这不单只加强了墓坑的危险性和经常有暴力事件出现的形象，也让阿史娜更像一个<LQ>新人。<RQ>在墓坑中，她初来乍到，所以并没有像其他人一样有老伤疤。
$ENTRY_JOURNAL2_SCARS_RIGHT_0_00	
$ENTRY_JOURNAL2_SCARS_LEFT_1_00	
$ENTRY_JOURNAL2_SCARS_RIGHT_1_00	
$ENTRY_JOURNAL2_SLAKLIBRARIAN_TITLE	
$ENTRY_JOURNAL2_SLAKLIBRARIAN_LEFT_00	图书馆管理员史勒
$ENTRY_JOURNAL2_SLAKLIBRARIAN_LEFT_10	你知道吗？原本的图书馆管理员，是史勒而非阿史娜，<N><N>在原本的介绍中是这样写的：
$ENTRY_JOURNAL2_SLAKLIBRARIAN_LEFT_20	职业：在被监禁以前，他是个首都图书馆管理员的一名成员。现在，在墓坑之中，他是一个职业的冒险家和雇佣兵。<N><N>教育程度：非常高，最喜欢的是历史与传奇文学，非常讨厌应用科学和数学。<N>
$ENTRY_JOURNAL2_SLAKLIBRARIAN_LEFT_30	最后，我们把他的背景设定给了阿史娜,让她成为那个神经质，经常挥舞汤勺子的图书馆管理员。史勒呢……有了一个全新的设定。
$ENTRY_JOURNAL2_SLAKLIBRARIAN_RIGHT_0_00	
$ENTRY_JOURNAL2_SLAKLIBRARIAN_LEFT_1_00	
$ENTRY_JOURNAL2_SLAKLIBRARIAN_RIGHT_1_00	
$ENTRY_JOURNAL2_STORYINSPIRE_TITLE	
$ENTRY_JOURNAL2_STORYINSPIRE_LEFT_00	故事灵感
$ENTRY_JOURNAL2_STORYINSPIRE_LEFT_10	有一个英语专业的朋友曾经问我Valley of the Forgotten的灵感来源，对于感兴趣的人来说，以下是我写作的时候经常出现在我脑海的东西：
$ENTRY_JOURNAL2_STORYINSPIRE_LEFT_20	瘟疫殖民地的概念其实是来自拉迪亚德·吉卜林（Rudyard Kipling）的短篇小说”The Strange Ride of Morrowbie Jukes”。我在11或是12岁的时候就读过这本书，那个自然形成的监狱，满满都是人，他们原本应该已经<LQ>死了的<RQ>，却后来痊愈了，这让我印象非常深刻。瘟疫社会强烈的景象也启发了我创作墓坑的一些细节（好像那里并没有马。Morrowbie 遭遇的第一件事就是他的马被人杀来吃，不过他也分到一份肉，所以并没有那么糟糕。）
$ENTRY_JOURNAL2_STORYINSPIRE_LEFT_30	除此以外，很多文化的元素来自于拜占庭的历史记录。很多瑟连里文化都是来自仙逝的伟人
$ENTRY_JOURNAL2_STORYINSPIRE_RIGHT_0_00	和早期东方基督教徒的手稿。
$ENTRY_JOURNAL2_STORYINSPIRE_RIGHT_0_10	还有我是一个历史文学的书呆子，很多灵感是来自盎格鲁-撒克逊的文学。当我开始进行Defender's Quest的创作时，我开始了古英语这门课，于是当中的语言和文化对近乎所有东西都有影响。那种忧郁有哀伤的语调看起来非常符合我们这个中世纪后末世时代设定。
$ENTRY_JOURNAL2_STORYINSPIRE_RIGHT_0_20	如果你对这一类的东西很感兴趣的话，我非常推荐“The Ruin”。它虽然短，但是包含了所有盎格鲁-撒克逊文学的死亡气息。
$ENTRY_JOURNAL3_STORYINSPIRE_RIGHT_0_30	当然，那里有很多东西在背后，但是这三个是对设定有最大的影响。嘿，这有我最喜欢的幽默作家的影响。
$ENTRY_JOURNAL2_STORYINSPIRE_LEFT_1_00	
$ENTRY_JOURNAL2_STORYINSPIRE_RIGHT_1_00	
$ENTRY_JOURNAL2_WOCOLAN_TITLE	
$ENTRY_JOURNAL2_WOCOLAN_LEFT_00	沃可兰的力量
$ENTRY_JOURNAL2_WOCOLAN_LEFT_10	描述<LQ>沃可兰装备重型武器后，图手把一只熊的头打碎<RQ>，是意图将奎德神话的背景再增加深度。<LQ>之后，他的孩子瓦斯坦与瓦丝拉因为喝下熊口中流下的鲜血，而可以在折磨人的家族放逐路途中撑过来。<RQ>我们并没有细写，但是沃可兰和孩子的故事，就是奎德族起源的传说，对他们的宗教也有深远的影响。在他流放的过程中，沃可兰被宇宙之焰选中并赋予力量，不止是为了让他通过严峻的考验，而是为了让他可以建立奎德族。<N><N>我尝试令整个故事更加古怪，更有传说的感觉。任何时候如果你想让一个故事更有<LQ>远古的宗教<RQ>色彩，你只需要让他们吃一些很恶心的东西。(或是你也可以走古埃及的路线，不过那可是颇为儿童不宜呢。)
$ENTRY_JOURNAL2_WOCOLAN_RIGHT_0_00	
$ENTRY_JOURNAL2_WOCOLAN_LEFT_1_00	
$ENTRY_JOURNAL2_WOCOLAN_RIGHT_1_00	
$ENTRY_JOURNAL2_BLOODMAD_TITLE	
$ENTRY_JOURNAL2_BLOODMAD_LEFT_00	狂血部落
$ENTRY_JOURNAL2_BLOODMAD_LEFT_10	诺曼族其实是一个属于以斯里·特诺奇管治的古文明的残余人口。当以斯里·特诺奇被打败后，他们流离失所，变成今天我们所认识的多神崇拜游牧部落。不过他们还是有些人忠于他们被击败的<LQ>神<RQ>，在他们神秘的女王领导下，组织成一个以解放以斯里·特诺奇的死亡萨满教派。这些部落围绕着Eztli的监狱聚居，用他们唯一知道的办法来尝试打破封印，那就是杀人后将那些血涂在巨石之上，希望有一天他们可以抓到对的人来打破封印。大家都很快知道要避开那些地方，所以血教迅速扩大地盘，最终开始影响到奎德帝国。很明显，把所有你遇见的人都杀来献祭并不是什么好主意，也对宇宙之焰来说是个侮辱，所以奎德者也发动了几次战争来对抗这些异教徒（就是乌仁娜所说的那些）。
$ENTRY_JOURNAL2_BLOODMAD_RIGHT_0_00	这些异教徒虽然散居各处，但是依然是个潜在的威胁。就在几个世纪以前，他们的女王消失了，这些异教徒失去了进行复杂献祭的意义，很多血族没有在巨石附近聚居，改为崇拜一个比较小的代替品，进行献祭。不过，以斯里·特诺奇在某程度上被释放后，他就去找自己散落四处的孩子。血族的萨满听到他的呼召后，就带领人民重返墓坑，回到囚禁他们神的巨石监狱附近。<N><N>这些异教徒维持着一种有毒的饮食(舍里米尔用在奥斯蒙身上那种)，保持着一种近乎疯狂的执念，就是相信他们可以被主人的灵魂所支配。这种有毒的饮食让他们可以在需要的时候边成亡者(以斯里·特诺奇的右手就是一个萨满，或是一群萨满，愿意为了他们的主人献身变成可怕的工具)。<N><N>Ketta的部落-革卡就是当她十来岁的时候，就被血族所屠杀，这也是为什么她对自己部落比较陌生，这也是她可以
$ENTRY_JOURNAL2_BLOODMAD_LEFT_1_00	认出她们的原因。<N><N>舍里米尔在奥斯蒙的饮食中下毒，是Lars 的主意。如果没有这个主意，我可没有狂血部落这个灵感。(原本，奥斯蒙是在被舍里米尔残忍地杀死后，才变为亡者，但是我那昆汀·塔伦蒂诺式的大屠杀被否决了，我还是更喜欢毒杀。顺带一说，那个眼罩长枪手，就是那个莫名奇妙地吸引了一堆小粉丝的，其实他原本也是死在混战之中)。<N>
$ENTRY_JOURNAL2_BLOODMAD_RIGHT_1_00	
$ENTRY_JOURNAL2_CITYSTATES_TITLE	
$ENTRY_JOURNAL2_CITYSTATES_LEFT_00	北方城邦
$ENTRY_JOURNAL2_CITYSTATES_LEFT_10	当我为了HD版的上线做准备时，要将故事扩展，我发现了一本旧的设计记事本。明显地，在过去某段日子，我曾经想把游戏中提及的北方城邦命名为卡革斯。我认为这听起来挺酷的，所以我就把它应用在游戏之中。我惊奇于这本封尘的记事本竟然像一个魔法的入口一样，把我引领进一个不需要再多干活的时光中。很明显，我们的冰霜法师是个命名为Laz的男人，他是修理钟表的工匠。还有最后一页是一张<LQ>清单<RQ>，写着:<N><N>1.倒垃圾<N>2.打电话给水喉修理工来把漏水修理好<N>3.中彩票，娶一个芬兰的超模或是公主，然后搬去加勒比的一个小岛，建一个城堡，生2.5个小孩。<N><N>你猜猜我做到了哪些？我的垃圾还在垃圾桶中。
$ENTRY_JOURNAL2_CITYSTATES_RIGHT_0_00	
$ENTRY_JOURNAL2_CITYSTATES_LEFT_1_00	
$ENTRY_JOURNAL2_CITYSTATES_RIGHT_1_00	
$ENTRY_JOURNAL2_FIRECULT_TITLE	
$ENTRY_JOURNAL2_FIRECULT_LEFT_00	奎德王族的拜火教
$ENTRY_JOURNAL2_FIRECULT_LEFT_10	奎德帝国拥有较为悠久的历史，它的宗教都是比较古老，虽然它是在岁月中慢慢把周边国家的宗教元素吸收进来。整体而言，王家宗教是以火为中心，比较严谨的一神崇拜。<N><N>王室成员都相信自己是宇宙之焰选中的孩子。只要为奎德帝国带来荣耀，他们就可以获得死后跟随先祖的权利。那些为帝国带来荣耀的王室成员名字会被记录在王宫的巨大石碑中，这就好像是一种通行证，代表着谁在死后可以通过一样。而那些不能为帝国带来任何荣耀的则会收到历史的评击，而且他们的遗体也不能火化，只能土葬，这可以一件非常不名誉的事情，因为火葬是唯一可以回归宇宙之焰的方法。
$ENTRY_JOURNAL2_FIRECULT_RIGHT_0_00	这意味着贵族比起平民享有更多的特权，因为他们肩负着更多的期望。<N><N>很多国王被推翻或是被杀就是因为他们漠视了自己的职责。与艾殊的战争持续了好几代的统治者，因为这在战争中更为容易<LQ>为国家带来荣耀<RQ>。
$ENTRY_JOURNAL2_FIRECULT_LEFT_1_00	
$ENTRY_JOURNAL2_FIRECULT_RIGHT_1_00	
$ENTRY_JOURNAL2_SELINI_TITLE	
$ENTRY_JOURNAL2_SELINI_LEFT_00	瑟连里
$ENTRY_JOURNAL2_SELINI_LEFT_10	艾殊神庙中不同的思想流派是很常见的，瑟连里派就是仿效宗教的始创人瑟连达的生活，追求重整世界的平衡。他们相信通过个人禁欲与侍奉身边的世界就可以做到。很多瑟连里的寺庙都在战乱地区或是其他不平静地区作为医院或是避难所地存在。
$ENTRY_JOURNAL2_SELINI_RIGHT_0_00	
$ENTRY_JOURNAL2_SELINI_LEFT_1_00	
$ENTRY_JOURNAL2_SELINI_RIGHT_1_00	
$ENTRY_JOURNAL2_ASHTEMPLE_TITLE	
$ENTRY_JOURNAL2_ASHTEMPLE_LEFT_00	艾殊神庙
$ENTRY_JOURNAL2_ASHTEMPLE_LEFT_10	艾殊神庙是一个以君主政体为核心的一神宗教，中心思想在于平衡与社区互动。世界就像一部大型机器，一切的动力来自于它的那永恒不变的创造者，每个人都有存在的意义，是这个大型机器中的一个小零件，所以每一个人都有责任保持平衡。不能做到或是失去平衡就是恶魔的象征(这个地方都是被社会结构所控制，大家都很重视指挥链和存在链)。整个宗教的中心就是那座高高的神庙，那曾经是创始人的学校。在神庙仪式中，水是重要的元素，水的不同形态就是保持世界平衡的完美象征。死亡后，那些在地上满足了存活目的的人，会被创造者带往神圣之地，基本上是完美的所在。<N>艾殊神庙是由来自北方的流亡哲学家瑟连达所创立。
$ENTRY_JOURNAL2_ASHTEMPLE_RIGHT_0_00	由于政治对手的逼害,瑟连达向南方出走，为不同的统治者担任幕僚。他在一场谜语比赛击败其他智者后，艾殊的国王就把他迎回国内。由于国王是第一个信徒，所以瑟连达的宗教哲学很快就在整个地区流行起来。<N><N>因为国王是第一个信徒，他的继承者也被视为管理神庙的人。整个王国的周边地区都信奉着同样的宗教，但是还是一艾殊神庙为中心。因为这个原因，艾殊一直都对于周边国家爆发的战争保持中立态度。只有很少的时候，当它的邻居收到威胁，它才会与其他的国家联合起来，共同为保卫神庙而战。这种中立的态度让艾殊成为繁荣的商业中心，大大提高了它的影响力。面对奎德帝国的威胁，艾殊王国周边的小国都联合起来，成为事实联邦，这令到艾殊帝国的规模庞大之余，国内又相对独立。
$ENTRY_JOURNAL2_ASHTEMPLE_LEFT_1_00	
$ENTRY_JOURNAL2_ASHTEMPLE_RIGHT_1_00	
$ENTRY_JOURNAL2_WARRIORMONK_TITLE	
$ENTRY_JOURNAL2_WARRIORMONK_LEFT_00	瑟连里的第9分支-真理与秩序的捍卫者-护教教派
$ENTRY_JOURNAL2_WARRIORMONK_LEFT_10	艾殊宗教最大的灵感来源，尤其是瑟连里等元素的，其实大多来自东方基督教。当我写作的时候，我也有担心这样会不会太明显。我急切希望避免直接复制现实的宗教至虚拟的故事世界中，而不是为这个世界创作更符合其世界观的宗教。<N><N>于是，我开始找寻艾殊哲学跟我灵感中的不同之处，看看那些价值是如何演变为这个设定中特别的一环。其中和平主意立马获得我的注意。东方基督教即使某程度上依然允许有限度度必要暴力，但是还是保留了令人难以置信的和平主意氛围。神职人员是绝对不可以杀人，即使是自卫（平民自卫的话也是不被认同的）。当进行礼拜仪式，就是教会生活的中心时，祭师必须进行
$ENTRY_JOURNAL2_WARRIORMONK_RIGHT_0_00	<LQ>无血献祭<RQ>。(实际上，如果神职人员遇上意外，例如一场有人命伤亡的车祸，他以后就不可以再进行侍奉了。)<N>这看起来跟我所创作的瑟连里哲学有较大的出入。在艾殊的宗教中，暴力是可以被视为进行神圣职务是其中一种必然手段。有时候，对于机器来说，你必须要移除已经坏了的零件，避免它会破坏其他零件。谁会比瑟连里的战士更适合来进行这个任务呢？当瑟连里认为暴力是最后的解决办法是，他们并没有任何禁忌来阻止神职人员或是僧侣去使用暴力，就像我并没有加入<LQ>无血奉献<RQ>作为中心思想。<N><N>这是我们武僧的灵感来源，即使他们并没有在游戏当中出现，但是他们是在背景中存在的。(有很多章节有关瑟连里教派，但是只有很少是与<LQ>护教教派<RQ>有关。巴可是更为爱好和平的教派。)武僧，
$ENTRY_JOURNAL2_WARRIORMONK_LEFT_1_00	，基于种性与社会等级的制度,创造者永恒不变的神圣，还有水的仪式等等，都让我觉得艾殊神庙是一个新东西，而不是从现实世界的宗教照搬过来。
$ENTRY_JOURNAL2_WARRIORMONK_RIGHT_1_00	
$ENTRY_JOURNAL2_ZELEMIR_NAME_TITLE	
$ENTRY_JOURNAL2_ZELEMIR_NAME_LEFT_00	舍里米尔之名
$ENTRY_JOURNAL2_ZELEMIR_NAME_LEFT_10	我选择这个名字的原因有二：1）它以Z开始，听起来很酷， 2）在古老的斯拉夫语中，它的意思是<LQ>对和平的渴望<RQ>。有趣的是，<LQ>和平<RQ>这个字(原文中的<LQ>mir<RQ>)另外一个意思是指<LQ>世界。<RQ>所以他的名字另外一重意义就是<LQ>对世界的渴望。<RQ>我觉得这对于我们心中充满矛盾的坏蛋来说是非常合衬的名字。
$ENTRY_JOURNAL2_ZELEMIR_NAME_RIGHT_0_00	
$ENTRY_JOURNAL2_ZELEMIR_NAME_LEFT_1_00	
$ENTRY_JOURNAL2_ZELEMIR_NAME_RIGHT_1_00	
$ENTRY_JOURNAL2_OUTRO_TITLE	
$ENTRY_JOURNAL2_OUTRO_LEFT_00	完
$ENTRY_JOURNAL2_OUTRO_LEFT_10	那是什么？代表幕后制作日记的完结？
$ENTRY_JOURNAL2_OUTRO_LEFT_20	多么紧张刺激的旅程啊！我们笑过，哭过，我为了追求真理而超越存在！我觉得我们已经建立起联系了，就像你们全是我的兄弟姐妹一样，虽然你们没有抢过我的玩具和图钉配过颜色后钉在我的床单上，让我很凄惨地整个冬天都要睡在那又脏又不舒服的床单上……
$ENTRY_JOURNAL2_OUTRO_LEFT_30	话说回来，这是一个冒险！我希望你们都喜欢这个疯狂又可怕的Defender's Quest: Valley of the Forgotten创作之旅(撇除了那些我哭着入睡，喝着漱口水,偷看邻居有线电视上西班牙语广告的日子)。<N>
$ENTRY_JOURNAL2_OUTRO_RIGHT_0_00	我会在Defender's Quest 2再见到你们的!<N><N>什么，有这样的东西吗？<N><N>是的！它会是超级的酷！<N><N>你应该立马就买下它！<N><N>PS:狼叔，你错过了一个超级棒的生日派对了！有人带了漱口水过来，然后我们都玩疯了。<N><N>PPS:如果你以为我偷看了邻居的有线电视很奇怪，我告诉你是他们偷了人家的线路，我不过是用望远镜看看他们家的电视罢了。
$ENTRY_JOURNAL2_OUTRO_LEFT_1_00	
$ENTRY_JOURNAL2_OUTRO_RIGHT_1_00	
$ENTRY_JOURNAL_END	完
