flag	content
$SCENE_OPENING_TITLE	开幕
$NARR_OPENING_00_TEXT	*我的名字是$MCG
$NARR_OPENING_10_TEXT	我快死了
$NARR_OPENING_20_TEXT	他们不会等待
$NARR_OPENING_30_TEXT	甚至没有时间焚烧尸体
$NARR_OPENING_40_TEXT	只是把尸体弄出城外
$NARR_OPENING_50_TEXT	……然后扔进墓坑
$SCENE_WHERE_AM_I_TITLE	中途世界
$NARR_WHERE_AM_I_00_TEXT	第一幕
$NARR_WHERE_AM_I_00_SUB_TEXT	*一脚踏于此岸，一脚踏于彼岸，灵魂位于中间，$N垂死之人可见万物。
$NARR_WHERE_AM_I_00_SUB_SUB_TEXT	*$N$N$N ——诺曼谚语
$LINE_WHERE_AM_I_00_CHAR	瘟疫受害者
$LINE_WHERE_AM_I_00_TEXT	你能感受到他吗？
$LINE_WHERE_AM_I_10_CHAR	$MCG
$LINE_WHERE_AM_I_10_TEXT	什么？我们在哪儿？
$LINE_WHERE_AM_I_20_CHAR	瘟疫受害者
$LINE_WHERE_AM_I_20_TEXT	他在呼唤我们……
$LINE_WHERE_AM_I_30_CHAR	瘟疫受害者
$LINE_WHERE_AM_I_30_TEXT	来，我们必须加入他……
$LINE_WHERE_AM_I_40_CHAR	瘟疫受害者
$LINE_WHERE_AM_I_40_TEXT	我们已经在半路了……
$LINE_WHERE_AM_I_50_CHAR	$MCG
$LINE_WHERE_AM_I_50_TEXT	你在做什么？你疯了吗？
$LINE_WHERE_AM_I_60_CHAR	瘟疫受害者
$LINE_WHERE_AM_I_60_TEXT	听……
$LINE_WHERE_AM_I_70_CHAR	瘟疫受害者
$LINE_WHERE_AM_I_70_TEXT	他出价那么高……让我们参与……一件重大的事情。
$LINE_WHERE_AM_I_80_CHAR	瘟疫受害者
$LINE_WHERE_AM_I_80_TEXT	只有傻瓜才会拒绝。
$LINE_WHERE_AM_I_90_CHAR	$MCG
$LINE_WHERE_AM_I_90_TEXT	离我远点！
$LINE_WHERE_AM_I_100_CHAR	声音
$LINE_WHERE_AM_I_100_TEXT	所有人都会加入。所有人都会变成容器。
$LINE_WHERE_AM_I_110_CHAR	$MCG
$LINE_WHERE_AM_I_110_TEXT	放我出去！
$LINE_WHERE_AM_I_120_CHAR	声音
$LINE_WHERE_AM_I_120_TEXT	这是命令。
$LINE_WHERE_AM_I_130_CHAR	$MCG
$LINE_WHERE_AM_I_130_TEXT	不能……动了……
$LINE_WHERE_AM_I_140_CHAR	$MCG
$LINE_WHERE_AM_I_140_TEXT	救救我……有人吗……
$LINE_WHERE_AM_I_150_CHAR	$BER
$LINE_WHERE_AM_I_150_TEXT	什么？！那个发狂的——在哪里？！
$SCENE_MEET_BERSERKER_TITLE	奇怪的新朋友
$LINE_MEET_BERSERKER_00_CHAR	$MCG
$LINE_MEET_BERSERKER_00_TEXT	哇哦。
$LINE_MEET_BERSERKER_10_CHAR	$MCG
$LINE_MEET_BERSERKER_10_TEXT	发生了什么？
$LINE_MEET_BERSERKER_20_CHAR	$BER
$LINE_MEET_BERSERKER_20_TEXT	我不知道。五分钟前你是一具尸体，而我只是想扒几双新鞋。
$LINE_MEET_BERSERKER_30_CHAR	$BER
$LINE_MEET_BERSERKER_30_TEXT	好消息！你活了，而且好像也没有再感染瘟疫了。
$LINE_MEET_BERSERKER_40_CHAR	$MCG
$LINE_MEET_BERSERKER_40_TEXT	哪里——？
$LINE_MEET_BERSERKER_50_CHAR	$BER
$LINE_MEET_BERSERKER_50_TEXT	坏消息是，这意味着我得不到新鞋了。
$LINE_MEET_BERSERKER_60_CHAR	$BER
$LINE_MEET_BERSERKER_60_TEXT	还有，你现在和我们一样，被困在这个瘟疫群落里了。
$LINE_MEET_BERSERKER_70_CHAR	$MCG
$LINE_MEET_BERSERKER_70_TEXT	墓坑……
$LINE_MEET_BERSERKER_80_CHAR	$BER
$LINE_MEET_BERSERKER_80_TEXT	开心点！你活过来了，所以你现在对瘟疫已经免疫了。
$LINE_MEET_BERSERKER_90_CHAR	$MCG
$LINE_MEET_BERSERKER_90_TEXT	既然这样，守卫会让我们出去，对吗？
$LINE_MEET_BERSERKER_100_CHAR	$BER
$LINE_MEET_BERSERKER_100_TEXT	你可以去试着跟他们解释一下，但是他们貌似不太擅长倾听。
$LINE_MEET_BERSERKER_110_CHAR	$BER
$LINE_MEET_BERSERKER_110_TEXT	*他们似乎分不清“洗耳恭听”，$N和“把你射成筛子”的区别。
$LINE_MEET_BERSERKER_120_CHAR	$BER
$LINE_MEET_BERSERKER_120_TEXT	真的。我不知道艾殊王国是怎么进行礼仪培训的。
$LINE_MEET_BERSERKER_130_CHAR	$MCG
$LINE_MEET_BERSERKER_130_TEXT	……
$LINE_MEET_BERSERKER_140_CHAR	$MCG
$LINE_MEET_BERSERKER_140_TEXT	我还是没有搞懂……那里……发生了什么……
$LINE_MEET_BERSERKER_150_CHAR	$BER
$LINE_MEET_BERSERKER_150_TEXT	别担心了。我一开始得瘟疫的时候也有过一样的幻觉。
$LINE_MEET_BERSERKER_160_CHAR	$MCG
$LINE_MEET_BERSERKER_160_TEXT	等一下——你当时和我在一起的！那怎么会是幻觉、
$LINE_MEET_BERSERKER_170_CHAR	$BER
$LINE_MEET_BERSERKER_170_TEXT	噢，那是什么？商队！
$LINE_MEET_BERSERKER_180_CHAR	$MCG
$LINE_MEET_BERSERKER_180_TEXT	等一下！
$LINE_MEET_BERSERKER_190_CHAR	$MCG
$LINE_MEET_BERSERKER_190_TEXT	至少告诉我你的名字！
$SCENE_SECOND_BATTLE_TITLE	死亡商队
$LINE_SECOND_BATTLE_00_CHAR	$BER
$LINE_SECOND_BATTLE_00_TEXT	嘿，商队的伙计们！谁有鞋子吗？
$LINE_SECOND_BATTLE_10_CHAR	被感染的商队守卫
$LINE_SECOND_BATTLE_10_TEXT	请……进贡……为了奥斯蒙……
$LINE_SECOND_BATTLE_20_CHAR	$BER
$LINE_SECOND_BATTLE_20_TEXT	噢哦。
$LINE_SECOND_BATTLE_30_CHAR	$MCG
$LINE_SECOND_BATTLE_30_TEXT	这些人是谁？
$LINE_SECOND_BATTLE_40_CHAR	$BER
$LINE_SECOND_BATTLE_40_TEXT	我们必须离开这里，马上。
$LINE_SECOND_BATTLE_50_CHAR	$MCG
$LINE_SECOND_BATTLE_50_TEXT	但是他们需要帮助！
$LINE_SECOND_BATTLE_60_CHAR	$BER
$LINE_SECOND_BATTLE_60_TEXT	啊哈哈，不。
$LINE_SECOND_BATTLE_70_CHAR	$MCG
$LINE_SECOND_BATTLE_70_TEXT	我们不能就这样丢下他们！
$LINE_SECOND_BATTLE_80_CHAR	$BER
$LINE_SECOND_BATTLE_80_TEXT	他们中了瘟疫了。
$LINE_SECOND_BATTLE_90_CHAR	$MCG
$LINE_SECOND_BATTLE_90_TEXT	但是我们都免疫了，对吗？
$LINE_SECOND_BATTLE_100_CHAR	$BER
$LINE_SECOND_BATTLE_100_TEXT	但是对于他们转过身来吃掉我们的脸这件事，我们是无法免疫的。
$LINE_SECOND_BATTLE_110_CHAR	$MCG
$LINE_SECOND_BATTLE_110_TEXT	转过身？
$LINE_SECOND_BATTLE_120_CHAR	得疫病的商队守卫
$LINE_SECOND_BATTLE_120_TEXT	噢！啊啊啊啊啊啊啊啊啊啊！
$LINE_SECOND_BATTLE_130_CHAR	$BER
$LINE_SECOND_BATTLE_130_TEXT	就像那样。
$LINE_SECOND_BATTLE_140_CHAR	$BER
$LINE_SECOND_BATTLE_140_TEXT	好吧，很高兴见到你。
$LINE_SECOND_BATTLE_150_CHAR	$MCG
$LINE_SECOND_BATTLE_150_TEXT	等等！
$LINE_SECOND_BATTLE_160_CHAR	$BER
$LINE_SECOND_BATTLE_160_TEXT	……
$LINE_SECOND_BATTLE_170_CHAR	$BER
$LINE_SECOND_BATTLE_170_TEXT	你还好吗？
$SCENE_TALK_BERSERKER_TITLE	仓库突袭
$LINE_TALK_BERSERKER_00_CHAR	$MCG
$LINE_TALK_BERSERKER_00_TEXT	那些人……他们都变成怪物了！
$LINE_TALK_BERSERKER_10_CHAR	$BER
$LINE_TALK_BERSERKER_10_TEXT	你一定是新来的。
$LINE_TALK_BERSERKER_20_CHAR	$BER
$LINE_TALK_BERSERKER_20_TEXT	不能在瘟疫中存活的人就会是那个下场。
$LINE_TALK_BERSERKER_30_CHAR	$MCG
$LINE_TALK_BERSERKER_30_TEXT	我们之前到过同样的地方……半路之地……
$LINE_TALK_BERSERKER_40_CHAR	$MCG
$LINE_TALK_BERSERKER_40_TEXT	这个地方太恐怖了！我……我必须得离开这里！
$LINE_TALK_BERSERKER_50_CHAR	$BER
$LINE_TALK_BERSERKER_50_TEXT	算了吧，人们已经尝试从墓坑逃跑有十年了。
$LINE_TALK_BERSERKER_60_CHAR	$MCG
$LINE_TALK_BERSERKER_60_TEXT	这已经有十年了？！
$LINE_TALK_BERSERKER_70_CHAR	$BER
$LINE_TALK_BERSERKER_70_TEXT	让我猜猜，你是从首都来的，是吧？
$LINE_TALK_BERSERKER_80_CHAR	$MCG
$LINE_TALK_BERSERKER_80_TEXT	我是皇家图书管理员……
$LINE_TALK_BERSERKER_90_CHAR	$BER
$LINE_TALK_BERSERKER_90_TEXT	看出来了。摄政王做事真是滴水不漏。
$LINE_TALK_BERSERKER_100_CHAR	$BER
$LINE_TALK_BERSERKER_100_TEXT	我猜你也不知道战争已经结束了吧。
$LINE_TALK_BERSERKER_110_CHAR	$MCG
$LINE_TALK_BERSERKER_110_TEXT	战争结束了？！但是那些士兵……那……那些军队都被派遣到哪里去了？
$LINE_TALK_BERSERKER_120_CHAR	$BER
$LINE_TALK_BERSERKER_120_TEXT	嘿？还记的把人们变成怪物的瘟疫吗？那需要很多的人力去控制！
$LINE_TALK_BERSERKER_130_CHAR	$MCG
$LINE_TALK_BERSERKER_130_TEXT	这……对不起，我只是……我只是需要一本好书和一瓶——不，两瓶酒。
$LINE_TALK_BERSERKER_140_CHAR	$BER
$LINE_TALK_BERSERKER_140_TEXT	嘿，朝好的一面看吧——至少亡者都离开了。
$LINE_TALK_BERSERKER_150_CHAR	$BER
$LINE_TALK_BERSERKER_150_TEXT	等等，他们没有离开，他们都死了！
$LINE_TALK_BERSERKER_160_CHAR	$BER
$LINE_TALK_BERSERKER_160_TEXT	从来没有人做过那样的事！
$LINE_TALK_BERSERKER_170_CHAR	$MCG
$LINE_TALK_BERSERKER_170_TEXT	什么？
$LINE_TALK_BERSERKER_180_CHAR	$BER
$LINE_TALK_BERSERKER_180_TEXT	亡者不会死……至少他们曾经不会死！
$LINE_TALK_BERSERKER_190_CHAR	$BER
$LINE_TALK_BERSERKER_190_TEXT	噢，伙计，这真是我的幸运日！
$LINE_TALK_BERSERKER_200_CHAR	$BER
$LINE_TALK_BERSERKER_200_TEXT	我交到了以为新的好友，而且他还有神秘的魔法力量……
$LINE_TALK_BERSERKER_210_CHAR	$BER
$LINE_TALK_BERSERKER_210_TEXT	而且一辆无人看守的拖车就是无尽的财富！我们发财了！发财了！我告诉你！
$LINE_TALK_BERSERKER_220_CHAR	$BER
$LINE_TALK_BERSERKER_220_TEXT	那些是鞋子吗？
$LINE_TALK_BERSERKER_221_CHAR	$MCG
$LINE_TALK_BERSERKER_221_TEXT	把那三瓶……
$SCENE_CAUGHT_BY_OZIMAL_TITLE	被捕
$LINE_CAUGHT_BY_OZIMAL_00_CHAR	$MCG
$LINE_CAUGHT_BY_OZIMAL_00_TEXT	*$BER，这些都是垃圾……
$LINE_CAUGHT_BY_OZIMAL_10_CHAR	大家伙
$LINE_CAUGHT_BY_OZIMAL_10_TEXT	强盗。我早该料到的。
$LINE_CAUGHT_BY_OZIMAL_20_CHAR	$MCG
$LINE_CAUGHT_BY_OZIMAL_20_TEXT	你是谁？
$LINE_CAUGHT_BY_OZIMAL_30_CHAR	奥斯蒙
$LINE_CAUGHT_BY_OZIMAL_30_TEXT	我是奥斯蒙·卡兹，墓坑战神，这些贡品是我的。
$LINE_CAUGHT_BY_OZIMAL_40_CHAR	$MCG
$LINE_CAUGHT_BY_OZIMAL_40_TEXT	等等，我才到这里，我不知道——
$LINE_CAUGHT_BY_OZIMAL_50_CHAR	奥斯蒙
$LINE_CAUGHT_BY_OZIMAL_50_TEXT	守卫，把这些没用的贼都扔进竞技场里！
$LINE_CAUGHT_BY_OZIMAL_60_CHAR	奥斯蒙
$LINE_CAUGHT_BY_OZIMAL_60_TEXT	让他们知道，偷奥斯蒙·卡兹的东西是什么下场。
$SCENE_COLISEUM_INTRO_TITLE	竞技场
$LINE_COLISEUM_INTRO_00_CHAR	$MCG
$LINE_COLISEUM_INTRO_00_TEXT	这看起来不妙。
$LINE_COLISEUM_INTRO_10_CHAR	囚犯
$LINE_COLISEUM_INTRO_10_TEXT	我猜这是你第一次受刑？
$LINE_COLISEUM_INTRO_20_CHAR	$MCG
$LINE_COLISEUM_INTRO_20_TEXT	受刑？
$LINE_COLISEUM_INTRO_30_CHAR	囚犯
$LINE_COLISEUM_INTRO_30_TEXT	是啊。马上他们就会打开那些大门，然后成群结队的野兽就会涌进来把我们吃掉。
$LINE_COLISEUM_INTRO_40_CHAR	$MCG
$LINE_COLISEUM_INTRO_40_TEXT	所以我们……必死无疑了？
$LINE_COLISEUM_INTRO_50_CHAR	囚犯
$LINE_COLISEUM_INTRO_50_TEXT	是的，欢迎来到墓坑。
$LINE_COLISEUM_INTRO_60_CHAR	囚犯
$LINE_COLISEUM_INTRO_60_TEXT	我还不认识你，公主，但是我打算坚持到底。
$LINE_COLISEUM_INTRO_70_CHAR	$MCG
$LINE_COLISEUM_INTRO_70_TEXT	*等等！如果我们必死无疑，那至少我们应该知道彼此的名字。我是$MCG。
$LINE_COLISEUM_INTRO_80_CHAR	囚犯
$LINE_COLISEUM_INTRO_80_TEXT	很高兴认识你。我是……
$SCENE_COLISEUM_OUTRO_TITLE	迎难而上
$LINE_COLISEUM_OUTRO_00_CHAR	守卫
$LINE_COLISEUM_OUTRO_00_TEXT	长官！亡者都死了！
$LINE_COLISEUM_OUTRO_10_CHAR	奥斯蒙
$LINE_COLISEUM_OUTRO_10_TEXT	不可能。没人可以杀死一个亡者。
$LINE_COLISEUM_OUTRO_20_CHAR	守卫
$LINE_COLISEUM_OUTRO_20_TEXT	是那个新来的姑娘……我不知道她做了什么，但是囚犯都还活着，但是亡者都死了。
$LINE_COLISEUM_OUTRO_30_CHAR	奥斯蒙
$LINE_COLISEUM_OUTRO_30_TEXT	有意思……
$LINE_COLISEUM_OUTRO_40_CHAR	奥斯蒙
$LINE_COLISEUM_OUTRO_40_TEXT	把他们扔进监狱。
$LINE_COLISEUM_OUTRO_50_CHAR	守卫
$LINE_COLISEUM_OUTRO_50_TEXT	是！长官！
$LINE_COLISEUM_OUTRO_60_CHAR	奥斯蒙
$LINE_COLISEUM_OUTRO_60_TEXT	然后，寄一封信给我们的朋友，收藏家。
$LINE_COLISEUM_OUTRO_70_CHAR	奥斯蒙
$LINE_COLISEUM_OUTRO_70_TEXT	告诉他，我有一件有趣的新宝贝想要出售。
$SCENE_OZIMAL_PRISON_TITLE	身陷囹圄
$LINE_OZIMAL_PRISON_00_CHAR	$RAN
$LINE_OZIMAL_PRISON_00_TEXT	好吧，你做了什么？
$LINE_OZIMAL_PRISON_10_CHAR	$RAN
$LINE_OZIMAL_PRISON_10_TEXT	我感觉……我的心脏被同时向着两个方向用力撕扯着。
$LINE_OZIMAL_PRISON_20_CHAR	$MCG
$LINE_OZIMAL_PRISON_20_TEXT	对不起，我真不知道。我只知道它起作用了。
$LINE_OZIMAL_PRISON_30_CHAR	$MCG
$LINE_OZIMAL_PRISON_30_TEXT	但是我们还活着！或者就有意义，对吗？
$LINE_OZIMAL_PRISON_40_CHAR	$RAN
$LINE_OZIMAL_PRISON_40_TEXT	很显然，活着，然后疯了。上帝啊，我需要一杯酒。
$LINE_OZIMAL_PRISON_50_CHAR	$MCG
$LINE_OZIMAL_PRISON_50_TEXT	我也是。
$LINE_OZIMAL_PRISON_60_CHAR	神秘的陌生人
$LINE_OZIMAL_PRISON_60_TEXT	*嘘！$MCG！这边！
$LINE_OZIMAL_PRISON_70_CHAR	$MCG
$LINE_OZIMAL_PRISON_70_TEXT	你怎么知道我的名字？
$LINE_OZIMAL_PRISON_80_CHAR	神秘的陌生人
$LINE_OZIMAL_PRISON_80_TEXT	守卫很快就会回来。如果你想要活着离开这里，你就必须好好听着。
$LINE_OZIMAL_PRISON_90_CHAR	$MCG
$LINE_OZIMAL_PRISON_90_TEXT	你是谁？
$LINE_OZIMAL_PRISON_100_CHAR	神秘的陌生人
$LINE_OZIMAL_PRISON_100_TEXT	一个朋友。
$LINE_OZIMAL_PRISON_110_CHAR	神秘的陌生人
$LINE_OZIMAL_PRISON_110_TEXT	仔细挺好：明天奥斯蒙打算把你卖给一个红衣人。我要阻止这件事情。
$LINE_OZIMAL_PRISON_120_CHAR	$MCG
$LINE_OZIMAL_PRISON_120_TEXT	……
$LINE_OZIMAL_PRISON_130_CHAR	神秘的陌生人
$LINE_OZIMAL_PRISON_130_TEXT	他会把你再次送回竞技场，让你示范你的技能。
$LINE_OZIMAL_PRISON_140_CHAR	$MCG
$LINE_OZIMAL_PRISON_140_TEXT	你怎么——？
$LINE_OZIMAL_PRISON_150_CHAR	神秘的陌生人
$LINE_OZIMAL_PRISON_150_TEXT	这时候，我会想办法干扰大家的注意力。你必须趁机逃走。
$LINE_OZIMAL_PRISON_160_CHAR	神秘的陌生人
$LINE_OZIMAL_PRISON_160_TEXT	拿上这个。用它来贿赂你的囚犯朋友们，让他们帮助你。你明天必须做好准备。
$LINE_OZIMAL_PRISON_170_CHAR	$MCG
$LINE_OZIMAL_PRISON_170_TEXT	你为什么要帮我？
$LINE_OZIMAL_PRISON_180_CHAR	神秘的陌生人
$LINE_OZIMAL_PRISON_180_TEXT	目前你知道的越少越安全。回头去修道院找我。我会把一切解释给你听。
$LINE_OZIMAL_PRISON_190_CHAR	$MCG
$LINE_OZIMAL_PRISON_190_TEXT	好吧……
$LINE_OZIMAL_PRISON_200_CHAR	神秘的陌生人
$LINE_OZIMAL_PRISON_200_TEXT	*$MCG，你一定不能落在他的手上。
$SCENE_COLISEUM_2_INTRO_TITLE	小小的示范
$LINE_COLISEUM_2_INTRO_00_CHAR	奥斯蒙
$LINE_COLISEUM_2_INTRO_00_TEXT	那么，我尊贵的客人，外面的世界发生了些什么？
$LINE_COLISEUM_2_INTRO_10_CHAR	红衣人
$LINE_COLISEUM_2_INTRO_10_TEXT	瘟疫已经完全摧毁了奎德帝国。除了那些成群结队的扭曲残暴的受感染者，其他一切都已经不复存在。
$LINE_COLISEUM_2_INTRO_20_CHAR	奥斯蒙
$LINE_COLISEUM_2_INTRO_20_TEXT	噢，这真是令人欣喜的消息。
$LINE_COLISEUM_2_INTRO_30_CHAR	红衣人
$LINE_COLISEUM_2_INTRO_30_TEXT	现在瘟疫已经传到了艾殊王国。如果不采取任何措施，疫病将完成奎德军队都无法完成的事情。
$LINE_COLISEUM_2_INTRO_40_CHAR	奥斯蒙
$LINE_COLISEUM_2_INTRO_40_TEXT	好吧，只要恐慌的阿萨尼持续不断的流放那些被感染者，我们墓坑统治者就有生意可做。
$LINE_COLISEUM_2_INTRO_50_CHAR	奥斯蒙
$LINE_COLISEUM_2_INTRO_50_TEXT	那些瘟疫巨兽对于能善加利用的人来说是一笔非常宝贵的资源，对吧？
$LINE_COLISEUM_2_INTRO_60_CHAR	红衣人
$LINE_COLISEUM_2_INTRO_60_TEXT	谈话就到此为止吧。那个女孩在哪儿？
$LINE_COLISEUM_2_INTRO_70_CHAR	奥斯蒙
$LINE_COLISEUM_2_INTRO_70_TEXT	在那边。我想你对于她的能力会非常感兴趣的。
$LINE_COLISEUM_2_INTRO_80_CHAR	红衣人
$LINE_COLISEUM_2_INTRO_80_TEXT	让我们拭目以待吧。
$LINE_COLISEUM_2_INTRO_90_CHAR	奥斯蒙
$LINE_COLISEUM_2_INTRO_90_TEXT	她陷入了一种精神恍惚的状态，她的同伴们似乎渐渐融入虚无之中。
$LINE_COLISEUM_2_INTRO_100_CHAR	奥斯蒙
$LINE_COLISEUM_2_INTRO_100_TEXT	在他们周围，亡者们成堆的倒下死去，就像是被无形的弓箭击杀一样。
$LINE_COLISEUM_2_INTRO_110_CHAR	红衣人
$LINE_COLISEUM_2_INTRO_110_TEXT	让我看看。
$LINE_COLISEUM_2_INTRO_120_CHAR	奥斯蒙
$LINE_COLISEUM_2_INTRO_120_TEXT	守卫，释放亡者！
$SCENE_COLISEUM_2_OUTRO_TITLE	大胆越狱
$LINE_COLISEUM_2_OUTRO_00_CHAR	红衣人
$LINE_COLISEUM_2_OUTRO_00_TEXT	难以置信。她能看到它们真实的样子。
$LINE_COLISEUM_2_OUTRO_10_CHAR	红衣人
$LINE_COLISEUM_2_OUTRO_10_TEXT	她在它们自己的世界中和它们战斗。
$LINE_COLISEUM_2_OUTRO_20_CHAR	奥斯蒙
$LINE_COLISEUM_2_OUTRO_20_TEXT	那么，你是否有兴趣？
$LINE_COLISEUM_2_OUTRO_30_CHAR	红衣人
$LINE_COLISEUM_2_OUTRO_30_TEXT	*考虑到双倍的价格，$N这可不算是我认知当中的公平交易。
$LINE_COLISEUM_2_OUTRO_40_CHAR	红衣人
$LINE_COLISEUM_2_OUTRO_40_TEXT	这是什么？
$LINE_COLISEUM_2_OUTRO_50_CHAR	奥斯蒙
$LINE_COLISEUM_2_OUTRO_50_TEXT	守卫！
$LINE_COLISEUM_2_OUTRO_60_CHAR	守卫
$LINE_COLISEUM_2_OUTRO_60_TEXT	长官，竞技场的南墙崩塌了！
$LINE_COLISEUM_2_OUTRO_70_CHAR	守卫
$LINE_COLISEUM_2_OUTRO_70_TEXT	囚犯们都逃跑了！
$LINE_COLISEUM_2_OUTRO_80_CHAR	奥斯蒙
$LINE_COLISEUM_2_OUTRO_80_TEXT	什么！
$LINE_COLISEUM_2_OUTRO_90_CHAR	奥斯蒙
$LINE_COLISEUM_2_OUTRO_90_TEXT	释放亡者！全力追击！
$SCENE_RIVER_INTRO_TITLE	渡河
$LINE_RIVER_INTRO_00_CHAR	$MCG
$LINE_RIVER_INTRO_00_TEXT	大家走这边！
$LINE_RIVER_INTRO_10_CHAR	$RAN
$LINE_RIVER_INTRO_10_TEXT	没有用，他们在逼近！
$LINE_RIVER_INTRO_20_CHAR	$MCG
$LINE_RIVER_INTRO_20_TEXT	快点，过河！我们可以在浅滩那里拖住他们！
$LINE_RIVER_INTRO_30_CHAR	$RAN
$LINE_RIVER_INTRO_30_TEXT	他们人太多了！
$LINE_RIVER_INTRO_40_CHAR	$BER
$LINE_RIVER_INTRO_40_TEXT	只有一件事可以做了……
$LINE_RIVER_INTRO_50_CHAR	$BER
$LINE_RIVER_INTRO_50_TEXT	疯狂自杀狂暴时间！！
$LINE_RIVER_INTRO_60_CHAR	$MCG
$LINE_RIVER_INTRO_60_TEXT	我认为你似乎想到了点什么……
$LINE_RIVER_INTRO_61_CHAR	$MCG
$LINE_RIVER_INTRO_61_TEXT	这是什么感觉？好像我——
$LINE_RIVER_INTRO_70_CHAR	$BER
$LINE_RIVER_INTRO_70_TEXT	像是你想要屠戮一切移动的东西，然后在漫天撒落的内脏残渣中舞蹈，然后想象自己是在生日聚会上的潮湿彩带纸屑中舞蹈？
$LINE_RIVER_INTRO_71_CHAR	$MCG
$LINE_RIVER_INTRO_71_TEXT	……
$LINE_RIVER_INTRO_72_CHAR	$MCG
$LINE_RIVER_INTRO_72_TEXT	……没错？
$SCENE_RIVER_OUTRO_TITLE	继续逃亡
$NARR_RIVER_OUTRO_00_TEXT	第二幕
$NARR_RIVER_OUTRO_00_SUB_TEXT	*我唾弃的看着叛徒的眼睛，他亲手谋杀了荣誉。$N愿他溺死在自己的血泊中。$N愿他的尸体在腐烂进土地里。$N愿严寒永久地吞噬他的骸骨。
$NARR_RIVER_OUTRO_00_SUB_SUB_TEXT	*$N$N$N$N$N——摘自奎德的就职宣言
$LINE_RIVER_OUTRO_00_CHAR	$BER
$LINE_RIVER_OUTRO_00_TEXT	谁准备好参加第二轮了？
$LINE_RIVER_OUTRO_10_CHAR	$BER
$LINE_RIVER_OUTRO_10_TEXT	我要撕烂你们的脸，再用你们的头骨来种装饰盆栽！
$LINE_RIVER_OUTRO_20_CHAR	$MCG
$LINE_RIVER_OUTRO_20_TEXT	*$BER，他们都死了……而且，你所有的盆栽都会闻起来像死人的。
$LINE_RIVER_OUTRO_30_CHAR	$BER
$LINE_RIVER_OUTRO_30_TEXT	噢。
$LINE_RIVER_OUTRO_40_CHAR	$BER
$LINE_RIVER_OUTRO_40_TEXT	那现在的计划是什么？
$LINE_RIVER_OUTRO_50_CHAR	$MCG
$LINE_RIVER_OUTRO_50_TEXT	嗯，那个神秘的老人说去<LQ>修道院<RQ>找他……
$LINE_RIVER_OUTRO_60_CHAR	$BER
$LINE_RIVER_OUTRO_60_TEXT	啊，他说的肯定是墓坑北边的瑟连里会堂。
$LINE_RIVER_OUTRO_70_CHAR	$MCG
$LINE_RIVER_OUTRO_70_TEXT	这里有艾殊神庙的僧侣吗……在这个瘟疫群落里？
$LINE_RIVER_OUTRO_80_CHAR	$BER
$LINE_RIVER_OUTRO_80_TEXT	有什么比医院更好的地方吗？来，我来给你指路。
$LINE_RIVER_OUTRO_90_CHAR	$RAN
$LINE_RIVER_OUTRO_90_TEXT	你信任这家伙？
$LINE_RIVER_OUTRO_100_CHAR	$MCG
$LINE_RIVER_OUTRO_100_TEXT	好吧，他非常的疯狂，的确如此，但是他看起来很忠诚。面对朋友的时候不能太吹毛求疵。
$LINE_RIVER_OUTRO_110_CHAR	$RAN
$LINE_RIVER_OUTRO_110_TEXT	不，我不是指小丑，我是指那个神秘的老人。
$LINE_RIVER_OUTRO_120_CHAR	$MCG
$LINE_RIVER_OUTRO_120_TEXT	如果他是一位艾殊神庙的僧侣，那我们就没有什么可以担心的。
$LINE_RIVER_OUTRO_130_CHAR	$RAN
$LINE_RIVER_OUTRO_130_TEXT	你认为你的修道院从来没有做过什么肮脏的事吗？
$LINE_RIVER_OUTRO_140_CHAR	$MCG
$LINE_RIVER_OUTRO_140_TEXT	嘿，你要是不信任他你不必一起来。
$LINE_RIVER_OUTRO_150_CHAR	$RAN
$LINE_RIVER_OUTRO_150_TEXT	然后也放弃跟你一起逃走的机会？如果可以逃离这个魔窟的话，我愿意接纳整个艾殊王国。
$LINE_RIVER_OUTRO_160_CHAR	$RAN
$LINE_RIVER_OUTRO_160_TEXT	只是——小心行事，好吗？
$SCENE_RANGER_TOWN_INTRO_TITLE	踏上征途
$LINE_RANGER_TOWN_INTRO_00_CHAR	$RAN
$LINE_RANGER_TOWN_INTRO_00_TEXT	*听着，$MCG，如果我们要去修道院，我认为我们需要更多的人。
$LINE_RANGER_TOWN_INTRO_10_CHAR	$MCG
$LINE_RANGER_TOWN_INTRO_10_TEXT	*嗯，我们已经有$BER了。
$LINE_RANGER_TOWN_INTRO_20_CHAR	$RAN
$LINE_RANGER_TOWN_INTRO_20_TEXT	我是说……正常人。
$LINE_RANGER_TOWN_INTRO_30_CHAR	$RAN
$LINE_RANGER_TOWN_INTRO_30_TEXT	真正可以和你并肩作战的人。
$LINE_RANGER_TOWN_INTRO_40_CHAR	$RAN
$LINE_RANGER_TOWN_INTRO_40_TEXT	装备着护甲的人。
$LINE_RANGER_TOWN_INTRO_50_CHAR	$BER
$LINE_RANGER_TOWN_INTRO_50_TEXT	什么，然后遮掩住这完美的身材？
$LINE_RANGER_TOWN_INTRO_60_CHAR	$RAN
$LINE_RANGER_TOWN_INTRO_60_TEXT	是的……我们雇佣一些增援部队吧。
$LINE_RANGER_TOWN_INTRO_70_CHAR	$BER
$LINE_RANGER_TOWN_INTRO_70_TEXT	什么？有我就够了！我可是拥有金刚不坏之身的人！
$LINE_RANGER_TOWN_INTRO_80_CHAR	$RAN
$LINE_RANGER_TOWN_INTRO_80_TEXT	……还有醉酒黄鼠狼之脑。
$LINE_RANGER_TOWN_INTRO_90_CHAR	$BER
$LINE_RANGER_TOWN_INTRO_90_TEXT	……醉酒黄鼠狼！天呐！
$SCENE_RANGER_TOWN_FIGHT_INTRO_TITLE	四面楚歌
$LINE_RANGER_TOWN_FIGHT_INTRO_00_CHAR	$MCG
$LINE_RANGER_TOWN_FIGHT_INTRO_00_TEXT	他们发现我们了！城镇正在受到攻击！
$LINE_RANGER_TOWN_FIGHT_INTRO_10_CHAR	奥斯蒙
$LINE_RANGER_TOWN_FIGHT_INTRO_10_TEXT	守卫，发动攻击！
$LINE_RANGER_TOWN_FIGHT_INTRO_20_CHAR	奥斯蒙
$LINE_RANGER_TOWN_FIGHT_INTRO_20_TEXT	她很值钱！给我抓活的！
$LINE_RANGER_TOWN_FIGHT_INTRO_30_CHAR	奥斯蒙
$LINE_RANGER_TOWN_FIGHT_INTRO_30_TEXT	其余人随意处置。
$LINE_RANGER_TOWN_FIGHT_INTRO_40_CHAR	奥斯蒙
$LINE_RANGER_TOWN_FIGHT_INTRO_40_TEXT	释放亡者！
$SCENE_RANGER_TOWN_FIGHT_OUTRO_TITLE	救援部队
$LINE_RANGER_TOWN_FIGHT_OUTRO_00_CHAR	奥斯蒙
$LINE_RANGER_TOWN_FIGHT_OUTRO_00_TEXT	什么，整个城镇都是死人，但是没有抓到一个囚犯？！
$LINE_RANGER_TOWN_FIGHT_OUTRO_10_CHAR	守卫
$LINE_RANGER_TOWN_FIGHT_OUTRO_10_TEXT	长官，我们没有足够的亡者了。
$LINE_RANGER_TOWN_FIGHT_OUTRO_20_CHAR	奥斯蒙
$LINE_RANGER_TOWN_FIGHT_OUTRO_20_TEXT	你以为我不知道吗？滚开！
$LINE_RANGER_TOWN_FIGHT_OUTRO_30_CHAR	奥斯蒙
$LINE_RANGER_TOWN_FIGHT_OUTRO_30_TEXT	没用的饭桶。
$LINE_RANGER_TOWN_FIGHT_OUTRO_40_CHAR	红衣人
$LINE_RANGER_TOWN_FIGHT_OUTRO_40_TEXT	不能让他们跑了。
$LINE_RANGER_TOWN_FIGHT_OUTRO_50_CHAR	奥斯蒙
$LINE_RANGER_TOWN_FIGHT_OUTRO_50_TEXT	我能怎么办？我的亡者大军都快被摧毁了。
$LINE_RANGER_TOWN_FIGHT_OUTRO_60_CHAR	奥斯蒙
$LINE_RANGER_TOWN_FIGHT_OUTRO_60_TEXT	我们没有足够的后续部队了。
$LINE_RANGER_TOWN_FIGHT_OUTRO_70_CHAR	红衣人
$LINE_RANGER_TOWN_FIGHT_OUTRO_70_TEXT	看看你周围。你看到了什么？
$LINE_RANGER_TOWN_FIGHT_OUTRO_80_CHAR	奥斯蒙
$LINE_RANGER_TOWN_FIGHT_OUTRO_80_TEXT	我看到了成堆的尸体，但是没有我们要找的人！
$LINE_RANGER_TOWN_FIGHT_OUTRO_90_CHAR	红衣人
$LINE_RANGER_TOWN_FIGHT_OUTRO_90_TEXT	继续追击。
$LINE_RANGER_TOWN_FIGHT_OUTRO_100_CHAR	红衣人
$LINE_RANGER_TOWN_FIGHT_OUTRO_100_TEXT	我们已经有足够的增援部队了。
$SCENE_2_2_INTRO_TITLE	老友，新敌
$LINE_2_2_INTRO_00_CHAR	$RAN
$LINE_2_2_INTRO_00_TEXT	等等，路上有人。
$LINE_2_2_INTRO_10_CHAR	$RAN
$LINE_2_2_INTRO_10_TEXT	是其他游侠吗……？
$LINE_2_2_INTRO_20_CHAR	$RAN
$LINE_2_2_INTRO_20_TEXT	其他人一定从村子里逃出来了！
$LINE_2_2_INTRO_30_CHAR	$RAN
$LINE_2_2_INTRO_30_TEXT	等等……有点不对劲！
$LINE_2_2_INTRO_40_CHAR	亡者
$LINE_2_2_INTRO_40_TEXT	哈……
$LINE_2_2_INTRO_50_CHAR	$RAN
$LINE_2_2_INTRO_50_TEXT	我们被攻击了！
$SCENE_2_2_OUTRO_TITLE	一日之间
$LINE_2_2_OUTRO_00_CHAR	$MCG
$LINE_2_2_OUTRO_00_TEXT	那些亡者……
$LINE_2_2_OUTRO_10_CHAR	$RAN
$LINE_2_2_OUTRO_10_TEXT	它们是从村子里来的。
$LINE_2_2_OUTRO_20_CHAR	$MCG
$LINE_2_2_OUTRO_20_TEXT	你是说所有人都被……变成亡者了？
$LINE_2_2_OUTRO_30_CHAR	$RAN
$LINE_2_2_OUTRO_30_TEXT	那里所有人都应该对瘟疫免疫。那些幸存者已经免疫了啊。
$LINE_2_2_OUTRO_40_CHAR	$MCG
$LINE_2_2_OUTRO_40_TEXT	我不觉得他们是自愿变成亡者的。
$LINE_2_2_OUTRO_50_CHAR	$RAN
$LINE_2_2_OUTRO_50_TEXT	红衣人……
$SCENE_CARAVAN_TOWN_INTRO_TITLE	我叫大块头布林奇
$LINE_CARAVAN_TOWN_INTRO_00_CHAR	$MCG
$LINE_CARAVAN_TOWN_INTRO_00_TEXT	我想我们失去它们了！
$LINE_CARAVAN_TOWN_INTRO_10_CHAR	$BER
$LINE_CARAVAN_TOWN_INTRO_10_TEXT	噢伙计，我只想再要三块亡者头骨来完成我的项链！
$LINE_CARAVAN_TOWN_INTRO_20_CHAR	$BER
$LINE_CARAVAN_TOWN_INTRO_20_TEXT	过来看！
$LINE_CARAVAN_TOWN_INTRO_30_CHAR	$BER
$LINE_CARAVAN_TOWN_INTRO_30_TEXT	我叫大块头布林奇，这个小个子是尖牙先生。
$LINE_CARAVAN_TOWN_INTRO_40_CHAR	$MCG
$LINE_CARAVAN_TOWN_INTRO_40_TEXT	*这真是……令人不安， $BER……
$LINE_CARAVAN_TOWN_INTRO_50_CHAR	$RAN
$LINE_CARAVAN_TOWN_INTRO_50_TEXT	*$MCG，这里有一些诺曼的商队，可以为我们提供些补给——当然价格合理。
$LINE_CARAVAN_TOWN_INTRO_60_CHAR	$RAN
$LINE_CARAVAN_TOWN_INTRO_60_TEXT	而且推车工是我外祖父的五姨太的二表弟，所以我可以尝试讨价还价来争取一些优惠。
$LINE_CARAVAN_TOWN_INTRO_70_CHAR	$RAN
$LINE_CARAVAN_TOWN_INTRO_70_TEXT	我建议我们应该提前储备些物资。
$SCENE_CARAVAN_TOWN_OUTRO_TITLE	来自朋友的礼物
$LINE_CARAVAN_TOWN_OUTRO_00_CHAR	诺曼
$LINE_CARAVAN_TOWN_OUTRO_00_TEXT	*嘿，陌生人！你不会就是$MCG把？
$LINE_CARAVAN_TOWN_OUTRO_10_CHAR	$MCG
$LINE_CARAVAN_TOWN_OUTRO_10_TEXT	是的，怎么？
$LINE_CARAVAN_TOWN_OUTRO_20_CHAR	诺曼
$LINE_CARAVAN_TOWN_OUTRO_20_TEXT	太棒了！
$LINE_CARAVAN_TOWN_OUTRO_30_CHAR	诺曼
$LINE_CARAVAN_TOWN_OUTRO_30_TEXT	几天前，有一位老人来过这里。
$LINE_CARAVAN_TOWN_OUTRO_40_CHAR	诺曼
$LINE_CARAVAN_TOWN_OUTRO_40_TEXT	他说你会来，然后让我把这个转交给你。
$LINE_CARAVAN_TOWN_OUTRO_50_CHAR	诺曼
$LINE_CARAVAN_TOWN_OUTRO_50_TEXT	他说这会对你有所帮助。
$LINE_CARAVAN_TOWN_OUTRO_60_CHAR	诺曼
$LINE_CARAVAN_TOWN_OUTRO_60_TEXT	如果硬要说的话，他是有一点点奇怪。
$LINE_CARAVAN_TOWN_OUTRO_70_CHAR	诺曼
$LINE_CARAVAN_TOWN_OUTRO_70_TEXT	但是任何送我免费羊皮纸的人，就是大好人！
$LINE_CARAVAN_TOWN_OUTRO_80_CHAR	诺曼
$LINE_CARAVAN_TOWN_OUTRO_80_TEXT	我很缺这东西。
$LINE_CARAVAN_TOWN_OUTRO_90_CHAR	诺曼
$LINE_CARAVAN_TOWN_OUTRO_90_TEXT	这东西很好吃！
$LINE_CARAVAN_TOWN_OUTRO_100_CHAR	$MCG
$LINE_CARAVAN_TOWN_OUTRO_100_TEXT	谢谢你，朋友。
$SCENE_MONASTERY_GATES_INTRO_TITLE	修道院大门
$LINE_MONASTERY_GATES_INTRO_00_CHAR	$BER
$LINE_MONASTERY_GATES_INTRO_00_TEXT	我们到了：瑟连里第七分会会堂！
$LINE_MONASTERY_GATES_INTRO_10_CHAR	$MCG
$LINE_MONASTERY_GATES_INTRO_10_TEXT	这就是修道院？
$LINE_MONASTERY_GATES_INTRO_20_CHAR	$BER
$LINE_MONASTERY_GATES_INTRO_20_TEXT	怎么，你以为是怎样的？
$LINE_MONASTERY_GATES_INTRO_30_CHAR	$MCG
$LINE_MONASTERY_GATES_INTRO_30_TEXT	我还以为它会像艾殊王国的皇家修道院那样呢。
$LINE_MONASTERY_GATES_INTRO_40_CHAR	$BER
$LINE_MONASTERY_GATES_INTRO_40_TEXT	好吧，如果你还嫌气氛不够，你可以为你唱圣歌。
$LINE_MONASTERY_GATES_INTRO_50_CHAR	$BER
$LINE_MONASTERY_GATES_INTRO_50_TEXT	哦哦哦哦哦哦哦啊啊啊啊啊啊哈啊啊啊啊
$LINE_MONASTERY_GATES_INTRO_60_CHAR	$MCG
$LINE_MONASTERY_GATES_INTRO_60_TEXT	它看起来不像是寺庙，更像是堡垒。
$LINE_MONASTERY_GATES_INTRO_70_CHAR	红衣人
$LINE_MONASTERY_GATES_INTRO_70_TEXT	没错，因为墓坑里到处都是危险。
$LINE_MONASTERY_GATES_INTRO_80_CHAR	$MCG
$LINE_MONASTERY_GATES_INTRO_80_TEXT	你！
$LINE_MONASTERY_GATES_INTRO_90_CHAR	红衣人
$LINE_MONASTERY_GATES_INTRO_90_TEXT	你以为坐在这墙后面的那个老蠢货能救你？
$LINE_MONASTERY_GATES_INTRO_100_CHAR	红衣人
$LINE_MONASTERY_GATES_INTRO_100_TEXT	你已经被隔绝了。这座寺庙也许也是奎德帝国能给予你帮助的最后的救命稻草了吧。
$LINE_MONASTERY_GATES_INTRO_110_CHAR	红衣人
$LINE_MONASTERY_GATES_INTRO_110_TEXT	亡者，击溃他们！
$SCENE_MONASTERY_GATES_OUTRO_TITLE	友好之墙
$LINE_MONASTERY_GATES_OUTRO_00_CHAR	神秘老人
$LINE_MONASTERY_GATES_OUTRO_00_TEXT	大门开了！快进去，趁他们还没有重整部队！
$LINE_MONASTERY_GATES_OUTRO_10_CHAR	$MCG
$LINE_MONASTERY_GATES_OUTRO_10_TEXT	所有人快进修道院！
$LINE_MONASTERY_GATES_OUTRO_20_CHAR	$MCG
$LINE_MONASTERY_GATES_OUTRO_20_TEXT	你又一次救了我们的命，尊敬的长者。
$LINE_MONASTERY_GATES_OUTRO_30_CHAR	神秘老人
$LINE_MONASTERY_GATES_OUTRO_30_TEXT	我是为你们，也是为了我自己。
$LINE_MONASTERY_GATES_OUTRO_40_CHAR	神秘老人
$LINE_MONASTERY_GATES_OUTRO_40_TEXT	你不知道你自己的重要性。
$LINE_MONASTERY_GATES_OUTRO_50_CHAR	神秘老人
$LINE_MONASTERY_GATES_OUTRO_50_TEXT	你是能够进入他们世界的人……
$LINE_MONASTERY_GATES_OUTRO_60_CHAR	$MCG
$LINE_MONASTERY_GATES_OUTRO_60_TEXT	拜托了，请你解释一下上周发生在我身上的事情——
$LINE_MONASTERY_GATES_OUTRO_70_CHAR	神秘老人
$LINE_MONASTERY_GATES_OUTRO_70_TEXT	这说来话长，但是我们的时间不多了。
$LINE_MONASTERY_GATES_OUTRO_80_CHAR	神秘老人
$LINE_MONASTERY_GATES_OUTRO_80_TEXT	敌人的军队仍然在门口。
$LINE_MONASTERY_GATES_OUTRO_90_CHAR	$MCG
$LINE_MONASTERY_GATES_OUTRO_90_TEXT	那至少告诉我：我到底欠谁一条命？
$SCENE_MONASTERY_SIEGE_INTRO_TITLE	围城
$LINE_MONASTERY_SIEGE_INTRO_00_CHAR	奥斯蒙
$LINE_MONASTERY_SIEGE_INTRO_00_TEXT	够了！
$LINE_MONASTERY_SIEGE_INTRO_10_CHAR	奥斯蒙
$LINE_MONASTERY_SIEGE_INTRO_10_TEXT	我的亡者大军都被摧毁了。
$LINE_MONASTERY_SIEGE_INTRO_20_CHAR	奥斯蒙
$LINE_MONASTERY_SIEGE_INTRO_20_TEXT	我不打算再让我的人去攻打修道院城门了。
$LINE_MONASTERY_SIEGE_INTRO_30_CHAR	红衣人
$LINE_MONASTERY_SIEGE_INTRO_30_TEXT	而这正是你需要做的事情。
$LINE_MONASTERY_SIEGE_INTRO_40_CHAR	奥斯蒙
$LINE_MONASTERY_SIEGE_INTRO_40_TEXT	不，我的朋友，我们完了。该死的！你的决定让我破了一大笔财。
$LINE_MONASTERY_SIEGE_INTRO_50_CHAR	红衣人
$LINE_MONASTERY_SIEGE_INTRO_50_TEXT	而你还需要再破一点财。
$LINE_MONASTERY_SIEGE_INTRO_51_CHAR	奥斯蒙
$LINE_MONASTERY_SIEGE_INTRO_51_TEXT	什么？！
$LINE_MONASTERY_SIEGE_INTRO_52_CHAR	舍里米尔
$LINE_MONASTERY_SIEGE_INTRO_52_TEXT	你应该更小心地看管你的实物。只要一点点毒药，你就只是另一具注入我意志的尸体了。
$LINE_MONASTERY_SIEGE_INTRO_60_CHAR	奥斯蒙
$LINE_MONASTERY_SIEGE_INTRO_60_TEXT	啊啊啊啊啊啊啊啊！
$LINE_MONASTERY_SIEGE_INTRO_70_CHAR	奥斯蒙
$LINE_MONASTERY_SIEGE_INTRO_70_TEXT	我、我的……主人……您……想要什么……？
$LINE_MONASTERY_SIEGE_INTRO_80_CHAR	红衣人
$LINE_MONASTERY_SIEGE_INTRO_80_TEXT	我的孩子，我有个任务给你……
$SCENE_MONASTERY_SIEGE_OUTRO_TITLE	预兆
$LINE_MONASTERY_SIEGE_OUTRO_00_CHAR	$HEA
$LINE_MONASTERY_SIEGE_OUTRO_00_TEXT	他们最后的力量也被瓦解了。
$LINE_MONASTERY_SIEGE_OUTRO_10_CHAR	$HEA
$LINE_MONASTERY_SIEGE_OUTRO_10_TEXT	我们暂时没事了。
$LINE_MONASTERY_SIEGE_OUTRO_20_CHAR	声音
$LINE_MONASTERY_SIEGE_OUTRO_20_TEXT	还没有结束，朋友。
$LINE_MONASTERY_SIEGE_OUTRO_30_CHAR	$MCG
$LINE_MONASTERY_SIEGE_OUTRO_30_TEXT	那是什么？
$LINE_MONASTERY_SIEGE_OUTRO_40_CHAR	$HEA
$LINE_MONASTERY_SIEGE_OUTRO_40_TEXT	现在你的死人仆从们不仅帮你战斗，还帮你说话了？
$LINE_MONASTERY_SIEGE_OUTRO_50_CHAR	红衣人
$LINE_MONASTERY_SIEGE_OUTRO_50_TEXT	你们现在也看到了，我已经势不可挡了。
$LINE_MONASTERY_SIEGE_OUTRO_60_CHAR	红衣人
$LINE_MONASTERY_SIEGE_OUTRO_60_TEXT	把女孩交过来，那么修道院就不会有事。
$LINE_MONASTERY_SIEGE_OUTRO_70_CHAR	$HEA
$LINE_MONASTERY_SIEGE_OUTRO_70_TEXT	舍里米尔，你曾经是那个人——
$LINE_MONASTERY_SIEGE_OUTRO_80_CHAR	舍里米尔
$LINE_MONASTERY_SIEGE_OUTRO_80_TEXT	你是说，<LQ>人<RQ>？
$LINE_MONASTERY_SIEGE_OUTRO_90_CHAR	舍里米尔
$LINE_MONASTERY_SIEGE_OUTRO_90_TEXT	你这个掩藏在僧侣长袍之下，畏缩在修道院高墙之后的胆小鬼，你有什么资格和我提<LQ>人<RQ>这个字！
$LINE_MONASTERY_SIEGE_OUTRO_100_CHAR	舍里米尔
$LINE_MONASTERY_SIEGE_OUTRO_100_TEXT	在这血流成河的情况下你还想保持两手干净吗？
$LINE_MONASTERY_SIEGE_OUTRO_110_CHAR	舍里米尔
$LINE_MONASTERY_SIEGE_OUTRO_110_TEXT	我的朋友，我没有你那么崇高的美德，这对我来说是一种奢侈。我只会尽自己一切所能去拯救这个世界。
$LINE_MONASTERY_SIEGE_OUTRO_120_CHAR	舍里米尔
$LINE_MONASTERY_SIEGE_OUTRO_120_TEXT	不管需要牺牲什么。
$LINE_MONASTERY_SIEGE_OUTRO_130_CHAR	$HEA
$LINE_MONASTERY_SIEGE_OUTRO_130_TEXT	这？这叫做拯救？这些尸骨遍野？这些血流成河？这都是你一手造成的！
$LINE_MONASTERY_SIEGE_OUTRO_140_CHAR	舍里米尔
$LINE_MONASTERY_SIEGE_OUTRO_140_TEXT	牺牲一些人可以拯救全世界。我记得你也做出过这样的牺牲……
$LINE_MONASTERY_SIEGE_OUTRO_150_CHAR	舍里米尔
$LINE_MONASTERY_SIEGE_OUTRO_150_TEXT	……曾经好几次。
$LINE_MONASTERY_SIEGE_OUTRO_160_CHAR	$HEA
$LINE_MONASTERY_SIEGE_OUTRO_160_TEXT	舍里米尔——
$LINE_MONASTERY_SIEGE_OUTRO_170_CHAR	舍里米尔
$LINE_MONASTERY_SIEGE_OUTRO_170_TEXT	*够了。我现在在和叫$MCG的人说话。
$LINE_MONASTERY_SIEGE_OUTRO_180_CHAR	$MCG
$LINE_MONASTERY_SIEGE_OUTRO_180_TEXT	你想要什么？
$LINE_MONASTERY_SIEGE_OUTRO_190_CHAR	舍里米尔
$LINE_MONASTERY_SIEGE_OUTRO_190_TEXT	如果你现在投降的话，可以拯救无数的性命。
$LINE_MONASTERY_SIEGE_OUTRO_200_CHAR	舍里米尔
$LINE_MONASTERY_SIEGE_OUTRO_200_TEXT	你活着是一件很危险的事。
$LINE_MONASTERY_SIEGE_OUTRO_210_CHAR	舍里米尔
$LINE_MONASTERY_SIEGE_OUTRO_210_TEXT	跟我来，你会拯救成百，甚至上千的人的性命。
$LINE_MONASTERY_SIEGE_OUTRO_220_CHAR	$HEA
$LINE_MONASTERY_SIEGE_OUTRO_220_TEXT	圣令将永不背叛踏入此地之人。
$LINE_MONASTERY_SIEGE_OUTRO_230_CHAR	舍里米尔
$LINE_MONASTERY_SIEGE_OUTRO_230_TEXT	很好。
$LINE_MONASTERY_SIEGE_OUTRO_240_CHAR	舍里米尔
$LINE_MONASTERY_SIEGE_OUTRO_240_TEXT	再见，朋友。我还会回来的。
$SCENE_MONASTERY_TOWN_OUTRO_TITLE	猎杀行动
$NARR_MONASTERY_TOWN_OUTRO_00_TEXT	第三幕
$NARR_MONASTERY_TOWN_OUTRO_00_SUB_TEXT	*齿轮不会怨恨杠杆，砝码不会责怪铁链，但是每一部分都和谐相处，只为了完成造物者的意愿。
$NARR_MONASTERY_TOWN_OUTRO_00_SUB_SUB_TEXT	*$N$N$N$N$N——摘自瑟林达写给七王国的第二封信
$LINE_MONASTERY_TOWN_OUTRO_00_CHAR	$MCG
$LINE_MONASTERY_TOWN_OUTRO_00_TEXT	我还是不敢相信尸体会做出这样的事情……
$LINE_MONASTERY_TOWN_OUTRO_10_CHAR	$HEA
$LINE_MONASTERY_TOWN_OUTRO_10_TEXT	肉体只是精神栖息的容器罢了。
$LINE_MONASTERY_TOWN_OUTRO_20_CHAR	$HEA
$LINE_MONASTERY_TOWN_OUTRO_20_TEXT	你可以去达的世界，精神的世界，这让你可以从本质上进行攻击，而不是仅仅对抗其肉身载体。
$LINE_MONASTERY_TOWN_OUTRO_30_CHAR	$MCG
$LINE_MONASTERY_TOWN_OUTRO_30_TEXT	但是，是什么精神在驱使他们？
$LINE_MONASTERY_TOWN_OUTRO_40_CHAR	$MCG
$LINE_MONASTERY_TOWN_OUTRO_40_TEXT	舍里米尔
$LINE_MONASTERY_TOWN_OUTRO_50_CHAR	$HEA
$LINE_MONASTERY_TOWN_OUTRO_50_TEXT	……是的。他可以通过未知的力量，来讲自己的意愿灌注进死者的躯体之内……
$LINE_MONASTERY_TOWN_OUTRO_60_CHAR	$HEA
$LINE_MONASTERY_TOWN_OUTRO_60_TEXT	最终来达成他那些黑暗的目的。
$LINE_MONASTERY_TOWN_OUTRO_70_CHAR	$HEA
$LINE_MONASTERY_TOWN_OUTRO_70_TEXT	*有很多事我必须要告诉你，$MCG。
$LINE_MONASTERY_TOWN_OUTRO_80_CHAR	$HEA
$LINE_MONASTERY_TOWN_OUTRO_80_TEXT	……但是我们没有时间了。等我们安全出去后，我再告诉你。
$SCENE_3_1_INTRO_TITLE	远处的烟雾
$LINE_3_1_INTRO_00_CHAR	$MCG
$LINE_3_1_INTRO_00_TEXT	我必须要向僧侣们为我们所做的一切表示感激。我从来没想到会有人愿意无私地帮助这些瘟疫受害者。
$LINE_3_1_INTRO_10_CHAR	$HEA
$LINE_3_1_INTRO_10_TEXT	在混乱之中重建秩序，这是瑟连里一直以来的宗旨。我们有一家医院在这附近，我们现在就过去吧。
$LINE_3_1_INTRO_20_CHAR	$MCG
$LINE_3_1_INTRO_20_TEXT	那里安全吗？
$LINE_3_1_INTRO_30_CHAR	$HEA
$LINE_3_1_INTRO_30_TEXT	不，但是那里有一个病人会成为我们强大的盟友。
$LINE_3_1_INTRO_40_CHAR	$HEA
$LINE_3_1_INTRO_40_TEXT	你不是唯一一个从死亡边缘逃生回来并且获得新能力的人。
$LINE_3_1_INTRO_50_CHAR	$MCG
$LINE_3_1_INTRO_50_TEXT	长老，远处那是烟吗？
$LINE_3_1_INTRO_60_CHAR	$HEA
$LINE_3_1_INTRO_60_TEXT	是医院！出事了！
$LINE_3_1_INTRO_70_CHAR	$HEA
$LINE_3_1_INTRO_70_TEXT	我们必须快点！
$SCENE_3_1_OUTRO_TITLE	新盟友
$LINE_3_1_OUTRO_00_CHAR	$HEA
$LINE_3_1_OUTRO_00_TEXT	他是唯一的幸存者了。
$LINE_3_1_OUTRO_10_CHAR	病人
$LINE_3_1_OUTRO_10_TEXT	你好啊，尊敬的老者。
$LINE_3_1_OUTRO_20_CHAR	$HEA
$LINE_3_1_OUTRO_20_TEXT	医院怎样了？
$LINE_3_1_OUTRO_30_CHAR	病人
$LINE_3_1_OUTRO_30_TEXT	这是这些天来的第四次攻击了。
$LINE_3_1_OUTRO_40_CHAR	$HEA
$LINE_3_1_OUTRO_40_TEXT	病人们呢？
$LINE_3_1_OUTRO_50_CHAR	病人
$LINE_3_1_OUTRO_50_TEXT	大家都还活着。
$LINE_3_1_OUTRO_60_CHAR	病人
$LINE_3_1_OUTRO_60_TEXT	敌人被打的落花流水。
$LINE_3_1_OUTRO_70_CHAR	$HEA
$LINE_3_1_OUTRO_70_TEXT	还是老样子，这么好战。
$LINE_3_1_OUTRO_80_CHAR	$HEA
$LINE_3_1_OUTRO_80_TEXT	我想让你来见见今天的战斗胜利的功臣。
$LINE_3_1_OUTRO_90_CHAR	$MCG
$LINE_3_1_OUTRO_90_TEXT	*嗯……你好。我是$MCG。
$LINE_3_1_OUTRO_100_CHAR	病人
$LINE_3_1_OUTRO_100_TEXT	很高兴见到新盟友。
$SCENE_3_2_INTRO_TITLE	火焰之女
$LINE_3_2_INTRO_00_CHAR	$MAG
$LINE_3_2_INTRO_00_TEXT	我很感激这里为我提供的一切。
$LINE_3_2_INTRO_10_CHAR	$MAG
$LINE_3_2_INTRO_10_TEXT	你救了我的命，不然我现在已经……浑身冰凉了。
$LINE_3_2_INTRO_20_CHAR	$MAG
$LINE_3_2_INTRO_20_TEXT	但是医院的围墙保护了我。
$LINE_3_2_INTRO_30_CHAR	$MAG
$LINE_3_2_INTRO_30_TEXT	尽管有寒冰的覆盖，但是宇宙的怒焰仍然在我体内燃烧。
$LINE_3_2_INTRO_40_CHAR	$MAG
$LINE_3_2_INTRO_40_TEXT	我渴望和敌人大战一场。
$LINE_3_2_INTRO_50_CHAR	$HEA
$LINE_3_2_INTRO_50_TEXT	*这也是我在这里的原因，$MAG。
$LINE_3_2_INTRO_60_CHAR	$HEA
$LINE_3_2_INTRO_60_TEXT	我们——需要你的帮助。
$LINE_3_2_INTRO_70_CHAR	$HEA
$LINE_3_2_INTRO_70_TEXT	明天，我会率领——
$LINE_3_2_INTRO_80_CHAR	$HEA
$LINE_3_2_INTRO_80_TEXT	那是什么？
$LINE_3_2_INTRO_90_CHAR	$MAG
$LINE_3_2_INTRO_90_TEXT	门口又来了好多敌人！
$LINE_3_2_INTRO_100_CHAR	$HEA
$LINE_3_2_INTRO_100_TEXT	守护者们！我们受到攻击了！
$LINE_3_2_INTRO_110_CHAR	$MAG
$LINE_3_2_INTRO_110_TEXT	此生此世，我仍是火焰之女。
$LINE_3_2_INTRO_120_CHAR	$MAG
$LINE_3_2_INTRO_120_TEXT	与我对抗的敌人，会被燃烧成灰烬！
$SCENE_3_2_OUTRO_TITLE	盟友的背景
$LINE_3_2_OUTRO_00_CHAR	$MCG
$LINE_3_2_OUTRO_00_TEXT	咳咳。无意冒犯，但她是奎德人，对吗？
$LINE_3_2_OUTRO_10_CHAR	$HEA
$LINE_3_2_OUTRO_10_TEXT	这里的大多数人都是。
$LINE_3_2_OUTRO_20_CHAR	$HEA
$LINE_3_2_OUTRO_20_TEXT	在瘟疫爆发之前，墓坑是一个战俘营。
$LINE_3_2_OUTRO_30_CHAR	$HEA
$LINE_3_2_OUTRO_30_TEXT	这里的很多人劳苦一生开采矿山，最终却把瘟疫受害者扔进来与他们为伴。
$LINE_3_2_OUTRO_40_CHAR	$MCG
$LINE_3_2_OUTRO_40_TEXT	但这改变不了一个事实，他们就是一群种族灭绝的拜火教疯子。奎德帝国不惜一切代价要——
$LINE_3_2_OUTRO_50_CHAR	$HEA
$LINE_3_2_OUTRO_50_TEXT	*$MCG，奎德帝国已经灭绝了。毁灭奎德的敌人现在已经开始觊觎这个世界的其他国家。
$LINE_3_2_OUTRO_60_CHAR	$HEA
$LINE_3_2_OUTRO_60_TEXT	我们不能对盟友的背景吹毛求疵。
$LINE_3_2_OUTRO_70_CHAR	$MCG
$LINE_3_2_OUTRO_70_TEXT	*噢，嘿，$MAG，我没看到你也在这儿。
$LINE_3_2_OUTRO_80_CHAR	$MCG
$LINE_3_2_OUTRO_80_TEXT	我们只是在讨论，呃，一些事情……
$LINE_3_2_OUTRO_90_CHAR	$MAG
$LINE_3_2_OUTRO_90_TEXT	很好。你知道他们说了什么：
$LINE_3_2_OUTRO_100_CHAR	$MAG
$LINE_3_2_OUTRO_100_TEXT	<LQ>对于那些可能会在半夜撕裂你喉咙的人，最好不要在背后说他们的闲话。<RQ>
$LINE_3_2_OUTRO_110_CHAR	$MCG
$LINE_3_2_OUTRO_110_TEXT	我对这句话不是很熟悉……谁……呃……谁说的？
$LINE_3_2_OUTRO_120_CHAR	$MAG
$LINE_3_2_OUTRO_120_TEXT	大概是那些喉咙还没有撕裂的人吧。
$LINE_3_2_OUTRO_130_CHAR	$MAG
$LINE_3_2_OUTRO_130_TEXT	因为那些已经被撕裂的人估计也没法说话了吧。
$LINE_3_2_OUTRO_140_CHAR	$MAG
$LINE_3_2_OUTRO_140_TEXT	他们只会，<LQ>咯咯，咯咯，咯咯。<RQ>
$LINE_3_2_OUTRO_150_CHAR	$MAG
$LINE_3_2_OUTRO_150_TEXT	然后你就会问，<LQ>这是什么建议吗？我不明白。能不能说清楚些？<RQ>
$LINE_3_2_OUTRO_160_CHAR	$MCG
$LINE_3_2_OUTRO_160_TEXT	……我真的很高兴我们是朋友。
$LINE_3_2_OUTRO_170_CHAR	$MAG
$LINE_3_2_OUTRO_170_TEXT	我也是！友谊万岁！比如，如果你想要在谁睡着的时候撕裂他的喉咙的话，你只要说，<LQ>嘿朋友，干掉他——<RQ>
$LINE_3_2_OUTRO_180_CHAR	$MCG
$LINE_3_2_OUTRO_180_TEXT	……确实如此！
$LINE_3_2_OUTRO_190_CHAR	$MCG
$LINE_3_2_OUTRO_190_TEXT	……我有一个很重要的问题要问你！
$LINE_3_2_OUTRO_200_CHAR	$MAG
$LINE_3_2_OUTRO_200_TEXT	什么？
$LINE_3_2_OUTRO_210_CHAR	$MCG
$LINE_3_2_OUTRO_210_TEXT	嗯……这些冰是怎么回事？我知道你通常是个火人，那……
$LINE_3_2_OUTRO_220_CHAR	$MAG
$LINE_3_2_OUTRO_220_TEXT	那我为什么不从我的眼眶里射出火球来？
$LINE_3_2_OUTRO_230_CHAR	$MCG
$LINE_3_2_OUTRO_230_TEXT	是的，我猜想。
$LINE_3_2_OUTRO_240_CHAR	$MAG
$LINE_3_2_OUTRO_240_TEXT	当我濒临死亡的时候……我看到了地狱……冰凉的黑暗无穷无尽地延伸。那是个没有温暖和光明的地方。
$LINE_3_2_OUTRO_250_CHAR	$MAG
$LINE_3_2_OUTRO_250_TEXT	然后一个金色的人，轻声呼唤我的名字。紧接着我才知道，听下去会变成诅咒。
$LINE_3_2_OUTRO_260_CHAR	$MAG
$LINE_3_2_OUTRO_260_TEXT	我想逃走，但是我无法移动。随着时间推移，低语声越来越大，最后掩盖了我的尖叫。
$LINE_3_2_OUTRO_270_CHAR	$MAG
$LINE_3_2_OUTRO_270_TEXT	然后突然间，所有的一切都消失了。我发现自己在医院里，僧侣们在照顾我。
$LINE_3_2_OUTRO_280_CHAR	$MAG
$LINE_3_2_OUTRO_280_TEXT	但是尽管我逃离了地狱，但我也发现自己从那里带了些东西回来。
$LINE_3_2_OUTRO_290_CHAR	$MAG
$LINE_3_2_OUTRO_290_TEXT	这……这些我心脏中的寒冰。我从来没有过这样的感觉。
$LINE_3_2_OUTRO_300_CHAR	$MAG
$LINE_3_2_OUTRO_300_TEXT	每一天我都希望火焰能让我重新变得完整……但是每一天诅咒都在继续。
$LINE_3_2_OUTRO_310_CHAR	$MAG
$LINE_3_2_OUTRO_310_TEXT	我不是唯一一个有这样经历的人。很多瘟疫的幸存者都发生了变化。
$LINE_3_2_OUTRO_320_CHAR	$MAG
$LINE_3_2_OUTRO_320_TEXT	直到火焰怜悯我的时候，我就能用这诅咒对抗那些违背正义的敌人。
$LINE_3_2_OUTRO_330_CHAR	$MAG
$LINE_3_2_OUTRO_330_TEXT	正如你所见的，只要你全身心专注，你可以使用任何东西杀死你的敌人。
$SCENE_HOSPITAL_INTRO_TITLE	肮脏的过去
$LINE_HOSPITAL_INTRO_00_CHAR	$MCG
$LINE_HOSPITAL_INTRO_00_TEXT	尊敬的长者，如果我们不能在这里寻求庇护，那么你的计划是什么？
$LINE_HOSPITAL_INTRO_10_CHAR	$HEA
$LINE_HOSPITAL_INTRO_10_TEXT	*$MCG，我的一生中有很多愧疚的事情……
$LINE_HOSPITAL_INTRO_20_CHAR	$HEA
$LINE_HOSPITAL_INTRO_20_TEXT	我不希望其中再增加一项欺骗你的罪名。
$LINE_HOSPITAL_INTRO_30_CHAR	$HEA
$LINE_HOSPITAL_INTRO_30_TEXT	如果我要继续引导你，那么有些关于我和我们对手的事情，你必须知道。
$LINE_HOSPITAL_INTRO_40_CHAR	$MCG
$LINE_HOSPITAL_INTRO_40_TEXT	舍里米尔？
$LINE_HOSPITAL_INTRO_50_CHAR	$HEA
$LINE_HOSPITAL_INTRO_50_TEXT	是的。他曾经是我们这些人的伟大领袖，现在一些神秘的力量让他变得疯狂。
$LINE_HOSPITAL_INTRO_60_CHAR	$MCG
$LINE_HOSPITAL_INTRO_60_TEXT	等等，你是说他是那个舍里米尔？那个皇太子舍里米尔·阿萨提莫？
$LINE_HOSPITAL_INTRO_70_CHAR	$MCG
$LINE_HOSPITAL_INTRO_70_TEXT	但是，他是那场战争中牺牲的英雄！
$LINE_HOSPITAL_INTRO_80_CHAR	$HEA
$LINE_HOSPITAL_INTRO_80_TEXT	所以每个人都相信这种说法，但是真相是一段更痛苦的历史。
$LINE_HOSPITAL_INTRO_90_CHAR	$HEA
$LINE_HOSPITAL_INTRO_90_TEXT	在你之前，那时候奎德战争达到了新的高度……你无法想象那种毁灭性的灾难。
$LINE_HOSPITAL_INTRO_100_CHAR	$HEA
$LINE_HOSPITAL_INTRO_100_TEXT	王权毁灭，屠杀遍野。
$LINE_HOSPITAL_INTRO_110_CHAR	$HEA
$LINE_HOSPITAL_INTRO_110_TEXT	我们已经处于湮灭的边缘。
$LINE_HOSPITAL_INTRO_120_CHAR	$HEA
$LINE_HOSPITAL_INTRO_120_TEXT	舍里米尔和我都是艾殊军团的将帅，我们就像亲兄弟一样。
$LINE_HOSPITAL_INTRO_130_CHAR	$HEA
$LINE_HOSPITAL_INTRO_130_TEXT	我们的军队骁勇如虎，但是我们心中都清楚自己在劫难逃。
$LINE_HOSPITAL_INTRO_140_CHAR	$HEA
$LINE_HOSPITAL_INTRO_140_TEXT	每天我们都看着艾殊一步步走向灭亡。
$LINE_HOSPITAL_INTRO_150_CHAR	$HEA
$LINE_HOSPITAL_INTRO_150_TEXT	然后，在一个敌人的废墟城市中，舍里米尔王子发现了一些东西。
$LINE_HOSPITAL_INTRO_160_CHAR	$HEA
$LINE_HOSPITAL_INTRO_160_TEXT	一个古老力量的位置，本来已经遗失在过去的时间长河里。
$LINE_HOSPITAL_INTRO_170_CHAR	$HEA
$LINE_HOSPITAL_INTRO_170_TEXT	门外的敌人已经兵临城下时，他制定了一个计划。
$LINE_HOSPITAL_INTRO_180_CHAR	$HEA
$LINE_HOSPITAL_INTRO_180_TEXT	一个黑暗的计划，一个绝望的产物。
$LINE_HOSPITAL_INTRO_190_CHAR	$HEA
$LINE_HOSPITAL_INTRO_190_TEXT	而我，十分愚蠢地，帮助了他。
$LINE_HOSPITAL_INTRO_200_CHAR	$HEA
$LINE_HOSPITAL_INTRO_200_TEXT	*$MCG，我已经竭尽全力的用我余下的生命来挽回舍里米尔的毁灭。
$LINE_HOSPITAL_INTRO_210_CHAR	$HEA
$LINE_HOSPITAL_INTRO_210_TEXT	无论出于什么原因，他选择了你作为他疯狂的目标。
$LINE_HOSPITAL_INTRO_220_CHAR	$HEA
$LINE_HOSPITAL_INTRO_220_TEXT	如果我们能找到原因，我们也许能利用其来对抗他。
$LINE_HOSPITAL_INTRO_230_CHAR	$HEA
$LINE_HOSPITAL_INTRO_230_TEXT	*你已经看到他的能力了，$MCG。你会帮助我吗？
$LINE_HOSPITAL_INTRO_240_CHAR	$MCG
$LINE_HOSPITAL_INTRO_240_TEXT	尽我所能。
$SCENE_HOSPITAL_OUTRO_TITLE	进入沙漠
$LINE_HOSPITAL_OUTRO_00_CHAR	$HEA
$LINE_HOSPITAL_OUTRO_00_TEXT	做好准备。在我们面前的是一个漫长的远征。
$LINE_HOSPITAL_OUTRO_10_CHAR	$MCG
$LINE_HOSPITAL_OUTRO_10_TEXT	我们要去哪里？
$LINE_HOSPITAL_OUTRO_20_CHAR	$HEA
$LINE_HOSPITAL_OUTRO_20_TEXT	舍里米尔发现他黑暗力量历史的城市。
$LINE_HOSPITAL_OUTRO_30_CHAR	$HEA
$LINE_HOSPITAL_OUTRO_30_TEXT	我希望找到那些记录，也许它们就是我们能理解舍里米尔寻找你的关键……也是我们要如何对抗他的关键。
$LINE_HOSPITAL_OUTRO_40_CHAR	$MCG
$LINE_HOSPITAL_OUTRO_40_TEXT	那座城市在这里……在墓坑？
$LINE_HOSPITAL_OUTRO_50_CHAR	$HEA
$LINE_HOSPITAL_OUTRO_50_TEXT	是的，是战争时期的遗迹。
$LINE_HOSPITAL_OUTRO_60_CHAR	$MCG
$LINE_HOSPITAL_OUTRO_60_TEXT	那舍里米尔呢？如果他知道这个地方……
$LINE_HOSPITAL_OUTRO_70_CHAR	$HEA
$LINE_HOSPITAL_OUTRO_70_TEXT	是的，他可能预料到我们的行动。
$LINE_HOSPITAL_OUTRO_80_CHAR	$HEA
$LINE_HOSPITAL_OUTRO_80_TEXT	但是，我们不能呆在这里。如果我们的行动足够快速，足够隐蔽，那么我们也许可以在他重建军队之前快速进城。
$SCENE_3_3_INTRO_TITLE	沙漠据点
$LINE_3_3_INTRO_00_CHAR	$HEA
$LINE_3_3_INTRO_00_TEXT	我们的秘密入口就在这里，沙漠表面。
$LINE_3_3_INTRO_10_CHAR	$RAN
$LINE_3_3_INTRO_10_TEXT	敌人就在我们身后！
$LINE_3_3_INTRO_20_CHAR	$HEA
$LINE_3_3_INTRO_20_TEXT	是舍里米尔的先遣部队。
$LINE_3_3_INTRO_30_CHAR	$HEA
$LINE_3_3_INTRO_30_TEXT	我们太慢了。
$LINE_3_3_INTRO_40_CHAR	$RAN
$LINE_3_3_INTRO_40_TEXT	快，我们必须进城！
$LINE_3_3_INTRO_50_CHAR	$HEA
$LINE_3_3_INTRO_50_TEXT	不！如果我们现在逃跑的话，大门就会被敌人占领。
$LINE_3_3_INTRO_60_CHAR	$HEA
$LINE_3_3_INTRO_60_TEXT	然后，他的整个军队就会跟上，而我们会被困在弯曲缠绕的街道迷宫中无法逃跑。
$LINE_3_3_INTRO_70_CHAR	$HEA
$LINE_3_3_INTRO_70_TEXT	我们必须在这里击败他们，并且摧毁我们身后的入口。
$SCENE_3_3_OUTRO_TITLE	沙漠之宝
$NARR_3_3_OUTRO_00_TEXT	第四幕
$NARR_3_3_OUTRO_00_SUB_TEXT	*我无法分辨自己在这地下呆了多久——$N几周，也许是几个月，暗无天日，$N随时随地生活在恐惧之中，因为眼前翻滚的黑暗，$N以及那些在黑暗中移动的东西。
$NARR_3_3_OUTRO_00_SUB_SUB_TEXT	*$N$N$N$N$N——摘自诺曼冒险家，克莱斯特·卡达所收集的故事
$LINE_3_3_OUTRO_00_CHAR	$BER
$LINE_3_3_OUTRO_00_TEXT	*没错！感受$BER的愤怒吧！快跑吧！快从我这粗犷不羁但诱人性感的魅力中逃跑吧！
$LINE_3_3_OUTRO_10_CHAR	$BER
$LINE_3_3_OUTRO_10_TEXT	*趁你们现在还能逃跑，快跑吧！你们这些悲惨的可怜虫！你们这些卑微的渣滓！你们……你们……这些娘娘腔！
$LINE_3_3_OUTRO_20_CHAR	$HEA
$LINE_3_3_OUTRO_20_TEXT	……
$LINE_3_3_OUTRO_30_CHAR	$BER
$LINE_3_3_OUTRO_30_TEXT	你认为最后一个太过了吗？我在努力保持新鲜感，你懂的。我在努力创造一些新的骂人的话。
$LINE_3_3_OUTRO_40_CHAR	$HEA
$LINE_3_3_OUTRO_40_TEXT	那你创作完毕了吗？我必须要封闭我们身后的入口了。
$LINE_3_3_OUTRO_50_CHAR	$BER
$LINE_3_3_OUTRO_50_TEXT	哇……你可以用意念让东西爆炸？
$LINE_3_3_OUTRO_60_CHAR	$BER
$LINE_3_3_OUTRO_60_TEXT	原谅我！请不要用你的意念能力让我的头爆炸！
$LINE_3_3_OUTRO_70_CHAR	$BER
$LINE_3_3_OUTRO_70_TEXT	我会归还所有从你包里偷走的鞋子，我发誓！我还会还你一百双鞋子，一千双！
$LINE_3_3_OUTRO_80_CHAR	$HEA
$LINE_3_3_OUTRO_80_TEXT	冷静点。这里生长的水晶天生就不稳定。奎德帝国当年建造这座城市，就是为了战争来开采矿藏。
$LINE_3_3_OUTRO_90_CHAR	$HEA
$LINE_3_3_OUTRO_90_TEXT	我刚刚只是操纵了一个简单的导火线，来引爆这里。
$LINE_3_3_OUTRO_100_CHAR	$BER
$LINE_3_3_OUTRO_100_TEXT	等等，什么？哦，那就算了。
$SCENE_3_4_INTRO_TITLE	不祥之兆
$LINE_3_4_INTRO_00_CHAR	$HEA
$LINE_3_4_INTRO_00_TEXT	几年前，我和舍里米尔也走过同样的大厅，这里还是沾满了战争的血迹。
$LINE_3_4_INTRO_10_CHAR	$MCG
$LINE_3_4_INTRO_10_TEXT	这就是舍里米尔发现他力量来源的地方吗？
$LINE_3_4_INTRO_20_CHAR	$HEA
$LINE_3_4_INTRO_20_TEXT	不，我们发现了一段用奎德语撰写的神秘历史，但是那语言太古老了，就算是舍里米尔这样的博学者也完全无法解读。
$LINE_3_4_INTRO_30_CHAR	$MCG
$LINE_3_4_INTRO_30_TEXT	那如果那古老的力量在别的地方，我们在这里干什么？
$LINE_3_4_INTRO_40_CHAR	$HEA
$LINE_3_4_INTRO_40_TEXT	舍里米尔惧怕你，很有可能是因为他当时在那份稿件中读到了什么——一些他当时没有分享出来的东西……
$LINE_3_4_INTRO_50_CHAR	$HEA
$LINE_3_4_INTRO_50_TEXT	……就像他计划中的很多方面一样。
$LINE_3_4_INTRO_60_CHAR	$MCG
$LINE_3_4_INTRO_60_TEXT	你不可能知道。
$LINE_3_4_INTRO_70_CHAR	$HEA
$LINE_3_4_INTRO_70_TEXT	我本应该猜到的。
$LINE_3_4_INTRO_80_CHAR	$HEA
$LINE_3_4_INTRO_80_TEXT	但是徒有后悔是没用的。我必须去制止那个我参与创造出来的怪物。
$LINE_3_4_INTRO_90_CHAR	$HEA
$LINE_3_4_INTRO_90_TEXT	我必须找到那些神秘的记录，并且找出究竟是什么让舍里米尔如此惧怕。
$LINE_3_4_INTRO_100_CHAR	$MCG
$LINE_3_4_INTRO_100_TEXT	那你认为你这次可以阅读它吗？
$LINE_3_4_INTRO_110_CHAR	$HEA
$LINE_3_4_INTRO_110_TEXT	我已经花费了几年……而且，这次——奎德公主和我们在一起。
$LINE_3_4_INTRO_120_CHAR	$MCG
$LINE_3_4_INTRO_120_TEXT	她会帮助我们吗？你的那些过去——
$LINE_3_4_INTRO_130_CHAR	$HEA
$LINE_3_4_INTRO_130_TEXT	*$MCG！有什么东西在动！
$LINE_3_4_INTRO_140_CHAR	$MCG
$LINE_3_4_INTRO_140_TEXT	可是，我以为你已经封闭了入口！
$LINE_3_4_INTRO_150_CHAR	$HEA
$LINE_3_4_INTRO_150_TEXT	我封闭了！这肯定是别的东西！
$LINE_3_4_INTRO_160_CHAR	$MCG
$LINE_3_4_INTRO_160_TEXT	所有人，到我这儿来！
$SCENE_3_4_OUTRO_TITLE	战争机器的燃料
$LINE_3_4_OUTRO_00_CHAR	$MCG
$LINE_3_4_OUTRO_00_TEXT	那个水晶是什么？
$LINE_3_4_OUTRO_10_CHAR	$HEA
$LINE_3_4_OUTRO_10_TEXT	那曾经是奎德攻城武器的关键。
$LINE_3_4_OUTRO_20_CHAR	$HEA
$LINE_3_4_OUTRO_20_TEXT	在地下的矿藏中随处可见。
$LINE_3_4_OUTRO_30_CHAR	$MCG
$LINE_3_4_OUTRO_30_TEXT	你认为那就是亡者的来源吗？
$LINE_3_4_OUTRO_40_CHAR	$HEA
$LINE_3_4_OUTRO_40_TEXT	不，他们都穿着艾殊的制服……或者别的什么遗留的东西。
$LINE_3_4_OUTRO_50_CHAR	$HEA
$LINE_3_4_OUTRO_50_TEXT	这些人是艾殊王国的骑士。
$LINE_3_4_OUTRO_60_CHAR	$MCG
$LINE_3_4_OUTRO_60_TEXT	我们封闭了身后的入口！他们是怎么进来的？
$LINE_3_4_OUTRO_70_CHAR	$HEA
$LINE_3_4_OUTRO_70_TEXT	我不知道……
$LINE_3_4_OUTRO_80_CHAR	$HEA
$LINE_3_4_OUTRO_80_TEXT	但是我们现在无法回头了。
$LINE_3_4_OUTRO_90_CHAR	$HEA
$LINE_3_4_OUTRO_90_TEXT	我们的目标是皇家档案室。
$LINE_3_4_OUTRO_100_CHAR	$MCG
$LINE_3_4_OUTRO_100_TEXT	等等……那个水晶……
$LINE_3_4_OUTRO_110_CHAR	$MCG
$LINE_3_4_OUTRO_110_TEXT	物理性质是由精神驱动的。
$LINE_3_4_OUTRO_120_CHAR	$MCG
$LINE_3_4_OUTRO_120_TEXT	而精神……是肉眼可见的……是可以被召唤的……
$LINE_3_4_OUTRO_130_CHAR	$MCG
$LINE_3_4_OUTRO_130_TEXT	我想我明白了。
$SCENE_3_5_INTRO_TITLE	与骑士的相遇
$LINE_3_5_INTRO_00_CHAR	$RAN
$LINE_3_5_INTRO_00_TEXT	……我只是说，如果我要规划一个城市，我也许会选一个不一样的地方。
$LINE_3_5_INTRO_10_CHAR	$RAN
$LINE_3_5_INTRO_10_TEXT	你懂的，一个地底下不会埋着一百万吨爆炸物的地方。
$LINE_3_5_INTRO_20_CHAR	独行骑士
$LINE_3_5_INTRO_20_TEXT	小心！他们又来了！
$LINE_3_5_INTRO_30_CHAR	$RAN
$LINE_3_5_INTRO_30_TEXT	你到底是谁？
$SCENE_3_5_OUTRO_TITLE	皇家债务
$LINE_3_5_OUTRO_00_CHAR	$KNI
$LINE_3_5_OUTRO_00_TEXT	你正好就在这里。
$LINE_3_5_OUTRO_10_CHAR	$KNI
$LINE_3_5_OUTRO_10_TEXT	我欠你一个人情，女士。
$LINE_3_5_OUTRO_20_CHAR	$KNI
$LINE_3_5_OUTRO_20_TEXT	也许这在这个混世之中不值一提，但我依然坚守家族的传统。
$LINE_3_5_OUTRO_30_CHAR	$KNI
$LINE_3_5_OUTRO_30_TEXT	以命偿命。我将会一直效命于你，直到我的债务还清。
$LINE_3_5_OUTRO_40_CHAR	$KNI
$LINE_3_5_OUTRO_40_TEXT	这是艾殊皇室的要求。
$LINE_3_5_OUTRO_50_CHAR	$MCG
$LINE_3_5_OUTRO_50_TEXT	皇室？你是……
$LINE_3_5_OUTRO_60_CHAR	$KNI
$LINE_3_5_OUTRO_60_TEXT	诚然，只是一个小皇室，但是我身体里流淌的血液仍然要求我守护家族的荣耀。
$LINE_3_5_OUTRO_70_CHAR	$MCG
$LINE_3_5_OUTRO_70_TEXT	这是我们的荣幸，王子殿下。
$LINE_3_5_OUTRO_80_CHAR	$KNI
$LINE_3_5_OUTRO_80_TEXT	不要向我鞠躬，女士。你才是我必须效命的人。
$LINE_3_5_OUTRO_90_CHAR	$KNI
$LINE_3_5_OUTRO_90_TEXT	我的刀锋听从你的命令，定会竭尽全力完成你所有的旨意。
$LINE_3_5_OUTRO_100_CHAR	$KNI
$LINE_3_5_OUTRO_100_TEXT	当然，是指合情合理的事情。
$LINE_3_5_OUTRO_110_CHAR	$KNI
$LINE_3_5_OUTRO_110_TEXT	而不是<LQ>单脚站立，假声演唱醉虎之歌<RQ>！
$LINE_3_5_OUTRO_120_CHAR	$KNI
$LINE_3_5_OUTRO_120_TEXT	当人们听到 <LQ>命债<RQ>二字后冒出的那些疯狂的念头，一定会让你感到震惊的。
$LINE_3_5_OUTRO_130_CHAR	$MCG
$LINE_3_5_OUTRO_130_TEXT	<LQ>醉虎之歌<RQ>？
$LINE_3_5_OUTRO_140_CHAR	$KNI
$LINE_3_5_OUTRO_140_TEXT	不要去想了。
$SCENE_GUARD_TOWN_INTRO_TITLE	守卫的藏身之处
$LINE_GUARD_TOWN_INTRO_00_CHAR	$HEA
$LINE_GUARD_TOWN_INTRO_00_TEXT	我没想到会在城堡里找到还活着的人。
$LINE_GUARD_TOWN_INTRO_10_CHAR	$KNI
$LINE_GUARD_TOWN_INTRO_10_TEXT	墓坑的居民对于受到感染的士兵还是充满同情的。
$LINE_GUARD_TOWN_INTRO_20_CHAR	$KNI
$LINE_GUARD_TOWN_INTRO_20_TEXT	另一方面：暴民的武力并不像所宣扬的那么厉害。
$LINE_GUARD_TOWN_INTRO_30_CHAR	$KNI
$LINE_GUARD_TOWN_INTRO_30_TEXT	不管怎样，一些老兵记得城堡的秘密入口——在那里我们能免受报复。
$LINE_GUARD_TOWN_INTRO_40_CHAR	$KNI
$LINE_GUARD_TOWN_INTRO_40_TEXT	但即使是在这里，我们仍然受到瘟疫的威胁。
$LINE_GUARD_TOWN_INTRO_50_CHAR	$HEA
$LINE_GUARD_TOWN_INTRO_50_TEXT	装甲亡者大军。
$LINE_GUARD_TOWN_INTRO_60_CHAR	$KNI
$LINE_GUARD_TOWN_INTRO_60_TEXT	它们曾经都是营地的成员。每当我们中有人死于噩梦般的瘟疫后，它们的人数就会增加。
$LINE_GUARD_TOWN_INTRO_70_CHAR	$HEA
$LINE_GUARD_TOWN_INTRO_70_TEXT	那此地不宜久留。
$SCENE_GUARD_TOWN_OUTRO_TITLE	警告之语
$LINE_GUARD_TOWN_OUTRO_00_CHAR	$KNI
$LINE_GUARD_TOWN_OUTRO_00_TEXT	你想要进一步深入城市吗？
$LINE_GUARD_TOWN_OUTRO_10_CHAR	$HEA
$LINE_GUARD_TOWN_OUTRO_10_TEXT	我们必须要去皇家档案室。
$LINE_GUARD_TOWN_OUTRO_20_CHAR	$HEA
$LINE_GUARD_TOWN_OUTRO_20_TEXT	那里的信息能帮助扭转这场灾难。
$LINE_GUARD_TOWN_OUTRO_30_CHAR	$KNI
$LINE_GUARD_TOWN_OUTRO_30_TEXT	我必须警告你，除了亡者之外，这座城市里还有更多其他的危险。
$LINE_GUARD_TOWN_OUTRO_40_CHAR	$KNI
$LINE_GUARD_TOWN_OUTRO_40_TEXT	火焰生物在这片土地的黑暗之处沉睡着。
$LINE_GUARD_TOWN_OUTRO_50_CHAR	$HEA
$LINE_GUARD_TOWN_OUTRO_50_TEXT	我们会直面必须面对的危险。
$LINE_GUARD_TOWN_OUTRO_60_CHAR	$KNI
$LINE_GUARD_TOWN_OUTRO_60_TEXT	我还是要警告你们一句……
$LINE_GUARD_TOWN_OUTRO_70_CHAR	$KNI
$LINE_GUARD_TOWN_OUTRO_70_TEXT	这里有恶龙。
$LINE_GUARD_TOWN_OUTRO_80_CHAR	$KNI
$LINE_GUARD_TOWN_OUTRO_80_TEXT	我一直都想说！
$LINE_GUARD_TOWN_OUTRO_90_CHAR	$KNI
$LINE_GUARD_TOWN_OUTRO_90_TEXT	但是，认真的，我的朋友，真的有龙。
$SCENE_SIDEQUEST_5_GET_TITLE	移动的黑影
$LINE_SIDEQUEST_5_GET_00_CHAR	$BER
$LINE_SIDEQUEST_5_GET_00_TEXT	嘿，坏蛋们！你们在外面吗？
$LINE_SIDEQUEST_5_GET_10_CHAR	$BER
$LINE_SIDEQUEST_5_GET_10_TEXT	……
$LINE_SIDEQUEST_5_GET_20_CHAR	$BER
$LINE_SIDEQUEST_5_GET_20_TEXT	不在吗？太好了！好了，我们完工了。大家去吃饭吧！
$LINE_SIDEQUEST_5_GET_30_CHAR	$KNI
$LINE_SIDEQUEST_5_GET_30_TEXT	嗯，这可不是站岗的人的工作。
$LINE_SIDEQUEST_5_GET_40_CHAR	$BER
$LINE_SIDEQUEST_5_GET_40_TEXT	噢，没错！我忘了最重要的一步：
$LINE_SIDEQUEST_5_GET_50_CHAR	$BER
$LINE_SIDEQUEST_5_GET_50_TEXT	保持良好形象！
$LINE_SIDEQUEST_5_GET_60_CHAR	$KNI
$LINE_SIDEQUEST_5_GET_60_TEXT	……
$LINE_SIDEQUEST_5_GET_70_CHAR	$KNI
$LINE_SIDEQUEST_5_GET_70_TEXT	这有什么帮助吗？
$LINE_SIDEQUEST_5_GET_80_CHAR	$BER
$LINE_SIDEQUEST_5_GET_80_TEXT	我们要表现的凶神恶煞一点。我是说，像你这样的小虾米走出去，摆明就是让别人来欺负的。
$LINE_SIDEQUEST_5_GET_90_CHAR	$KNI
$LINE_SIDEQUEST_5_GET_90_TEXT	……
$LINE_SIDEQUEST_5_GET_100_CHAR	$KNI
$LINE_SIDEQUEST_5_GET_100_TEXT	那是什么？
$LINE_SIDEQUEST_5_GET_110_CHAR	$BER
$LINE_SIDEQUEST_5_GET_110_TEXT	*这是我新发现的肌肉群。我把它们命名为$BER肌。
$LINE_SIDEQUEST_5_GET_120_CHAR	$KNI
$LINE_SIDEQUEST_5_GET_120_TEXT	不，你这个白痴！我是说那边。有人在跟踪我们。
$LINE_SIDEQUEST_5_GET_130_CHAR	$BER
$LINE_SIDEQUEST_5_GET_130_TEXT	他们一定是难以抗拒我那粗犷男子气概所散发出来的诱惑力，而被吸引过来的。
$LINE_SIDEQUEST_5_GET_140_CHAR	$KNI
$LINE_SIDEQUEST_5_GET_140_TEXT	或者他们是敌人的间谍。呆在这里，我去查看一下。
$LINE_SIDEQUEST_5_GET_150_CHAR	$BER
$LINE_SIDEQUEST_5_GET_150_TEXT	什么？没有我你怎么杀人！等等！
$SCENE_SIDEQUEST_5_INTRO_TITLE	消失在黑暗中
$LINE_SIDEQUEST_5_INTRO_00_CHAR	$KNI
$LINE_SIDEQUEST_5_INTRO_00_TEXT	谁在那儿？！亮明你的身份！
$LINE_SIDEQUEST_5_INTRO_10_CHAR	神秘女子
$LINE_SIDEQUEST_5_INTRO_10_TEXT	消失！
$LINE_SIDEQUEST_5_INTRO_20_CHAR	$KNI
$LINE_SIDEQUEST_5_INTRO_20_TEXT	这是什么？
$LINE_SIDEQUEST_5_INTRO_30_CHAR	神秘女子
$LINE_SIDEQUEST_5_INTRO_30_TEXT	你在这里做什么？
$LINE_SIDEQUEST_5_INTRO_40_CHAR	$KNI
$LINE_SIDEQUEST_5_INTRO_40_TEXT	你到底是谁？
$LINE_SIDEQUEST_5_INTRO_50_CHAR	神秘女子
$LINE_SIDEQUEST_5_INTRO_50_TEXT	……我一定是不小心拉上了你。但是这就意味着……
$LINE_SIDEQUEST_5_INTRO_60_CHAR	$BER
$LINE_SIDEQUEST_5_INTRO_60_TEXT	哟。
$LINE_SIDEQUEST_5_INTRO_70_CHAR	$KNI
$LINE_SIDEQUEST_5_INTRO_70_TEXT	太棒了。你还想带那个傻瓜过来吗？
$LINE_SIDEQUEST_5_INTRO_80_CHAR	$BER
$LINE_SIDEQUEST_5_INTRO_80_TEXT	外面那些数不清的亡者大军怎么办？
$LINE_SIDEQUEST_5_INTRO_90_CHAR	神秘女子
$LINE_SIDEQUEST_5_INTRO_90_TEXT	什么？
$LINE_SIDEQUEST_5_INTRO_100_CHAR	神秘女子
$LINE_SIDEQUEST_5_INTRO_100_TEXT	我要怎么结束这一切？不不不！还太早了！
$LINE_SIDEQUEST_5_INTRO_110_CHAR	神秘女子
$LINE_SIDEQUEST_5_INTRO_110_TEXT	我们必须赶紧逃走！
$LINE_SIDEQUEST_5_INTRO_120_CHAR	$KNI
$LINE_SIDEQUEST_5_INTRO_120_TEXT	你这么想？
$LINE_SIDEQUEST_5_INTRO_130_CHAR	神秘女子
$LINE_SIDEQUEST_5_INTRO_130_TEXT	我们必须再次消失。
$LINE_SIDEQUEST_5_INTRO_140_CHAR	神秘女子
$LINE_SIDEQUEST_5_INTRO_140_TEXT	让他们离我远点！
$SCENE_SIDEQUEST_5_OUTRO_TITLE	沉思谜团
$LINE_SIDEQUEST_5_OUTRO_00_CHAR	$KNI
$LINE_SIDEQUEST_5_OUTRO_00_TEXT	好吧，这是最后一个了。现在我们应该得到一些答案了吧。
$LINE_SIDEQUEST_5_OUTRO_10_CHAR	神秘女子
$LINE_SIDEQUEST_5_OUTRO_10_TEXT	就一次——
$LINE_SIDEQUEST_5_OUTRO_20_CHAR	$KNI
$LINE_SIDEQUEST_5_OUTRO_20_TEXT	你到底是谁？你想干什么？你是怎么能穿越——
$LINE_SIDEQUEST_5_OUTRO_30_CHAR	神秘女子
$LINE_SIDEQUEST_5_OUTRO_30_TEXT	消失。
$LINE_SIDEQUEST_5_OUTRO_40_CHAR	$MCG
$LINE_SIDEQUEST_5_OUTRO_40_TEXT	*好吧，我预料到$BER会干出这些蠢事，但是你，$KNI？你怎么也这么傻？
$LINE_SIDEQUEST_5_OUTRO_50_CHAR	$RAN
$LINE_SIDEQUEST_5_OUTRO_50_TEXT	至少现在还有些东西没有被烧焦。
$LINE_SIDEQUEST_5_OUTRO_60_CHAR	$MCG
$LINE_SIDEQUEST_5_OUTRO_60_TEXT	嘿！只是因为我不会狼吞虎咽地生吃东西——
$LINE_SIDEQUEST_5_OUTRO_70_CHAR	$RAN
$LINE_SIDEQUEST_5_OUTRO_70_TEXT	*$MCG，你也许对很多事情很擅长，但是你得承认我更擅长。
$LINE_SIDEQUEST_5_OUTRO_80_CHAR	$MCG
$LINE_SIDEQUEST_5_OUTRO_80_TEXT	更擅长被勺子打脸吗！
$LINE_SIDEQUEST_5_OUTRO_90_CHAR	$KNI
$LINE_SIDEQUEST_5_OUTRO_90_TEXT	有没有人能在意一下，我现在正站在一锅汤里？！！！
$LINE_SIDEQUEST_5_OUTRO_100_CHAR	$RAN
$LINE_SIDEQUEST_5_OUTRO_100_TEXT	唔，当你把它弄成那样之后……
$LINE_SIDEQUEST_5_OUTRO_110_CHAR	$MCG
$LINE_SIDEQUEST_5_OUTRO_110_TEXT	是啊，你们到底在干什么？
$LINE_SIDEQUEST_5_OUTRO_120_CHAR	$RAN
$LINE_SIDEQUEST_5_OUTRO_120_TEXT	也许可以改善一下汤的味道。
$LINE_SIDEQUEST_5_OUTRO_130_CHAR	$MCG
$LINE_SIDEQUEST_5_OUTRO_130_TEXT	需要我来演示一下我这只拿着勺子的手的力量吗？
$LINE_SIDEQUEST_5_OUTRO_140_CHAR	$BER
$LINE_SIDEQUEST_5_OUTRO_140_TEXT	打起来了！打起来了！
$LINE_SIDEQUEST_5_OUTRO_150_CHAR	$MCG
$LINE_SIDEQUEST_5_OUTRO_150_TEXT	你们到底去哪里了？
$LINE_SIDEQUEST_5_OUTRO_160_CHAR	$BER
$LINE_SIDEQUEST_5_OUTRO_160_TEXT	*噢，$KNI和我被女巫绑架了，她一直在跟踪我们，大概是有什么不可告人的，阴险毒辣的秘密，但是我们还没来得及审问她，她就逃跑了。
$LINE_SIDEQUEST_5_OUTRO_170_CHAR	$MCG
$LINE_SIDEQUEST_5_OUTRO_170_TEXT	什么？你们为什么不告诉我？
$LINE_SIDEQUEST_5_OUTRO_180_CHAR	$BER
$LINE_SIDEQUEST_5_OUTRO_180_TEXT	*很明显，$KNI忙着站在汤里，所以没有时间立刻宣布这个重大事件。
$LINE_SIDEQUEST_5_OUTRO_190_CHAR	$KNI
$LINE_SIDEQUEST_5_OUTRO_190_TEXT	……
$LINE_SIDEQUEST_5_OUTRO_200_CHAR	$KNI
$LINE_SIDEQUEST_5_OUTRO_200_TEXT	我可以借用一下那把勺子吗？
$LINE_SIDEQUEST_5_OUTRO_210_CHAR	$MCG
$LINE_SIDEQUEST_5_OUTRO_210_TEXT	所以她像我一样把你拉进了中途世界？
$LINE_SIDEQUEST_5_OUTRO_220_CHAR	$KNI
$LINE_SIDEQUEST_5_OUTRO_220_TEXT	不止如此。她还能消失，并在另一个地方重新出现。
$LINE_SIDEQUEST_5_OUTRO_230_CHAR	$MCG
$LINE_SIDEQUEST_5_OUTRO_230_TEXT	如果我也有这样的能力的话，我确信我已经不会在墓坑里闲逛了。
$LINE_SIDEQUEST_5_OUTRO_240_CHAR	$KNI
$LINE_SIDEQUEST_5_OUTRO_240_TEXT	我觉得她在找什么东西。当我们在一个奇怪的废墟里出现后，她说了些什么，类似<LQ>还没到时间<RQ>。
$LINE_SIDEQUEST_5_OUTRO_250_CHAR	$KNI
$LINE_SIDEQUEST_5_OUTRO_250_TEXT	而且，她还带着什么东西。
$LINE_SIDEQUEST_5_OUTRO_260_CHAR	$KNI
$LINE_SIDEQUEST_5_OUTRO_260_TEXT	她想在手掌上刻出某种符号。
$LINE_SIDEQUEST_5_OUTRO_270_CHAR	$KNI
$LINE_SIDEQUEST_5_OUTRO_270_TEXT	不知道是什么意思，但我也没有时间去仔细查看。
$LINE_SIDEQUEST_5_OUTRO_280_CHAR	$MCG
$LINE_SIDEQUEST_5_OUTRO_280_TEXT	那是什么？
$LINE_SIDEQUEST_5_OUTRO_290_CHAR	$KNI
$LINE_SIDEQUEST_5_OUTRO_290_TEXT	有点像我之前看到过的诺曼武器。但是和现在部落里生产出的任何东西相比起来，工艺都要更加精良。
$LINE_SIDEQUEST_5_OUTRO_300_CHAR	$MCG
$LINE_SIDEQUEST_5_OUTRO_300_TEXT	……我曾经在图书馆里见过这东西的草图……非常古老……
$LINE_SIDEQUEST_5_OUTRO_310_CHAR	$MCG
$LINE_SIDEQUEST_5_OUTRO_310_TEXT	不管她是谁，她都掌握着大量的知识。
$LINE_SIDEQUEST_5_OUTRO_320_CHAR	$KNI
$LINE_SIDEQUEST_5_OUTRO_320_TEXT	现在开始我们必须保持警惕。
$LINE_SIDEQUEST_5_OUTRO_330_CHAR	$MCG
$LINE_SIDEQUEST_5_OUTRO_330_TEXT	不开玩笑。
$SCENE_3_6_INTRO_TITLE	帅气的近战战士
$LINE_3_6_INTRO_00_CHAR	$BER
$LINE_3_6_INTRO_00_TEXT	嘿，新来的！让我告诉你这里的一些基本规矩。
$LINE_3_6_INTRO_10_CHAR	$BER
$LINE_3_6_INTRO_10_TEXT	这里已经有了一个狂野帅气的近战战士了。
$LINE_3_6_INTRO_20_CHAR	$BER
$LINE_3_6_INTRO_20_TEXT	所以，你为什么不自己去找一些娘炮的投掷装备来使用呢，对吧，新来的？
$LINE_3_6_INTRO_30_CHAR	$BER
$LINE_3_6_INTRO_30_TEXT	我们可不想你在前线受伤。你会弄坏你的指甲或者别的什么的。
$LINE_3_6_INTRO_40_CHAR	$KNI
$LINE_3_6_INTRO_40_TEXT	*我的名字是$KNI，另外，我不喜欢你说话的语气。
$LINE_3_6_INTRO_50_CHAR	$BER
$LINE_3_6_INTRO_50_TEXT	哦，硬汉？一个躲在盔甲后面的硬汉？
$LINE_3_6_INTRO_60_CHAR	$KNI
$LINE_3_6_INTRO_60_TEXT	这些是军用装备，用来——
$LINE_3_6_INTRO_70_CHAR	$BER
$LINE_3_6_INTRO_70_TEXT	……用来让小女孩不要害怕被击中的！
$LINE_3_6_INTRO_80_CHAR	$KNI
$LINE_3_6_INTRO_80_TEXT	这不合乎道理。谁想在战场中被击中？
$LINE_3_6_INTRO_90_CHAR	$KNI
$LINE_3_6_INTRO_90_TEXT	即使是你，也还在战场上穿着裤子呢。
$LINE_3_6_INTRO_100_CHAR	$BER
$LINE_3_6_INTRO_100_TEXT	以后再也不会穿了！
$LINE_3_6_INTRO_110_CHAR	$KNI
$LINE_3_6_INTRO_110_TEXT	什么——？
$LINE_3_6_INTRO_120_CHAR	$MCG
$LINE_3_6_INTRO_120_TEXT	亡者又来了！
$SCENE_3_6_OUTRO_TITLE	不止一人
$LINE_3_6_OUTRO_00_CHAR	$KNI
$LINE_3_6_OUTRO_00_TEXT	这些不是我的人。
$LINE_3_6_OUTRO_10_CHAR	$KNI
$LINE_3_6_OUTRO_10_TEXT	他们一定是从别的地方进城的。
$LINE_3_6_OUTRO_20_CHAR	$HEA
$LINE_3_6_OUTRO_20_TEXT	那就说明我们的秘密入口被人发现了。
$LINE_3_6_OUTRO_30_CHAR	$HEA
$LINE_3_6_OUTRO_30_TEXT	我们必须赶紧离开。
$LINE_3_6_OUTRO_40_CHAR	$HEA
$LINE_3_6_OUTRO_40_TEXT	舍里米尔的追兵正在逼近。
$SCENE_3_7_INTRO_TITLE	不速之客
$LINE_3_7_INTRO_00_CHAR	$MCG
$LINE_3_7_INTRO_00_TEXT	*$KNI看到亡者倒下的时候似乎非常吃惊。
$LINE_3_7_INTRO_10_CHAR	$HEA
$LINE_3_7_INTRO_10_TEXT	你第一次击杀它们的时候，我们都很很吃惊。
$LINE_3_7_INTRO_20_CHAR	$MCG
$LINE_3_7_INTRO_20_TEXT	为什么别人都无法击杀亡者，但是我可以做到？
$LINE_3_7_INTRO_30_CHAR	$HEA
$LINE_3_7_INTRO_30_TEXT	亡者，正如它们的名字一样，它们就只是服从舍里米尔意志的傀儡而已。
$LINE_3_7_INTRO_40_CHAR	$HEA
$LINE_3_7_INTRO_40_TEXT	就算通过奥术力量我仍然无法理解，究竟他是如何通过精神来操控它们的。
$LINE_3_7_INTRO_50_CHAR	$HEA
$LINE_3_7_INTRO_50_TEXT	理论上来说，想要摧毁舍里米尔对它们的控制是不可能的，就像我无法用剑砍掉你的 意志一样。
$LINE_3_7_INTRO_60_CHAR	$MCG
$LINE_3_7_INTRO_60_TEXT	但是我做到了！
$LINE_3_7_INTRO_70_CHAR	$HEA
$LINE_3_7_INTRO_70_TEXT	但是你不是在这个世界做到的。你站在死亡的边缘，处于前往精神世界的半路上。
$LINE_3_7_INTRO_80_CHAR	$HEA
$LINE_3_7_INTRO_80_TEXT	在那里，你的意志可以斩断舍里米尔的意志。
$LINE_3_7_INTRO_90_CHAR	$HEA
$LINE_3_7_INTRO_90_TEXT	所以，那些已经死去的，便可以再死一次……
$LINE_3_7_INTRO_100_CHAR	$MCG
$LINE_3_7_INTRO_100_TEXT	我明白了，所以——
$LINE_3_7_INTRO_110_CHAR	凶恶的龙
$LINE_3_7_INTRO_110_TEXT	什么人胆敢闯入神的领地？
$LINE_3_7_INTRO_120_CHAR	$HEA
$LINE_3_7_INTRO_120_TEXT	大家快后退！
$LINE_3_7_INTRO_130_CHAR	凶恶的龙
$LINE_3_7_INTRO_130_TEXT	快说，否则我把你们都烧成灰烬！
$LINE_3_7_INTRO_140_CHAR	$HEA
$LINE_3_7_INTRO_140_TEXT	现在不是战斗的时候！亡者大军来了！
$LINE_3_7_INTRO_150_CHAR	凶恶的龙
$LINE_3_7_INTRO_150_TEXT	又是那些虫子？我要让它们见识一下圣神的怒火！
$SCENE_3_7_OUTRO_TITLE	龙的诺言
$LINE_3_7_OUTRO_00_CHAR	$DRA
$LINE_3_7_OUTRO_00_TEXT	作为凡人而言，你们打得很不错。
$LINE_3_7_OUTRO_10_CHAR	$DRA
$LINE_3_7_OUTRO_10_TEXT	但是你们贸然闯入这里的行为，仍然不可饶恕。
$LINE_3_7_OUTRO_20_CHAR	$DRA
$LINE_3_7_OUTRO_20_TEXT	……
$LINE_3_7_OUTRO_30_CHAR	$DRA
$LINE_3_7_OUTRO_30_TEXT	不过，如果你们能够替我完成一项特定任务，我也许可以宽恕你们的无礼。
$LINE_3_7_OUTRO_40_CHAR	$MCG
$LINE_3_7_OUTRO_40_TEXT	那作为交换么？
$LINE_3_7_OUTRO_50_CHAR	$DRA
$LINE_3_7_OUTRO_50_TEXT	我会 留你们一条活路，不把你们烤焦。
$LINE_3_7_OUTRO_60_CHAR	$RAN
$LINE_3_7_OUTRO_60_TEXT	听起来是一笔不错的交易。
$LINE_3_7_OUTRO_70_CHAR	$MCG
$LINE_3_7_OUTRO_70_TEXT	我们需要更多的回报。
$LINE_3_7_OUTRO_80_CHAR	$DRA
$LINE_3_7_OUTRO_80_TEXT	你竟敢跟我讨教还价？
$LINE_3_7_OUTRO_90_CHAR	$MCG
$LINE_3_7_OUTRO_90_TEXT	带我们去皇家档案室，我们会竭尽全力协助你。
$LINE_3_7_OUTRO_100_CHAR	$DRA
$LINE_3_7_OUTRO_100_TEXT	……凡人跟神做交易是很不明智的选择。
$LINE_3_7_OUTRO_110_CHAR	$DRA
$LINE_3_7_OUTRO_110_TEXT	你很幸运——我现在心情很好。我同意这个安排。我会遵守诺言的。
$LINE_3_7_OUTRO_120_CHAR	$DRA
$LINE_3_7_OUTRO_120_TEXT	现在跟我来。你们有工作要做。
$LINE_3_7_OUTRO_130_CHAR	$RAN
$LINE_3_7_OUTRO_130_TEXT	哇噢，下次你想要激怒一个巨大的喷火怪物时，请先让我回避一下。
$LINE_3_7_OUTRO_140_CHAR	$MCG
$LINE_3_7_OUTRO_140_TEXT	如果她想要杀了我们的话，我们早就没命了。她需要我们。
$LINE_3_7_OUTRO_150_CHAR	$MCG
$LINE_3_7_OUTRO_150_TEXT	……如果我们能善加利用这一点，那就更好了。
$LINE_3_7_OUTRO_160_CHAR	$RAN
$LINE_3_7_OUTRO_160_TEXT	好吧，但是，呃……
$LINE_3_7_OUTRO_170_CHAR	$RAN
$LINE_3_7_OUTRO_170_TEXT	下次她在的时候，我还是要避免站在你身边。
$LINE_3_7_OUTRO_180_CHAR	$MAG
$LINE_3_7_OUTRO_180_TEXT	你和龙做交易？
$LINE_3_7_OUTRO_190_CHAR	$MCG
$LINE_3_7_OUTRO_190_TEXT	我以为你会很激动……极度，呃……狂热激昂之类的。
$LINE_3_7_OUTRO_200_CHAR	$MCG
$LINE_3_7_OUTRO_200_TEXT	你不是同道中人吗？
$LINE_3_7_OUTRO_210_CHAR	$MAG
$LINE_3_7_OUTRO_210_TEXT	你没有听到她自称为神吗？
$LINE_3_7_OUTRO_220_CHAR	$MAG
$LINE_3_7_OUTRO_220_TEXT	这可不是为火焰效忠的那些龙。
$LINE_3_7_OUTRO_230_CHAR	$MAG
$LINE_3_7_OUTRO_230_TEXT	恐怕我们遇到了一条邪恶的龙……它们运用火焰只是为了它们自私的荣耀。
$LINE_3_7_OUTRO_240_CHAR	$MCG
$LINE_3_7_OUTRO_240_TEXT	但是，即使是恶人也能做善事。
$LINE_3_7_OUTRO_250_CHAR	$MAG
$LINE_3_7_OUTRO_250_TEXT	*说得好，$MCG，但是它仍然非常危险。大多数人认为他们拥有的智慧足以将黑暗力量玩弄于鼓掌之间。
$LINE_3_7_OUTRO_260_CHAR	$MAG
$LINE_3_7_OUTRO_260_TEXT	不要让自大蒙蔽了双眼。
$LINE_3_7_OUTRO_270_CHAR	$MCG
$LINE_3_7_OUTRO_270_TEXT	*当然，$MAG。我觉得我们……
$LINE_3_7_OUTRO_280_CHAR	$MCG
$LINE_3_7_OUTRO_280_TEXT	……在玩火。
$LINE_3_7_OUTRO_290_CHAR	$MAG
$LINE_3_7_OUTRO_290_TEXT	甚至……不是……呃。
$LINE_3_7_OUTRO_300_CHAR	$MCG
$LINE_3_7_OUTRO_300_TEXT	来吧，会很有趣的。
$LINE_3_7_OUTRO_310_CHAR	$MAG
$LINE_3_7_OUTRO_310_TEXT	……我脑袋疼。
$SCENE_3_8_INTRO_TITLE	保卫巢穴
$LINE_3_8_INTRO_00_CHAR	$MCG
$LINE_3_8_INTRO_00_TEXT	所以，某些龙是值得信任的？
$LINE_3_8_INTRO_10_CHAR	$MAG
$LINE_3_8_INTRO_10_TEXT	起初，所有的龙都效力于火焰的……
$LINE_3_8_INTRO_20_CHAR	$MAG
$LINE_3_8_INTRO_20_TEXT	而且，火焰把他们作为光辉的榜样，送到全世界人类的面前。
$LINE_3_8_INTRO_30_CHAR	$MAG
$LINE_3_8_INTRO_30_TEXT	但是有一些龙，它们看到了人类的那些闪亮的金银珠宝后，开始垂涎觊觎。
$LINE_3_8_INTRO_40_CHAR	$MAG
$LINE_3_8_INTRO_40_TEXT	它们不再愿意为宇宙之焰效力，而是开始滥用自身的力量来壮大自己。
$LINE_3_8_INTRO_50_CHAR	$MAG
$LINE_3_8_INTRO_50_TEXT	它们不断地掠夺，不断的囤积，最终成为了可悲的，毁灭性的生物，反观它们真实的初衷，简直是一种讽刺。
$LINE_3_8_INTRO_60_CHAR	$MAG
$LINE_3_8_INTRO_60_TEXT	其他的在这个世界待得太久，都已经忘了是谁，是什么 原因把它们送来的。
$LINE_3_8_INTRO_70_CHAR	$MAG
$LINE_3_8_INTRO_70_TEXT	它们在这个世界游荡，徘徊，但它们还保留一些关于被召唤的记忆，靠着这点残存的朦胧记忆，它们没有堕落。
$LINE_3_8_INTRO_80_CHAR	$MAG
$LINE_3_8_INTRO_80_TEXT	最后，最少数、最明智的一部分，忠诚地效力于火神。
$LINE_3_8_INTRO_90_CHAR	$MAG
$LINE_3_8_INTRO_90_TEXT	最好你要见的就是这一部分。
$LINE_3_8_INTRO_100_CHAR	$MAG
$LINE_3_8_INTRO_100_TEXT	那些已经遗忘的，非常危险而且不可预测，但是有时它们也会给予你祝福和财富。
$LINE_3_8_INTRO_110_CHAR	$MAG
$LINE_3_8_INTRO_110_TEXT	那些已经堕落的，只会带来毁灭。
$LINE_3_8_INTRO_120_CHAR	$MCG
$LINE_3_8_INTRO_120_TEXT	那你认为我们的伙伴是怎样的？
$LINE_3_8_INTRO_130_CHAR	$MAG
$LINE_3_8_INTRO_130_TEXT	她要么是堕落的，要么是遗忘的。看在上帝的份上，我希望——
$LINE_3_8_INTRO_140_CHAR	$DRA
$LINE_3_8_INTRO_140_TEXT	我们到了，人类！
$LINE_3_8_INTRO_150_CHAR	$DRA
$LINE_3_8_INTRO_150_TEXT	现在开始你们的任务吧。
$LINE_3_8_INTRO_160_CHAR	$MCG
$LINE_3_8_INTRO_160_TEXT	这是一个……巢穴？
$LINE_3_8_INTRO_170_CHAR	$DRA
$LINE_3_8_INTRO_170_TEXT	每天晚上，敌人都会来攻击。
$LINE_3_8_INTRO_180_CHAR	$DRA
$LINE_3_8_INTRO_180_TEXT	我已经击退了成千上百的敌人，但他们仍然源源不断的过来。
$LINE_3_8_INTRO_190_CHAR	$DRA
$LINE_3_8_INTRO_190_TEXT	每天早上，我就又有一些孩子失踪了。
$LINE_3_8_INTRO_200_CHAR	$MCG
$LINE_3_8_INTRO_200_TEXT	为什么亡者们想要得到龙？
$LINE_3_8_INTRO_210_CHAR	$DRA
$LINE_3_8_INTRO_210_TEXT	现在不是提问的时间，人类。
$LINE_3_8_INTRO_220_CHAR	$MCG
$LINE_3_8_INTRO_220_TEXT	敌人来了！
$LINE_3_8_INTRO_230_CHAR	$DRA
$LINE_3_8_INTRO_230_TEXT	现在是开火的时间。
$SCENE_3_8_OUTRO_TITLE	最后一件事
$NARR_3_8_OUTRO_00_TEXT	第五幕
$NARR_3_8_OUTRO_00_SUB_TEXT	*让我们狂舞吧，伴着死者的鲜血！$N让我们高歌吧，赞颂主人的伟大！$N飞溅，喷射，洗涤这个世界，直到他的归来！
$NARR_3_8_OUTRO_00_SUB_SUB_TEXT	*$N$N$N$N$N——狂血之歌，来自革卡部落生还者的描述
$LINE_3_8_OUTRO_00_CHAR	$MCG
$LINE_3_8_OUTRO_00_TEXT	你的孩子们都安全了，大人。
$LINE_3_8_OUTRO_10_CHAR	$DRA
$LINE_3_8_OUTRO_10_TEXT	你们做的很好，人类。
$LINE_3_8_OUTRO_20_CHAR	$MCG
$LINE_3_8_OUTRO_20_TEXT	我们坚守了我们的诺言。
$LINE_3_8_OUTRO_30_CHAR	$DRA
$LINE_3_8_OUTRO_30_TEXT	是的，是的……当然……
$LINE_3_8_OUTRO_40_CHAR	$DRA
$LINE_3_8_OUTRO_40_TEXT	但是我的孩子们都太饿了，它们没办法走到你要找的那个房间。
$LINE_3_8_OUTRO_50_CHAR	$DRA
$LINE_3_8_OUTRO_50_TEXT	我们上一次进食已经是在好几个月前了……
$LINE_3_8_OUTRO_60_CHAR	$MCG
$LINE_3_8_OUTRO_60_TEXT	我们有什么可以帮忙的吗？
$LINE_3_8_OUTRO_70_CHAR	$DRA
$LINE_3_8_OUTRO_70_TEXT	作为一个人类而言，你勇气可嘉。
$LINE_3_8_OUTRO_80_CHAR	$DRA
$LINE_3_8_OUTRO_80_TEXT	但是……也许吧。
$LINE_3_8_OUTRO_90_CHAR	$DRA
$LINE_3_8_OUTRO_90_TEXT	也许你队伍中的一两个成员，可以充当一下牺牲品？
$LINE_3_8_OUTRO_100_CHAR	$DRA
$LINE_3_8_OUTRO_100_TEXT	例如那个长着奇怪眼睛的呆子。
$LINE_3_8_OUTRO_110_CHAR	$DRA
$LINE_3_8_OUTRO_110_TEXT	或者那个眼里充满不信任的，怒气冲冲的沉默女孩。
$LINE_3_8_OUTRO_120_CHAR	$MCG
$LINE_3_8_OUTRO_120_TEXT	或者是别的东西怎么样？
$LINE_3_8_OUTRO_130_CHAR	$MCG
$LINE_3_8_OUTRO_130_TEXT	比如，嗯……用羊来代替？？
$LINE_3_8_OUTRO_140_CHAR	$MCG
$LINE_3_8_OUTRO_140_TEXT	上等，美味，多汁的嫩羊肉？
$LINE_3_8_OUTRO_150_CHAR	$DRA
$LINE_3_8_OUTRO_150_TEXT	嗯……
$LINE_3_8_OUTRO_160_CHAR	$DRA
$LINE_3_8_OUTRO_160_TEXT	我想应该够了。
$LINE_3_8_OUTRO_170_CHAR	$DRA
$LINE_3_8_OUTRO_170_TEXT	但是要尽快！我的耐心就快消磨光了。
$SCENE_3_9_INTRO_TITLE	羊肉
$LINE_3_9_INTRO_00_CHAR	$RAN
$LINE_3_9_INTRO_00_TEXT	羊？你确定？这就是你能想到的最好的办法吗？
$LINE_3_9_INTRO_10_CHAR	$MCG
$LINE_3_9_INTRO_10_TEXT	听着，我已经在尽力想办法不让大家被吃掉了，好吗？
$LINE_3_9_INTRO_20_CHAR	$RAN
$LINE_3_9_INTRO_20_TEXT	那你认为如果我们找不到你承诺的神奇的羊的话，会发生什么？
$LINE_3_9_INTRO_30_CHAR	$MCG
$LINE_3_9_INTRO_30_TEXT	我只是说了我脑海中蹦出的想法而已。
$LINE_3_9_INTRO_40_CHAR	$RAN
$LINE_3_9_INTRO_40_TEXT	所以你脑海中蹦出的第一个想法是<LQ>羊<RQ>？这里在你看来像是一片牧场吗？
$LINE_3_9_INTRO_50_CHAR	$MCG
$LINE_3_9_INTRO_50_TEXT	不，我脑海中蹦出来的第一个想法是<LQ>是啊，吃了那个讨厌的，皮包骨的，喋喋不休的黑发的女孩吧。<RQ>
$LINE_3_9_INTRO_60_CHAR	$RAN
$LINE_3_9_INTRO_60_TEXT	什么喋喋不休，我？还是我的黑发？
$LINE_3_9_INTRO_70_CHAR	$MCG
$LINE_3_9_INTRO_70_TEXT	都是！
$LINE_3_9_INTRO_80_CHAR	$RAN
$LINE_3_9_INTRO_80_TEXT	你要知道，我甚至不需要动脑子去想什么机智的言论来反驳，因为这是与生俱来的——
$LINE_3_9_INTRO_90_CHAR	羊
$LINE_3_9_INTRO_90_TEXT	咩咩呸。
$LINE_3_9_INTRO_100_CHAR	$RAN
$LINE_3_9_INTRO_100_TEXT	……
$LINE_3_9_INTRO_110_CHAR	$RAN
$LINE_3_9_INTRO_110_TEXT	好吧，这只是……
$LINE_3_9_INTRO_120_CHAR	$MAG
$LINE_3_9_INTRO_120_TEXT	*这让我印象深刻，$MCG。
$LINE_3_9_INTRO_130_CHAR	$MAG
$LINE_3_9_INTRO_130_TEXT	不是很多人知道奎德城市地下的秘密羊圈。
$LINE_3_9_INTRO_140_CHAR	$MAG
$LINE_3_9_INTRO_140_TEXT	通常只有在城市被围困时，它们才会派上用场，不过就目前情况而言，可以破例一次。
$LINE_3_9_INTRO_150_CHAR	$MAG
$LINE_3_9_INTRO_150_TEXT	我只希望它们没有……过于野性化。
$LINE_3_9_INTRO_160_CHAR	$MCG
$LINE_3_9_INTRO_160_TEXT	野性化？
$LINE_3_9_INTRO_170_CHAR	$MAG
$LINE_3_9_INTRO_170_TEXT	因为城市被废弃已久，它们除了洞穴菇和同类，没别的东西可吃。
$LINE_3_9_INTRO_180_CHAR	$MAG
$LINE_3_9_INTRO_180_TEXT	它们变得……异常凶残。
$LINE_3_9_INTRO_190_CHAR	$MCG
$LINE_3_9_INTRO_190_TEXT	我由衷地希望，有一天，我能不用再和那些对我生命构成威胁的生物打交道。
$LINE_3_9_INTRO_200_CHAR	$MAG
$LINE_3_9_INTRO_200_TEXT	从它们的表情来看，今天应该不是你说的那一天。
$SCENE_3_9_OUTRO_TITLE	吃饱喝足
$LINE_3_9_OUTRO_00_CHAR	$DRA
$LINE_3_9_OUTRO_00_TEXT	我的孩子们享用了美食，体力已经恢复了。
$LINE_3_9_OUTRO_10_CHAR	$MCG
$LINE_3_9_OUTRO_10_TEXT	*我们已经兑现了我们的承诺了，$DRA。
$LINE_3_9_OUTRO_20_CHAR	$DRA
$LINE_3_9_OUTRO_20_TEXT	很好，我会带你们去皇家档案室，不过我有最后一个规矩。
$LINE_3_9_OUTRO_30_CHAR	$DRA
$LINE_3_9_OUTRO_30_TEXT	当你们完成要做的事之后，必须带我们一起离开墓坑。
$LINE_3_9_OUTRO_40_CHAR	$MCG
$LINE_3_9_OUTRO_40_TEXT	你有翅膀，你不能直接飞出去吗？
$LINE_3_9_OUTRO_50_CHAR	$DRA
$LINE_3_9_OUTRO_50_TEXT	你的问题太多了，人类。
$LINE_3_9_OUTRO_60_CHAR	$DRA
$LINE_3_9_OUTRO_60_TEXT	就算是像你这样有用的人，也会因为冒犯而被我烧死的。
$LINE_3_9_OUTRO_70_CHAR	$MCG
$LINE_3_9_OUTRO_70_TEXT	好吧，我们乐意带你们一起走。
$LINE_3_9_OUTRO_80_CHAR	$DRA
$LINE_3_9_OUTRO_80_TEXT	你本该如此。
$LINE_3_9_OUTRO_90_CHAR	$MCG
$LINE_3_9_OUTRO_90_TEXT	但是你们都必须像其他人一样共同战斗。
$LINE_3_9_OUTRO_100_CHAR	$DRA
$LINE_3_9_OUTRO_100_TEXT	……
$LINE_3_9_OUTRO_110_CHAR	$DRA
$LINE_3_9_OUTRO_110_TEXT	你在讨价还价，人类。
$LINE_3_9_OUTRO_120_CHAR	$DRA
$LINE_3_9_OUTRO_120_TEXT	……你的大胆让我觉得很有趣。
$LINE_3_9_OUTRO_130_CHAR	$DRA
$LINE_3_9_OUTRO_130_TEXT	只要孩子们的劳动都有补偿，那我们会给你的敌人送上烈焰的。
$SCENE_DRAGON_LAIR_INTRO_TITLE	龙之宝库
$LINE_DRAGON_LAIR_INTRO_00_CHAR	$DRA
$LINE_DRAGON_LAIR_INTRO_00_TEXT	这些年来，我们收藏了很多人类的武器和铠甲在我们的宝库里。
$LINE_DRAGON_LAIR_INTRO_10_CHAR	$DRA
$LINE_DRAGON_LAIR_INTRO_10_TEXT	这些东西对我们而言没有用处，但是它们……闪闪发光，我们喜欢闪亮的东西。
$LINE_DRAGON_LAIR_INTRO_20_CHAR	$DRA
$LINE_DRAGON_LAIR_INTRO_20_TEXT	我相信，向你们这样的战队应该可以好好利用这些东西。
$LINE_DRAGON_LAIR_INTRO_30_CHAR	$DRA
$LINE_DRAGON_LAIR_INTRO_30_TEXT	当然得有个合适的价格……
$LINE_DRAGON_LAIR_INTRO_40_CHAR	$BER
$LINE_DRAGON_LAIR_INTRO_40_TEXT	伙计，羊肉炖汤就非常棒！
$LINE_DRAGON_LAIR_INTRO_50_CHAR	$DRA
$LINE_DRAGON_LAIR_INTRO_50_TEXT	我已经把那些炖汤反哺给孩子们了。
$LINE_DRAGON_LAIR_INTRO_60_CHAR	$BER
$LINE_DRAGON_LAIR_INTRO_60_TEXT	……
$LINE_DRAGON_LAIR_INTRO_70_CHAR	$DRA
$LINE_DRAGON_LAIR_INTRO_70_TEXT	……
$LINE_DRAGON_LAIR_INTRO_80_CHAR	$BER
$LINE_DRAGON_LAIR_INTRO_80_TEXT	还有吗？
$SCENE_DRAGON_LAIR_OUTRO_TITLE	漫长的故事
$LINE_DRAGON_LAIR_OUTRO_00_CHAR	$MCG
$LINE_DRAGON_LAIR_OUTRO_00_TEXT	我们现在就走……
$LINE_DRAGON_LAIR_OUTRO_10_CHAR	$MCG
$LINE_DRAGON_LAIR_OUTRO_10_TEXT	*长老$HEA？
$LINE_DRAGON_LAIR_OUTRO_20_CHAR	$HEA
$LINE_DRAGON_LAIR_OUTRO_20_TEXT	摧毁世界，真的是一件极其简单的事情。
$LINE_DRAGON_LAIR_OUTRO_30_CHAR	$HEA
$LINE_DRAGON_LAIR_OUTRO_30_TEXT	舍里米尔把我带了出来——带到遥远的东部沙漠，最后带进一个黑暗洞穴中。
$LINE_DRAGON_LAIR_OUTRO_40_CHAR	$HEA
$LINE_DRAGON_LAIR_OUTRO_40_TEXT	我们来到一个三十尺高的水晶前。
$LINE_DRAGON_LAIR_OUTRO_50_CHAR	$HEA
$LINE_DRAGON_LAIR_OUTRO_50_TEXT	然后，我们让自己的鲜血流淌到石头上。
$LINE_DRAGON_LAIR_OUTRO_60_CHAR	$HEA
$LINE_DRAGON_LAIR_OUTRO_60_TEXT	伤口无法愈合。
$LINE_DRAGON_LAIR_OUTRO_70_CHAR	$HEA
$LINE_DRAGON_LAIR_OUTRO_70_TEXT	一开始，我以为什么都没有发生。
$LINE_DRAGON_LAIR_OUTRO_80_CHAR	$HEA
$LINE_DRAGON_LAIR_OUTRO_80_TEXT	但是舍里米尔……他进入了一种恍惚出神的状态。我只好等着。
$LINE_DRAGON_LAIR_OUTRO_90_CHAR	$HEA
$LINE_DRAGON_LAIR_OUTRO_90_TEXT	太阳下山了，我能听见周围那些沙漠野兽的吼叫声。但是，舍里米尔仍然纹丝不动。
$LINE_DRAGON_LAIR_OUTRO_100_CHAR	$HEA
$LINE_DRAGON_LAIR_OUTRO_100_TEXT	接着一头巨狼突然跳进我们的帐篷，他仍然没有任何反应……
$LINE_DRAGON_LAIR_OUTRO_110_CHAR	$HEA
$LINE_DRAGON_LAIR_OUTRO_110_TEXT	我用剑刺穿了它，然后它就在舍里米尔的脚边，抽搐着咽下最后一口气。
$LINE_DRAGON_LAIR_OUTRO_120_CHAR	$HEA
$LINE_DRAGON_LAIR_OUTRO_120_TEXT	即使这样，他都没有注意到。我们就这样度过了三个晚上。
$LINE_DRAGON_LAIR_OUTRO_130_CHAR	$HEA
$LINE_DRAGON_LAIR_OUTRO_130_TEXT	在第三天的黎明，他眨了三次眼睛，然后站了起来。
$LINE_DRAGON_LAIR_OUTRO_140_CHAR	$HEA
$LINE_DRAGON_LAIR_OUTRO_140_TEXT	<LQ>我们的问题解决了，<RQ>他说道。
$LINE_DRAGON_LAIR_OUTRO_150_CHAR	$HEA
$LINE_DRAGON_LAIR_OUTRO_150_TEXT	当我们回到营地时，敌人已经溃不成军。
$LINE_DRAGON_LAIR_OUTRO_160_CHAR	$HEA
$LINE_DRAGON_LAIR_OUTRO_160_TEXT	瘟疫开始爆发。
$LINE_DRAGON_LAIR_OUTRO_170_CHAR	$HEA
$LINE_DRAGON_LAIR_OUTRO_170_TEXT	每天，他……出神的时间越来越久，灵魂出窍去了别的地方。
$LINE_DRAGON_LAIR_OUTRO_180_CHAR	$HEA
$LINE_DRAGON_LAIR_OUTRO_180_TEXT	一个月内，奎德帝国的一半人口，要么死了，要么濒临死亡，或者更糟。
$LINE_DRAGON_LAIR_OUTRO_190_CHAR	$HEA
$LINE_DRAGON_LAIR_OUTRO_190_TEXT	焚烧尸体的火焰把地平线都染红了……城市崩分离析。我看到了战争中都无法目睹的景象。
$LINE_DRAGON_LAIR_OUTRO_200_CHAR	$HEA
$LINE_DRAGON_LAIR_OUTRO_200_TEXT	我知道这必须停止了。
$LINE_DRAGON_LAIR_OUTRO_210_CHAR	$HEA
$LINE_DRAGON_LAIR_OUTRO_210_TEXT	但是舍里米尔——他听不见我说话……
$LINE_DRAGON_LAIR_OUTRO_220_CHAR	$HEA
$LINE_DRAGON_LAIR_OUTRO_220_TEXT	每天他出神的时间越来越长，直到最后，他完全不再回神。
$LINE_DRAGON_LAIR_OUTRO_230_CHAR	$HEA
$LINE_DRAGON_LAIR_OUTRO_230_TEXT	我等了三天。每天都有上千人死去。
$LINE_DRAGON_LAIR_OUTRO_240_CHAR	$HEA
$LINE_DRAGON_LAIR_OUTRO_240_TEXT	最后，在一个清晨，我走进了他的帐篷。
$LINE_DRAGON_LAIR_OUTRO_250_CHAR	$HEA
$LINE_DRAGON_LAIR_OUTRO_250_TEXT	他没有注意到我……他已经不能注意到任何事情。
$LINE_DRAGON_LAIR_OUTRO_260_CHAR	$HEA
$LINE_DRAGON_LAIR_OUTRO_260_TEXT	我拔剑刺穿了他。
$LINE_DRAGON_LAIR_OUTRO_270_CHAR	$HEA
$LINE_DRAGON_LAIR_OUTRO_270_TEXT	我把他埋在了沙漠里。
$LINE_DRAGON_LAIR_OUTRO_280_CHAR	$HEA
$LINE_DRAGON_LAIR_OUTRO_280_TEXT	但是瘟疫还在继续蔓延，越过了边境，毁灭了路上的一切。
$LINE_DRAGON_LAIR_OUTRO_290_CHAR	$HEA
$LINE_DRAGON_LAIR_OUTRO_290_TEXT	在回家的长途跋涉中，我遇到了一群瑟连里僧侣。
$LINE_DRAGON_LAIR_OUTRO_300_CHAR	$HEA
$LINE_DRAGON_LAIR_OUTRO_300_TEXT	我扔掉了我的剑，跪倒在他们脚下。从此之后，成为了一名僧侣。
$LINE_DRAGON_LAIR_OUTRO_310_CHAR	$HEA
$LINE_DRAGON_LAIR_OUTRO_310_TEXT	但是现在，我曾经杀掉的这位朋友已经变成了怪兽，并且卷土重来。
$LINE_DRAGON_LAIR_OUTRO_320_CHAR	$HEA
$LINE_DRAGON_LAIR_OUTRO_320_TEXT	*这就是我们要对抗的黑魔法，$MCG。
$LINE_DRAGON_LAIR_OUTRO_330_CHAR	$HEA
$LINE_DRAGON_LAIR_OUTRO_330_TEXT	我虔心祈祷，这些记录资料中有解决这场灾难的答案。
$LINE_DRAGON_LAIR_OUTRO_340_CHAR	$MCG
$LINE_DRAGON_LAIR_OUTRO_340_TEXT	我们也是如此，长老。
$SCENE_SIDEQUEST_6_GET_TITLE	堕落神庙
$LINE_SIDEQUEST_6_GET_00_CHAR	$KNI
$LINE_SIDEQUEST_6_GET_00_TEXT	*$MCG？
$LINE_SIDEQUEST_6_GET_10_CHAR	$MCG
$LINE_SIDEQUEST_6_GET_10_TEXT	嘿，你终于搞定了名字这件基础的事情了。
$LINE_SIDEQUEST_6_GET_20_CHAR	$KNI
$LINE_SIDEQUEST_6_GET_20_TEXT	我无意要评判你对盟友的选择，但是你那，咆哮的，精神变态的仇敌公主是要把我们都杀了。
$LINE_SIDEQUEST_6_GET_30_CHAR	$MCG
$LINE_SIDEQUEST_6_GET_30_TEXT	*$MAG真的没有那么坏，只要你别管那些杀人狂的那部分。
$LINE_SIDEQUEST_6_GET_40_CHAR	$KNI
$LINE_SIDEQUEST_6_GET_40_TEXT	恐怕她只有<LQ>杀人狂<RQ>的那部分。
$LINE_SIDEQUEST_6_GET_50_CHAR	$MCG
$LINE_SIDEQUEST_6_GET_50_TEXT	你应该试着找个时间和她聊聊。
$LINE_SIDEQUEST_6_GET_60_CHAR	$KNI
$LINE_SIDEQUEST_6_GET_60_TEXT	是啊，一个曾经的守卫和一个曾经的犯人应该可以成为好朋友的。
$LINE_SIDEQUEST_6_GET_70_CHAR	$KNI
$LINE_SIDEQUEST_6_GET_70_TEXT	然后，借助友谊的力量，我们可以坐上彩虹，逃出墓坑。
$LINE_SIDEQUEST_6_GET_80_CHAR	$MCG
$LINE_SIDEQUEST_6_GET_80_TEXT	你究竟想说什么？
$LINE_SIDEQUEST_6_GET_90_CHAR	$KNI
$LINE_SIDEQUEST_6_GET_90_TEXT	好吧，很明显，这里有一些被玷污的奎德神庙。
$LINE_SIDEQUEST_6_GET_100_CHAR	$KNI
$LINE_SIDEQUEST_6_GET_100_TEXT	*$MAG发现了这一点，然后变得有点……那个词怎么说来着？
$LINE_SIDEQUEST_6_GET_110_CHAR	$KNI
$LINE_SIDEQUEST_6_GET_110_TEXT	你是个图书管理员——有没有一个形容词是说：
$LINE_SIDEQUEST_6_GET_120_CHAR	$KNI
$LINE_SIDEQUEST_6_GET_120_TEXT	<LQ>丢弃了脆弱的一贯正面的伪装，而表现出了密封在之下的疯狂的沸腾的内心？<RQ>
$LINE_SIDEQUEST_6_GET_130_CHAR	$BER
$LINE_SIDEQUEST_6_GET_130_TEXT	*$MCG！
$LINE_SIDEQUEST_6_GET_140_CHAR	$MCG
$LINE_SIDEQUEST_6_GET_140_TEXT	什么？
$LINE_SIDEQUEST_6_GET_150_CHAR	$BER
$LINE_SIDEQUEST_6_GET_150_TEXT	*这不公平！$MAG不愿意分享！
$LINE_SIDEQUEST_6_GET_160_CHAR	$MCG
$LINE_SIDEQUEST_6_GET_160_TEXT	你到底在说什么？
$LINE_SIDEQUEST_6_GET_170_CHAR	$BER
$LINE_SIDEQUEST_6_GET_170_TEXT	*$MAG发现了这个超级酷的古老圣地，那里有……十亿后面的数字是什么？
$LINE_SIDEQUEST_6_GET_180_CHAR	$MCG
$LINE_SIDEQUEST_6_GET_180_TEXT	十亿零一？
$LINE_SIDEQUEST_6_GET_190_CHAR	$BER
$LINE_SIDEQUEST_6_GET_190_TEXT	*是的，那里有十亿零一个亡者在里面，但是$MAG不让我们和它们战斗！
$LINE_SIDEQUEST_6_GET_200_CHAR	$MCG
$LINE_SIDEQUEST_6_GET_200_TEXT	你有没有想过，除非真的有必要，我不想再和更多的怪物战斗了？
$LINE_SIDEQUEST_6_GET_210_CHAR	$BER
$LINE_SIDEQUEST_6_GET_210_TEXT	……
$LINE_SIDEQUEST_6_GET_220_CHAR	$BER
$LINE_SIDEQUEST_6_GET_220_TEXT	……无法理解……奇怪的……外国逻辑……
$LINE_SIDEQUEST_6_GET_230_CHAR	$BER
$LINE_SIDEQUEST_6_GET_230_TEXT	*不管怎样，$MAG说这是她的地盘，谁要进去就杀了谁！
$LINE_SIDEQUEST_6_GET_240_CHAR	$BER
$LINE_SIDEQUEST_6_GET_240_TEXT	这不公平！你应该去融掉她的脸！！！
$LINE_SIDEQUEST_6_GET_250_CHAR	$MCG
$LINE_SIDEQUEST_6_GET_250_TEXT	……总是要融掉别人的脸。
$LINE_SIDEQUEST_6_GET_260_CHAR	$KNI
$LINE_SIDEQUEST_6_GET_260_TEXT	看吧，她是在太疯狂了，她甚至能恐吓其他的疯子。
$LINE_SIDEQUEST_6_GET_270_CHAR	$MCG
$LINE_SIDEQUEST_6_GET_270_TEXT	我想我应该去弄清楚真相。
$SCENE_SIDEQUEST_6_INTRO_TITLE	火焰之仆
$LINE_SIDEQUEST_6_INTRO_00_CHAR	$MAG
$LINE_SIDEQUEST_6_INTRO_00_TEXT	我是火焰之女！
$LINE_SIDEQUEST_6_INTRO_10_CHAR	$BER
$LINE_SIDEQUEST_6_INTRO_10_TEXT	*好吧，$MCG说她不在意你是谁，你必须分享！
$LINE_SIDEQUEST_6_INTRO_20_CHAR	$MCG
$LINE_SIDEQUEST_6_INTRO_20_TEXT	这不是我说的。
$LINE_SIDEQUEST_6_INTRO_30_CHAR	$MAG
$LINE_SIDEQUEST_6_INTRO_30_TEXT	我可以一个人把这些讨厌的东西赶出去。我净化这座神庙可不是为了让其他敌人进去！
$LINE_SIDEQUEST_6_INTRO_40_CHAR	$MCG
$LINE_SIDEQUEST_6_INTRO_40_TEXT	*$MAG，听我说。你不能一个人去做这些事。
$LINE_SIDEQUEST_6_INTRO_50_CHAR	$MAG
$LINE_SIDEQUEST_6_INTRO_50_TEXT	*我是$MAG·兰·兰世弥！我是火焰女祭司！无论是生是死，我都不能容忍敌人进入火焰之屋！
$LINE_SIDEQUEST_6_INTRO_60_CHAR	$MCG
$LINE_SIDEQUEST_6_INTRO_60_TEXT	*$MAG？让我——
$LINE_SIDEQUEST_6_INTRO_70_CHAR	$MAG
$LINE_SIDEQUEST_6_INTRO_70_TEXT	*$MCG，不要。我会杀了你。我没有选择。没有人能进去神庙拯救真理知者。
$LINE_SIDEQUEST_6_INTRO_80_CHAR	$MAG
$LINE_SIDEQUEST_6_INTRO_80_TEXT	我曾发誓要竭尽全力地维护信仰和荣耀。不要逼我杀死自己的朋友。
$LINE_SIDEQUEST_6_INTRO_90_CHAR	$MCG
$LINE_SIDEQUEST_6_INTRO_90_TEXT	没有我，你打算怎么去杀死那些亡者？
$LINE_SIDEQUEST_6_INTRO_100_CHAR	$MAG
$LINE_SIDEQUEST_6_INTRO_100_TEXT	……我会想办法。
$LINE_SIDEQUEST_6_INTRO_110_CHAR	$MCG
$LINE_SIDEQUEST_6_INTRO_110_TEXT	*你想死吗？这就是你的想法吗，$MAG？
$LINE_SIDEQUEST_6_INTRO_120_CHAR	$MAG
$LINE_SIDEQUEST_6_INTRO_120_TEXT	我只想着要为火焰效命！
$LINE_SIDEQUEST_6_INTRO_130_CHAR	$MCG
$LINE_SIDEQUEST_6_INTRO_130_TEXT	噢，所以你打算牺牲自己来为火焰效命吗？你打算永远地斩断奎德的血脉吗？
$LINE_SIDEQUEST_6_INTRO_140_CHAR	$MCG
$LINE_SIDEQUEST_6_INTRO_140_TEXT	所以你打算站在审判面前，说：
$LINE_SIDEQUEST_6_INTRO_150_CHAR	$MCG
$LINE_SIDEQUEST_6_INTRO_150_TEXT	<LQ>我害怕眼前的任务，并且蔑视你们赠予的工具，所以我选择死亡。<RQ>
$LINE_SIDEQUEST_6_INTRO_160_CHAR	$MAG
$LINE_SIDEQUEST_6_INTRO_160_TEXT	不！
$LINE_SIDEQUEST_6_INTRO_170_CHAR	$MCG
$LINE_SIDEQUEST_6_INTRO_170_TEXT	真的吗？因为这就是我看到的。你的墓志铭会写着<LQ>没有勇气重建她的王国，所以选择认输。<RQ>
$LINE_SIDEQUEST_6_INTRO_180_CHAR	$MAG
$LINE_SIDEQUEST_6_INTRO_180_TEXT	不！！！
$LINE_SIDEQUEST_6_INTRO_190_CHAR	$MCG
$LINE_SIDEQUEST_6_INTRO_190_TEXT	那让我跟你一起。
$LINE_SIDEQUEST_6_INTRO_200_CHAR	$MAG
$LINE_SIDEQUEST_6_INTRO_200_TEXT	但是……
$LINE_SIDEQUEST_6_INTRO_210_CHAR	$MCG
$LINE_SIDEQUEST_6_INTRO_210_TEXT	你如果一个人进去的话，那你能帮助的只有你的敌人。
$LINE_SIDEQUEST_6_INTRO_220_CHAR	$MCG
$LINE_SIDEQUEST_6_INTRO_220_TEXT	你到底站在哪一边？
$LINE_SIDEQUEST_6_INTRO_230_CHAR	$MAG
$LINE_SIDEQUEST_6_INTRO_230_TEXT	我……永远为火焰效命……
$LINE_SIDEQUEST_6_INTRO_240_CHAR	$MCG
$LINE_SIDEQUEST_6_INTRO_240_TEXT	那让我们去净化神庙吧。
$SCENE_SIDEQUEST_6_OUTRO_TITLE	收集碎片
$LINE_SIDEQUEST_6_OUTRO_00_CHAR	$MAG
$LINE_SIDEQUEST_6_OUTRO_00_TEXT	你竟敢到这里来？！
$LINE_SIDEQUEST_6_OUTRO_10_CHAR	$DRA
$LINE_SIDEQUEST_6_OUTRO_10_TEXT	我们忘记了吗，渺小的人类，在这里到底是谁掌握着火焰的秘密？
$LINE_SIDEQUEST_6_OUTRO_20_CHAR	$MAG
$LINE_SIDEQUEST_6_OUTRO_20_TEXT	你堕落！扭曲！亵渎神灵！
$LINE_SIDEQUEST_6_OUTRO_30_CHAR	$MCG
$LINE_SIDEQUEST_6_OUTRO_30_TEXT	*$MAG，她帮了我们。
$LINE_SIDEQUEST_6_OUTRO_40_CHAR	$MAG
$LINE_SIDEQUEST_6_OUTRO_40_TEXT	你的呼吸都玷污了这里。滚出去。
$LINE_SIDEQUEST_6_OUTRO_50_CHAR	$DRA
$LINE_SIDEQUEST_6_OUTRO_50_TEXT	神愿意去哪儿就去哪儿。
$LINE_SIDEQUEST_6_OUTRO_60_CHAR	$MAG
$LINE_SIDEQUEST_6_OUTRO_60_TEXT	滚出去！
$LINE_SIDEQUEST_6_OUTRO_70_CHAR	$MCG
$LINE_SIDEQUEST_6_OUTRO_70_TEXT	……
$LINE_SIDEQUEST_6_OUTRO_80_CHAR	$MCG
$LINE_SIDEQUEST_6_OUTRO_80_TEXT	你想谈谈吗？
$LINE_SIDEQUEST_6_OUTRO_90_CHAR	$MAG
$LINE_SIDEQUEST_6_OUTRO_90_TEXT	言语无法解决仍何事。
$LINE_SIDEQUEST_6_OUTRO_100_CHAR	$MCG
$LINE_SIDEQUEST_6_OUTRO_100_TEXT	我希望这不是真的，否则我就选错职业了。
$LINE_SIDEQUEST_6_OUTRO_110_CHAR	$MAG
$LINE_SIDEQUEST_6_OUTRO_110_TEXT	你有选择？真<LQ>稀奇<RQ>啊。
$LINE_SIDEQUEST_6_OUTRO_120_CHAR	$MAG
$LINE_SIDEQUEST_6_OUTRO_120_TEXT	……我们去的每一个小屋，在屋子里拿每一样东西时，我都觉得有其他幸存者在看着我。他们知道我是谁。
$LINE_SIDEQUEST_6_OUTRO_130_CHAR	$MAG
$LINE_SIDEQUEST_6_OUTRO_130_TEXT	他们以为我会带他们回到我们的城市，回到一个根本不再存在的世界！
$LINE_SIDEQUEST_6_OUTRO_140_CHAR	$MAG
$LINE_SIDEQUEST_6_OUTRO_140_TEXT	这里，这里就是我的归属地。神庙已经变成了停尸房。
$LINE_SIDEQUEST_6_OUTRO_150_CHAR	$MAG
$LINE_SIDEQUEST_6_OUTRO_150_TEXT	那些可怜的四散的幸存者指望我来拯救他们，但是除了这座神庙废墟，我无法再为他们提供任何的保护。
$LINE_SIDEQUEST_6_OUTRO_160_CHAR	$MAG
$LINE_SIDEQUEST_6_OUTRO_160_TEXT	看看我！从小就是一个俘虏，一个囚犯，一个……你不明白……他们对我们做的那些事。
$LINE_SIDEQUEST_6_OUTRO_170_CHAR	$MAG
$LINE_SIDEQUEST_6_OUTRO_170_TEXT	不……是你们对我们做的事！
$LINE_SIDEQUEST_6_OUTRO_180_CHAR	$MAG
$LINE_SIDEQUEST_6_OUTRO_180_TEXT	我的脑海里总是出现尖叫声，我知道，这些尖叫声就是他们的，我闭上眼睛，看见我的姐妹们站在血泊中……
$LINE_SIDEQUEST_6_OUTRO_190_CHAR	$MCG
$LINE_SIDEQUEST_6_OUTRO_190_TEXT	*$MAG……
$LINE_SIDEQUEST_6_OUTRO_200_CHAR	$MAG
$LINE_SIDEQUEST_6_OUTRO_200_TEXT	太阳……慢慢的落了下去，我拿起破碎的箭头，等着他转过身……
$LINE_SIDEQUEST_6_OUTRO_210_CHAR	$MAG
$LINE_SIDEQUEST_6_OUTRO_210_TEXT	而现在，我孤身一人。他们都不在了……我是皇室最后的血脉……
$LINE_SIDEQUEST_6_OUTRO_220_CHAR	$MAG
$LINE_SIDEQUEST_6_OUTRO_220_TEXT	我甚至无法控制我自己的思绪！我还怎么能领导一个国家呢？
$LINE_SIDEQUEST_6_OUTRO_230_CHAR	$MAG
$LINE_SIDEQUEST_6_OUTRO_230_TEXT	我能为我的子民做什么呢？
$LINE_SIDEQUEST_6_OUTRO_240_CHAR	$MCG
$LINE_SIDEQUEST_6_OUTRO_240_TEXT	*$MAG，我是个图书管理员。你是奎德的战士公主。
$LINE_SIDEQUEST_6_OUTRO_250_CHAR	$MCG
$LINE_SIDEQUEST_6_OUTRO_250_TEXT	你生来就是领导者。我生来就是……摆放书本，并且被书吏虎视眈眈的盯着。
$LINE_SIDEQUEST_6_OUTRO_260_CHAR	$MCG
$LINE_SIDEQUEST_6_OUTRO_260_TEXT	我很迷茫，也不知道该如何领导……我几乎无法控制大局了。有时候，我能做的只有记得呼吸。
$LINE_SIDEQUEST_6_OUTRO_270_CHAR	$MCG
$LINE_SIDEQUEST_6_OUTRO_270_TEXT	我自己都不会追随自己。
$LINE_SIDEQUEST_6_OUTRO_280_CHAR	$MCG
$LINE_SIDEQUEST_6_OUTRO_280_TEXT	我看着你，我总希望自己能有你十分之一的勇气和决心。
$LINE_SIDEQUEST_6_OUTRO_290_CHAR	$MCG
$LINE_SIDEQUEST_6_OUTRO_290_TEXT	但也许我没有也是件好事，否则我就在建立一个帝国，而不是忙着逃亡了。
$LINE_SIDEQUEST_6_OUTRO_300_CHAR	$MAG
$LINE_SIDEQUEST_6_OUTRO_300_TEXT	……
$LINE_SIDEQUEST_6_OUTRO_310_CHAR	$MAG
$LINE_SIDEQUEST_6_OUTRO_310_TEXT	*谢谢你，$MCG。
$LINE_SIDEQUEST_6_OUTRO_320_CHAR	$MAG
$LINE_SIDEQUEST_6_OUTRO_320_TEXT	……也许我之前对于言语的认知是错误的。
$LINE_SIDEQUEST_6_OUTRO_330_CHAR	$MCG
$LINE_SIDEQUEST_6_OUTRO_330_TEXT	……你想要拥抱一下吗？
$LINE_SIDEQUEST_6_OUTRO_340_CHAR	$MAG
$LINE_SIDEQUEST_6_OUTRO_340_TEXT	什么是<LQ>拥抱<RQ>？
$SCENE_3_10_INTRO_TITLE	皇家档案室
$LINE_3_10_INTRO_00_CHAR	$DRA
$LINE_3_10_INTRO_00_TEXT	我们到了，人类：皇家档案室。
$LINE_3_10_INTRO_10_CHAR	$MCG
$LINE_3_10_INTRO_10_TEXT	上面说了什么？
$LINE_3_10_INTRO_20_CHAR	$HEA
$LINE_3_10_INTRO_20_TEXT	现在流血似乎有意义了……这看起来像是某种仪式的封印……
$LINE_3_10_INTRO_30_CHAR	$HEA
$LINE_3_10_INTRO_30_TEXT	后代……血……长子……
$LINE_3_10_INTRO_40_CHAR	$HEA
$LINE_3_10_INTRO_40_TEXT	用先祖的血解除封印。
$LINE_3_10_INTRO_50_CHAR	$HEA
$LINE_3_10_INTRO_50_TEXT	只有创造封印的人的血才能解除这个<LQ>血印<RQ>——
$LINE_3_10_INTRO_60_CHAR	$MCG
$LINE_3_10_INTRO_60_TEXT	但是他们都早已去世了。
$LINE_3_10_INTRO_70_CHAR	$HEA
$LINE_3_10_INTRO_70_TEXT	是的，但是他们的血液依旧流淌在他们的后人体内。<LQ>长子之血<RQ>。
$LINE_3_10_INTRO_80_CHAR	$MCG
$LINE_3_10_INTRO_80_TEXT	但是，他们封印着什么呢？舍里米尔获得的力量？
$LINE_3_10_INTRO_90_CHAR	$HEA
$LINE_3_10_INTRO_90_TEXT	*我不确定，这种语言非常深奥……也许$MAG能更好的破解它……
$LINE_3_10_INTRO_100_CHAR	$MAG
$LINE_3_10_INTRO_100_TEXT	这比我之前见过的所有奎德人都要古老……
$LINE_3_10_INTRO_110_CHAR	$MAG
$LINE_3_10_INTRO_110_TEXT	<LQ>……自由人民的领导者……联合……充满巨大争端或冲突的领土……<RQ>
$LINE_3_10_INTRO_120_CHAR	$MAG
$LINE_3_10_INTRO_120_TEXT	<LQ>伟大的国王衰落<RQ>，——一定是指奎德国王。
$LINE_3_10_INTRO_130_CHAR	$MAG
$LINE_3_10_INTRO_130_TEXT	<LQ>……衰落……但是他的同盟……<RQ>
$LINE_3_10_INTRO_140_CHAR	$MAG
$LINE_3_10_INTRO_140_TEXT	<LQ>邪恶联结……被牺牲牵制……牺牲阿散蒂王，他的尊贵的韦齐尔，科纳特·科扎尔……<RQ>
$LINE_3_10_INTRO_150_CHAR	$MAG
$LINE_3_10_INTRO_150_TEXT	<LQ>还有一个，在呼唤中向前迈进……步兵……<RQ>
$LINE_3_10_INTRO_160_CHAR	$MAG
$LINE_3_10_INTRO_160_TEXT	<LQ>属于尼菲尔家族的，现在他们是皇室收集的……新主人？<RQ>
$LINE_3_10_INTRO_170_CHAR	$MAG
$LINE_3_10_INTRO_170_TEXT	<LQ>这三个人用鲜血封住了邪恶……<RQ>
$LINE_3_10_INTRO_180_CHAR	$MAG
$LINE_3_10_INTRO_180_TEXT	<LQ>艾斯里——特诺奇<RQ>
$LINE_3_10_INTRO_190_CHAR	$MCG
$LINE_3_10_INTRO_190_TEXT	艾斯里—特诺奇？
$LINE_3_10_INTRO_200_CHAR	$MAG
$LINE_3_10_INTRO_200_TEXT	我不明白……这不是奎德语的词。
$LINE_3_10_INTRO_210_CHAR	$MCG
$LINE_3_10_INTRO_210_TEXT	这不是我熟悉的语言。
$LINE_3_10_INTRO_220_CHAR	$RAN
$LINE_3_10_INTRO_220_TEXT	你刚刚是说<LQ>艾斯里—特诺奇<RQ>？
$LINE_3_10_INTRO_230_CHAR	$MAG
$LINE_3_10_INTRO_230_TEXT	你知道？
$LINE_3_10_INTRO_240_CHAR	$RAN
$LINE_3_10_INTRO_240_TEXT	是远东狂血部落信奉的某个神。
$LINE_3_10_INTRO_250_CHAR	$MAG
$LINE_3_10_INTRO_250_TEXT	血饮教？我爷爷统治时期曾花了很长的时间尝试驱散过他们。
$LINE_3_10_INTRO_260_CHAR	$RAN
$LINE_3_10_INTRO_260_TEXT	哦，他们不喝血，他们只是……用血当涂料。
$LINE_3_10_INTRO_270_CHAR	$BER
$LINE_3_10_INTRO_270_TEXT	好吧，这非常有趣，但亡者好像在这条路上造成了大混乱……
$LINE_3_10_INTRO_280_CHAR	$BER
$LINE_3_10_INTRO_280_TEXT	哦，你什么也不需要做。你只要在我一个人力挽狂澜时，好好的在旁边看着。
$LINE_3_10_INTRO_290_CHAR	$BER
$LINE_3_10_INTRO_290_TEXT	好吧，不是一个人……真理和正义会给我提供些帮助！
$LINE_3_10_INTRO_300_CHAR	$BER
$LINE_3_10_INTRO_300_TEXT	更不用说雷鸣，闪电，屠杀，混乱，胜利和行刑者。
$LINE_3_10_INTRO_310_CHAR	$RAN
$LINE_3_10_INTRO_310_TEXT	……
$LINE_3_10_INTRO_320_CHAR	$BER
$LINE_3_10_INTRO_320_TEXT	那是我的腹肌。
$LINE_3_10_INTRO_330_CHAR	$BER
$LINE_3_10_INTRO_330_TEXT	你说什么？我的臀部怎么了？
$LINE_3_10_INTRO_340_CHAR	$RAN
$LINE_3_10_INTRO_340_TEXT	我可没问。
$LINE_3_10_INTRO_350_CHAR	$BER
$LINE_3_10_INTRO_350_TEXT	别担心。可汗和卡丽斯不会袖手旁观的。
$LINE_3_10_INTRO_360_CHAR	$RAN
$LINE_3_10_INTRO_360_TEXT	卡丽斯？你把你的屁股取名叫卡丽斯？
$LINE_3_10_INTRO_370_CHAR	$BER
$LINE_3_10_INTRO_370_TEXT	只是一半屁股而已。
$LINE_3_10_INTRO_380_CHAR	$BER
$LINE_3_10_INTRO_380_TEXT	另外一半怎怎么样？是单独的一块肌肉吗？我是说，如果是，我可不会给它取名，但是……我不太清楚……它感觉……
$LINE_3_10_INTRO_390_CHAR	$RAN
$LINE_3_10_INTRO_390_TEXT	噢，孩子！亡者在这儿呢，谢天谢地！
$SCENE_3_10_OUTRO_TITLE	戏剧性暂停
$LINE_3_10_OUTRO_00_CHAR	$MCG
$LINE_3_10_OUTRO_00_TEXT	我想这是最后一个了。
$LINE_3_10_OUTRO_10_CHAR	$HEA
$LINE_3_10_OUTRO_10_TEXT	这个笔记……
$LINE_3_10_OUTRO_20_CHAR	$HEA
$LINE_3_10_OUTRO_20_TEXT	*$MCG，你家人在皇家图书馆工作了多久？
$LINE_3_10_OUTRO_30_CHAR	$MCG
$LINE_3_10_OUTRO_30_TEXT	……我记得我还是个小女孩的时候，我曾去那里看过我的曾祖父。
$LINE_3_10_OUTRO_40_CHAR	$MCG
$LINE_3_10_OUTRO_40_TEXT	据我所知，我的家族一直在那里工作。
$LINE_3_10_OUTRO_50_CHAR	$MCG
$LINE_3_10_OUTRO_50_TEXT	从字面上看，我姓氏意思就是“图书馆”
$LINE_3_10_OUTRO_60_CHAR	$HEA
$LINE_3_10_OUTRO_60_TEXT	这里说的步兵——
$LINE_3_10_OUTRO_70_CHAR	$BER
$LINE_3_10_OUTRO_70_TEXT	哟，看啊！
$LINE_3_10_OUTRO_80_CHAR	$HEA
$LINE_3_10_OUTRO_80_TEXT	墓坑的地图！……那是——？
$LINE_3_10_OUTRO_90_CHAR	$BER
$LINE_3_10_OUTRO_90_TEXT	嘿，别偷我的雷电定制图！
$LINE_3_10_OUTRO_100_CHAR	$BER
$LINE_3_10_OUTRO_100_TEXT	正如我所说，在我被无礼地打断之前。这是墓坑地图，包括……
$LINE_3_10_OUTRO_110_CHAR	$BER
$LINE_3_10_OUTRO_110_TEXT	……戏剧性暂停……
$LINE_3_10_OUTRO_120_CHAR	$BER
$LINE_3_10_OUTRO_120_TEXT	出口！
$SCENE_3_11_INTRO_TITLE	舍里米尔出现
$LINE_3_11_INTRO_00_CHAR	$HEA
$LINE_3_11_INTRO_00_TEXT	*$MCG，你没发现吗？你是——
$LINE_3_11_INTRO_10_CHAR	舍里米尔
$LINE_3_11_INTRO_10_TEXT	最后一块拼图。
$LINE_3_11_INTRO_20_CHAR	舍里米尔
$LINE_3_11_INTRO_20_TEXT	步兵的牺牲拯救了世界。皇室家族怀着感激之情，给他的后人们在宫殿里设立了荣誉席位。
$LINE_3_11_INTRO_30_CHAR	舍里米尔
$LINE_3_11_INTRO_30_TEXT	而他最后的一位后人就在这里。
$LINE_3_11_INTRO_40_CHAR	$MCG
$LINE_3_11_INTRO_40_TEXT	我是……封印的最后一部分。
$LINE_3_11_INTRO_50_CHAR	舍里米尔
$LINE_3_11_INTRO_50_TEXT	血印的其他两部分已经被破坏了。
$LINE_3_11_INTRO_60_CHAR	$MCG
$LINE_3_11_INTRO_60_TEXT	是的，正是你的杰作。
$LINE_3_11_INTRO_70_CHAR	舍里米尔
$LINE_3_11_INTRO_70_TEXT	现在，我打算要修整那个错误。
$LINE_3_11_INTRO_80_CHAR	舍里米尔
$LINE_3_11_INTRO_80_TEXT	而你，是他唯一的障碍。
$LINE_3_11_INTRO_90_CHAR	舍里米尔
$LINE_3_11_INTRO_90_TEXT	这是他双手被缚所能做到的事情。你根本无法想象如果他完全重获自由后会发生什么。
$LINE_3_11_INTRO_100_CHAR	舍里米尔
$LINE_3_11_INTRO_100_TEXT	他所要的，只是得到你的一小滴血。
$LINE_3_11_INTRO_110_CHAR	$MCG
$LINE_3_11_INTRO_110_TEXT	他？
$LINE_3_11_INTRO_120_CHAR	$MCG
$LINE_3_11_INTRO_120_TEXT	你是说艾斯里-特诺奇？
$LINE_3_11_INTRO_130_CHAR	舍里米尔
$LINE_3_11_INTRO_130_TEXT	你还是不明白，是吗？我们对付的可不是什么抽象的力量。
$LINE_3_11_INTRO_140_CHAR	舍里米尔
$LINE_3_11_INTRO_140_TEXT	他是个人类，一个智者，和你或我一样真实……而且，非常非常得危险。
$LINE_3_11_INTRO_150_CHAR	舍里米尔
$LINE_3_11_INTRO_150_TEXT	我们——我用部分自由与他交易一小部分力量。
$LINE_3_11_INTRO_160_CHAR	舍里米尔
$LINE_3_11_INTRO_160_TEXT	他并不满意他的牢房。他在寻找你。即使现在，他的仆从们仍在蛮荒之地搜寻着你的鲜血。
$LINE_3_11_INTRO_170_CHAR	舍里米尔
$LINE_3_11_INTRO_170_TEXT	只有一条路是安全的。
$LINE_3_11_INTRO_180_CHAR	舍里米尔
$LINE_3_11_INTRO_180_TEXT	你必须死。
$LINE_3_11_INTRO_190_CHAR	$MCG
$LINE_3_11_INTRO_190_TEXT	疯狂总是令人信服……
$LINE_3_11_INTRO_200_CHAR	$MCG
$LINE_3_11_INTRO_200_TEXT	你只是在追求让自己力量更强大的方法而已。
$LINE_3_11_INTRO_210_CHAR	$MCG
$LINE_3_11_INTRO_210_TEXT	你削弱封印，现在又指挥那些已死之人。
$LINE_3_11_INTRO_220_CHAR	$MCG
$LINE_3_11_INTRO_220_TEXT	现在你想要通过打破整个封印让自己获得更大的力量。
$LINE_3_11_INTRO_230_CHAR	舍里米尔
$LINE_3_11_INTRO_230_TEXT	你认为这是我所想的？有什么根据……不……
$LINE_3_11_INTRO_240_CHAR	舍里米尔
$LINE_3_11_INTRO_240_TEXT	相信你想要的。你必须死。
$LINE_3_11_INTRO_250_CHAR	舍里米尔
$LINE_3_11_INTRO_250_TEXT	……兄弟，我希望你能明白。
$LINE_3_11_INTRO_260_CHAR	$HEA
$LINE_3_11_INTRO_260_TEXT	不。
$LINE_3_11_INTRO_270_CHAR	$HEA
$LINE_3_11_INTRO_270_TEXT	我不会再让你杀害其他无辜之人。
$LINE_3_11_INTRO_280_CHAR	舍里米尔
$LINE_3_11_INTRO_280_TEXT	世界在燃烧，我不会让无知之人捆绑住我的双手！
$LINE_3_11_INTRO_290_CHAR	舍里米尔
$LINE_3_11_INTRO_290_TEXT	亡者大军！进攻！
$SCENE_3_11_OUTRO_TITLE	仅仅是开始
$LINE_3_11_OUTRO_00_CHAR	$MCG
$LINE_3_11_OUTRO_00_TEXT	好吧，这比我担心的要简单得多了。
$LINE_3_11_OUTRO_10_CHAR	$HEA
$LINE_3_11_OUTRO_10_TEXT	相信我，这仅仅是开始。
$LINE_3_11_OUTRO_20_CHAR	$HEA
$LINE_3_11_OUTRO_20_TEXT	我们不能冒风险开战。尤其是在舍里米尔领导军队的时候。
$LINE_3_11_OUTRO_30_CHAR	$HEA
$LINE_3_11_OUTRO_30_TEXT	我知道穿过下水道有条逃跑路线。
$LINE_3_11_OUTRO_40_CHAR	$HEA
$LINE_3_11_OUTRO_40_TEXT	在敌人找到机会重组前我们必须离开！
$LINE_3_11_OUTRO_50_CHAR	$MCG
$LINE_3_11_OUTRO_50_TEXT	是啊。下水道。
$LINE_3_11_OUTRO_60_CHAR	$MCG
$LINE_3_11_OUTRO_60_TEXT	你们这些家伙可能忘了，虽然我们已经有段时间没有跟文明接触，但是……
$LINE_3_11_OUTRO_70_CHAR	$MCG
$LINE_3_11_OUTRO_70_TEXT	看吧，事实就是，下水道里满是污物。
$LINE_3_11_OUTRO_80_CHAR	$MCG
$LINE_3_11_OUTRO_80_TEXT	所以，关键在于词语读音的相似性。
$LINE_3_11_OUTRO_90_CHAR	$MCG
$LINE_3_11_OUTRO_90_TEXT	疯了，我知道，但是你们可以信任我。我是图书管理员，成天和语言打交道。
$LINE_3_11_OUTRO_100_CHAR	$MCG
$LINE_3_11_OUTRO_100_TEXT	……通常情况下，我不和逝去的文明打交道。
$LINE_3_11_OUTRO_110_CHAR	$MCG
$LINE_3_11_OUTRO_110_TEXT	我只是想以那样的方式保存。
$LINE_3_11_OUTRO_120_CHAR	$MCG
$LINE_3_11_OUTRO_120_TEXT	总之，我只是说出来，给那些在听的人……
$LINE_3_11_OUTRO_130_CHAR	$MCG
$LINE_3_11_OUTRO_130_TEXT	好吧，没人在听。
$LINE_3_11_OUTRO_140_CHAR	$MCG
$LINE_3_11_OUTRO_140_TEXT	……
$LINE_3_11_OUTRO_150_CHAR	$MCG
$LINE_3_11_OUTRO_150_TEXT	*没关系，$MCG，我在听，而且我百分之百地同意。
$LINE_3_11_OUTRO_160_CHAR	$MCG
$LINE_3_11_OUTRO_160_TEXT	*谢谢，$MCG，真高兴还有人能在意我的观点。
$LINE_3_11_OUTRO_170_CHAR	$MCG
$LINE_3_11_OUTRO_170_TEXT	我们应该彼此照应。我们是这里唯一理智的人了。
$LINE_3_11_OUTRO_180_CHAR	$MCG
$LINE_3_11_OUTRO_180_TEXT	谢谢，有人能说说话可真好。
$LINE_3_11_OUTRO_190_CHAR	$KNI
$LINE_3_11_OUTRO_190_TEXT	……嗯……呃哼。
$LINE_3_11_OUTRO_200_CHAR	$MCG
$LINE_3_11_OUTRO_200_TEXT	*噢，嗨，$KNI！
$LINE_3_11_OUTRO_210_CHAR	$MCG
$LINE_3_11_OUTRO_210_TEXT	……呃……你在这里站了多久了？
$LINE_3_11_OUTRO_220_CHAR	$KNI
$LINE_3_11_OUTRO_220_TEXT	……很久了，足以听到整个……对话。
$LINE_3_11_OUTRO_230_CHAR	$MCG
$LINE_3_11_OUTRO_230_TEXT	哦，我只是……嗯……我……
$LINE_3_11_OUTRO_240_CHAR	$MCG
$LINE_3_11_OUTRO_240_TEXT	我打算余生都躲在衣柜里过了，再见！
$LINE_3_11_OUTRO_250_CHAR	$KNI
$LINE_3_11_OUTRO_250_TEXT	总是跟疯子在一起。为什么？为什么是我？
$LINE_3_11_OUTRO_260_CHAR	$KNI
$LINE_3_11_OUTRO_260_TEXT	下次我一定会说“谢谢你救了我的命！在我发誓永远地忠诚之前——你不会恰好是那种把裤子穿在头上的疯子吧，是吗？”
$LINE_3_11_OUTRO_270_CHAR	$BER
$LINE_3_11_OUTRO_270_TEXT	嘿！别再自言自语了，怪人！
$SCENE_3_12_INTRO_TITLE	进入逃跑地道
$LINE_3_12_INTRO_00_CHAR	$RAN
$LINE_3_12_INTRO_00_TEXT	逃跑路线在下水道里？
$LINE_3_12_INTRO_10_CHAR	$RAN
$LINE_3_12_INTRO_10_TEXT	到底是谁设计的这座城市？！
$LINE_3_12_INTRO_20_CHAR	$HEA
$LINE_3_12_INTRO_20_TEXT	路线通向矿井。从那里我们可以——
$LINE_3_12_INTRO_30_CHAR	舍里米尔
$LINE_3_12_INTRO_30_TEXT	你真的认为我找不到你？
$LINE_3_12_INTRO_40_CHAR	舍里米尔
$LINE_3_12_INTRO_40_TEXT	你不是唯一一个知道这座城市秘密的人。
$LINE_3_12_INTRO_50_CHAR	舍里米尔
$LINE_3_12_INTRO_50_TEXT	而且你应该知道，我会不惜一切地保护我的子民。
$LINE_3_12_INTRO_60_CHAR	$HEA
$LINE_3_12_INTRO_60_TEXT	就像我们解除我们那部分血印的时候一样吗，王子殿下？
$LINE_3_12_INTRO_70_CHAR	舍里米尔
$LINE_3_12_INTRO_70_TEXT	我们濒临灭绝。奎德帝国为达目的，会不择手段的。
$LINE_3_12_INTRO_80_CHAR	舍里米尔
$LINE_3_12_INTRO_80_TEXT	你已经忘记了东部省份的荒废了吗？
$LINE_3_12_INTRO_90_CHAR	舍里米尔
$LINE_3_12_INTRO_90_TEXT	我跪在子民的血泊之中——我们的子民——我发誓我会不惜一切，拯救艾殊王国！
$LINE_3_12_INTRO_100_CHAR	舍里米尔
$LINE_3_12_INTRO_100_TEXT	我仍然以此誓言为荣。
$LINE_3_12_INTRO_110_CHAR	$HEA
$LINE_3_12_INTRO_110_TEXT	然后呢？你杀了个女孩。
$LINE_3_12_INTRO_120_CHAR	$HEA
$LINE_3_12_INTRO_120_TEXT	如果这次瘟疫真的是黑暗智者一手造成的，那么当你毁了它唯一的逃跑之路，它会怎么做？
$LINE_3_12_INTRO_130_CHAR	$HEA
$LINE_3_12_INTRO_130_TEXT	当他绝望时会发生什么？
$LINE_3_12_INTRO_140_CHAR	舍里米尔
$LINE_3_12_INTRO_140_TEXT	计划正在进行，一切都会在适当的时候解决。
$LINE_3_12_INTRO_150_CHAR	舍里米尔
$LINE_3_12_INTRO_150_TEXT	但是首先，她必须被除掉。
$SCENE_3_12_OUTRO_TITLE	百万亡者的哭声
$LINE_3_12_OUTRO_00_CHAR	$HEA
$LINE_3_12_OUTRO_00_TEXT	它们又被打回来了。我们必须走！
$LINE_3_12_OUTRO_10_CHAR	$MAG
$LINE_3_12_OUTRO_10_TEXT	舍里米尔。
$LINE_3_12_OUTRO_20_CHAR	$HEA
$LINE_3_12_OUTRO_20_TEXT	他做了自认为必要的选择。
$LINE_3_12_OUTRO_30_CHAR	$MAG
$LINE_3_12_OUTRO_30_TEXT	他会为此而死。
$LINE_3_12_OUTRO_40_CHAR	$HEA
$LINE_3_12_OUTRO_40_TEXT	*$MAG，复仇从来不是这样的。
$LINE_3_12_OUTRO_50_CHAR	$MAG
$LINE_3_12_OUTRO_50_TEXT	不是复仇。是正义。是荣誉。
$LINE_3_12_OUTRO_60_CHAR	$MAG
$LINE_3_12_OUTRO_60_TEXT	我不能放任不管这样的一个帝国的罪犯。
$LINE_3_12_OUTRO_70_CHAR	$MAG
$LINE_3_12_OUTRO_70_TEXT	不取舍里米尔的鲜血，我无颜再面对宇宙之焰。
$LINE_3_12_OUTRO_80_CHAR	$MAG
$LINE_3_12_OUTRO_80_TEXT	数百万的生命都在迫切渴求他的鲜血。
$LINE_3_12_OUTRO_90_CHAR	$HEA
$LINE_3_12_OUTRO_90_TEXT	那就为了将来去拯救正义。
$LINE_3_12_OUTRO_100_CHAR	$HEA
$LINE_3_12_OUTRO_100_TEXT	而现在，趁我们还有时间，我们必须逃离这里！
$LINE_3_12_OUTRO_110_CHAR	$KNI
$LINE_3_12_OUTRO_110_TEXT	女士？
$LINE_3_12_OUTRO_120_CHAR	$MCG
$LINE_3_12_OUTRO_120_TEXT	什么？
$LINE_3_12_OUTRO_130_CHAR	$KNI
$LINE_3_12_OUTRO_130_TEXT	我们要被敌人包围了……
$LINE_3_12_OUTRO_140_CHAR	$KNI
$LINE_3_12_OUTRO_140_TEXT	我不知道这对你是否有用……但是应该有所帮助。
$LINE_3_12_OUTRO_150_CHAR	$KNI
$LINE_3_12_OUTRO_150_TEXT	我认识的最聪明的军人曾经告诉我：
$LINE_3_12_OUTRO_160_CHAR	$KNI
$LINE_3_12_OUTRO_160_TEXT	<LQ>不要使用手臂的力量去攻击，而要使用精神的力量，然后，身心合一，击退敌人。<RQ>
$LINE_3_12_OUTRO_170_CHAR	$KNI
$LINE_3_12_OUTRO_170_TEXT	我很多年后才理解。
$LINE_3_12_OUTRO_180_CHAR	$KNI
$LINE_3_12_OUTRO_180_TEXT	我以为他——
$LINE_3_12_OUTRO_190_CHAR	$MCG
$LINE_3_12_OUTRO_190_TEXT	等等……<LQ>精神的力量<RQ>……<LQ>击退敌人<RQ>……
$LINE_3_12_OUTRO_200_CHAR	$MCG
$LINE_3_12_OUTRO_200_TEXT	我明白了！
$LINE_3_12_OUTRO_210_CHAR	$KNI
$LINE_3_12_OUTRO_210_TEXT	哇哦。那可花了我三年时间。
$LINE_3_12_OUTRO_220_CHAR	$KNI
$LINE_3_12_OUTRO_220_TEXT	我不想撒谎……我现在有点讨厌你了。
$SCENE_3_13_INTRO_TITLE	绝望逃亡
$LINE_3_13_INTRO_00_CHAR	$RAN
$LINE_3_13_INTRO_00_TEXT	所以我直说了：逃跑的地道——就是当你遇到危险想逃进去的那地方——全是爆炸物？
$LINE_3_13_INTRO_10_CHAR	$RAN
$LINE_3_13_INTRO_10_TEXT	到底是谁设计的这座城市？！！
$LINE_3_13_INTRO_20_CHAR	$RAN
$LINE_3_13_INTRO_20_TEXT	我是认真的，我要他的地址。我要去找到他，然后狠狠揍他一顿。
$LINE_3_13_INTRO_30_CHAR	$BER
$LINE_3_13_INTRO_30_TEXT	我不知道，我认为这是座了不起的城市。
$LINE_3_13_INTRO_40_CHAR	$RAN
$LINE_3_13_INTRO_40_TEXT	听着，有一个率领僵尸的灭族疯子跟在我们屁股后面，并且拼命想要致我们于死地。
$LINE_3_13_INTRO_50_CHAR	$RAN
$LINE_3_13_INTRO_50_TEXT	而我们被爆炸物包围了！！
$LINE_3_13_INTRO_60_CHAR	$HEA
$LINE_3_13_INTRO_60_TEXT	这也许是我们唯一的出路。
$LINE_3_13_INTRO_70_CHAR	$RAN
$LINE_3_13_INTRO_70_TEXT	我希望你说的是别的方法。
$LINE_3_13_INTRO_80_CHAR	$HEA
$LINE_3_13_INTRO_80_TEXT	如果你们能给争取我充足时间，我应该能触发一次贯穿整个矿井的爆炸。
$LINE_3_13_INTRO_90_CHAR	$HEA
$LINE_3_13_INTRO_90_TEXT	在舍里米尔跟着我们出去之前，地道就会砸在他头上。
$SCENE_3_13_OUTRO_TITLE	更为强大的敌人
$NARR_3_13_OUTRO_00_TEXT	第六幕
$NARR_3_13_OUTRO_00_SUB_TEXT	*在一个男人心中，光荣和骄傲也有着细微的差别。一个是良好服务后的巨大愉悦，另外一个是夺取荣誉的火焰，致人死亡。
$NARR_3_13_OUTRO_00_SUB_SUB_TEXT	*$N$N$N$N$N——摘自隐士阿拉克兰的作品集
$LINE_3_13_OUTRO_00_CHAR	$MAG
$LINE_3_13_OUTRO_00_TEXT	他死了。
$LINE_3_13_OUTRO_10_CHAR	$HEA
$LINE_3_13_OUTRO_10_TEXT	是的。
$LINE_3_13_OUTRO_20_CHAR	$HEA
$LINE_3_13_OUTRO_20_TEXT	或者我希望如此。……来自老友为数不多的希望。
$LINE_3_13_OUTRO_30_CHAR	$HEA
$LINE_3_13_OUTRO_30_TEXT	愿他找到此生无处寻求的平静。
$LINE_3_13_OUTRO_40_CHAR	$MAG
$LINE_3_13_OUTRO_40_TEXT	你为那只杀人狗哀悼？和魔鬼有协议的那个？
$LINE_3_13_OUTRO_50_CHAR	$HEA
$LINE_3_13_OUTRO_50_TEXT	他对我而言就像个兄弟，曾经如此，很久以前。
$LINE_3_13_OUTRO_60_CHAR	$MAG
$LINE_3_13_OUTRO_60_TEXT	他现在是个敌人了。
$LINE_3_13_OUTRO_70_CHAR	$MAG
$LINE_3_13_OUTRO_70_TEXT	他是罪有应得。
$LINE_3_13_OUTRO_80_CHAR	$MAG
$LINE_3_13_OUTRO_80_TEXT	我们的对手被摧毁了。
$LINE_3_13_OUTRO_90_CHAR	$MAG
$LINE_3_13_OUTRO_90_TEXT	愿他的尸体在邪恶的土地上发霉。
$LINE_3_13_OUTRO_100_CHAR	$HEA
$LINE_3_13_OUTRO_100_TEXT	我们不应该沦落到祈祷虚假的安全感。
$LINE_3_13_OUTRO_110_CHAR	$HEA
$LINE_3_13_OUTRO_110_TEXT	墓坑里仍有很多危险。没有必要的话，我们不应该一直等下去。
$LINE_3_13_OUTRO_120_CHAR	$MAG
$LINE_3_13_OUTRO_120_TEXT	有必要暂停我们的胜利喜悦了，但是我们的光荣将是永久。
$LINE_3_13_OUTRO_130_CHAR	$MCG
$LINE_3_13_OUTRO_130_TEXT	你认为他说的是事实么？如果这样……
$LINE_3_13_OUTRO_140_CHAR	$HEA
$LINE_3_13_OUTRO_140_TEXT	*$MCG，我们不知道。舍里米尔……在结束前就失去了思想。
$LINE_3_13_OUTRO_150_CHAR	$MCG
$LINE_3_13_OUTRO_150_TEXT	但如果是真的……那么我的血就真的可以释放他。
$LINE_3_13_OUTRO_160_CHAR	$HEA
$LINE_3_13_OUTRO_160_TEXT	你要怎么做，杀了自己？
$LINE_3_13_OUTRO_170_CHAR	$MCG
$LINE_3_13_OUTRO_170_TEXT	如果这意味着世界上的其他人将得到安全……不这么做的话就太自私了。
$LINE_3_13_OUTRO_180_CHAR	$HEA
$LINE_3_13_OUTRO_180_TEXT	如果血印是真的，那么我们唯一想做的，就是把你的血溅到墓坑里。
$LINE_3_13_OUTRO_190_CHAR	$HEA
$LINE_3_13_OUTRO_190_TEXT	舍里米尔说仆从们正在找你。
$LINE_3_13_OUTRO_200_CHAR	$HEA
$LINE_3_13_OUTRO_200_TEXT	我认为死亡无法阻止他们搜寻你的血液。
$LINE_3_13_OUTRO_210_CHAR	$MCG
$LINE_3_13_OUTRO_210_TEXT	很好……但是这同样很自私。
$LINE_3_13_OUTRO_220_CHAR	$HEA
$LINE_3_13_OUTRO_220_TEXT	当你为别人活着时，生命就不再自私。
$LINE_3_13_OUTRO_230_CHAR	$HEA
$LINE_3_13_OUTRO_230_TEXT	没有你，你的朋友仍会被困在这里，或者死去。
$LINE_3_13_OUTRO_240_CHAR	$HEA
$LINE_3_13_OUTRO_240_TEXT	他们需要你。我需要你。
$LINE_3_13_OUTRO_250_CHAR	$MCG
$LINE_3_13_OUTRO_250_TEXT	谢谢你，老者。
$LINE_3_13_OUTRO_260_CHAR	$MCG
$LINE_3_13_OUTRO_260_TEXT	……你认为他们说的仆从是什么意思？
$LINE_3_13_OUTRO_270_CHAR	$HEA
$LINE_3_13_OUTRO_270_TEXT	我不知道……
$LINE_3_13_OUTRO_280_CHAR	$HEA
$LINE_3_13_OUTRO_280_TEXT	……但是我想我们得尽快查明真相。
$SCENE_GHOST_TOWN_INTRO_TITLE	鬼镇
$LINE_GHOST_TOWN_INTRO_00_CHAR	村民
$LINE_GHOST_TOWN_INTRO_00_TEXT	欢迎来到我们的……村子。
$LINE_GHOST_TOWN_INTRO_10_CHAR	$MCG
$LINE_GHOST_TOWN_INTRO_10_TEXT	大家都去哪儿了？
$LINE_GHOST_TOWN_INTRO_20_CHAR	村民
$LINE_GHOST_TOWN_INTRO_20_TEXT	……死了，或者……被转化了……
$LINE_GHOST_TOWN_INTRO_30_CHAR	村民
$LINE_GHOST_TOWN_INTRO_30_TEXT	现在，我们还在开采水晶……和往常一样……
$LINE_GHOST_TOWN_INTRO_40_CHAR	$MCG
$LINE_GHOST_TOWN_INTRO_40_TEXT	那种爆炸水晶？
$LINE_GHOST_TOWN_INTRO_50_CHAR	村民
$LINE_GHOST_TOWN_INTRO_50_TEXT	……帝国的……荣耀就靠……我们了。
$LINE_GHOST_TOWN_INTRO_60_CHAR	村民
$LINE_GHOST_TOWN_INTRO_60_TEXT	……面对……狂血教……我们仍然……在服役。
$SCENE_4_1_INTRO_TITLE	热烈欢迎
$LINE_4_1_INTRO_00_CHAR	朝圣者
$LINE_4_1_INTRO_00_TEXT	欢迎你们，陌生人，欢迎！
$LINE_4_1_INTRO_10_CHAR	朝圣者
$LINE_4_1_INTRO_10_TEXT	在沙漠里遇到其他朝圣者总是件好事情。
$LINE_4_1_INTRO_20_CHAR	$MCG
$LINE_4_1_INTRO_20_TEXT	朋友，你要去哪里？
$LINE_4_1_INTRO_30_CHAR	朝圣者
$LINE_4_1_INTRO_30_TEXT	啊，你是问哪里在召唤我吗？
$LINE_4_1_INTRO_40_CHAR	朝圣者
$LINE_4_1_INTRO_40_TEXT	去供奉的……巨石那里。
$LINE_4_1_INTRO_50_CHAR	$RAN
$LINE_4_1_INTRO_50_TEXT	*$MCG，我们必须离开这里。现在。
$LINE_4_1_INTRO_60_CHAR	朝圣者
$LINE_4_1_INTRO_60_TEXT	*你说的是$MCG？
$LINE_4_1_INTRO_70_CHAR	朝圣者
$LINE_4_1_INTRO_70_TEXT	我们之前怎么没有见过呢？
$LINE_4_1_INTRO_80_CHAR	狂血教徒
$LINE_4_1_INTRO_80_TEXT	她的血……她的血！
$LINE_4_1_INTRO_90_CHAR	狂血教徒
$LINE_4_1_INTRO_90_TEXT	主人的热诚情填满我的内心！
$LINE_4_1_INTRO_100_CHAR	狂血教徒
$LINE_4_1_INTRO_100_TEXT	我会谨遵您的意愿！<N>为了巨石！
$LINE_4_1_INTRO_101_CHAR	狂血教徒
$LINE_4_1_INTRO_101_TEXT	让我成为您的部下之一！
$SCENE_4_1_OUTRO_TITLE	强大自身
$LINE_4_1_OUTRO_00_CHAR	$MCG
$LINE_4_1_OUTRO_00_TEXT	那到底是什么？
$LINE_4_1_OUTRO_10_CHAR	$MCG
$LINE_4_1_OUTRO_10_TEXT	他们刚刚把自己转化成亡者了吗？
$LINE_4_1_OUTRO_20_CHAR	$MCG
$LINE_4_1_OUTRO_20_TEXT	而且和之前不同……感觉不一样……有一种力量在驱动他们。
$LINE_4_1_OUTRO_30_CHAR	$RAN
$LINE_4_1_OUTRO_30_TEXT	我之前见过这些面具……
$LINE_4_1_OUTRO_40_CHAR	$RAN
$LINE_4_1_OUTRO_40_TEXT	涂着血迹，镶嵌着水晶颗粒……
$LINE_4_1_OUTRO_50_CHAR	$RAN
$LINE_4_1_OUTRO_50_TEXT	他们是狂血邪教徒，来自远东的咒逐部落。
$LINE_4_1_OUTRO_60_CHAR	$RAN
$LINE_4_1_OUTRO_60_TEXT	*幸亏我们和你在一起， $MCG。
$LINE_4_1_OUTRO_70_CHAR	$RAN
$LINE_4_1_OUTRO_70_TEXT	没有你，我们就要被献祭给他们的神了。
$LINE_4_1_OUTRO_80_CHAR	$MCG
$LINE_4_1_OUTRO_80_TEXT	……变成艾斯里-特诺奇的仆从。
$LINE_4_1_OUTRO_90_CHAR	$MCG
$LINE_4_1_OUTRO_90_TEXT	舍里米尔说的是真的。
$LINE_4_1_OUTRO_100_CHAR	$RAN
$LINE_4_1_OUTRO_100_TEXT	他们遍布东部的沙漠……抢劫过路游客……
$LINE_4_1_OUTRO_110_CHAR	$RAN
$LINE_4_1_OUTRO_110_TEXT	……只是我从来没有想过会在墓坑里遇到他们。
$LINE_4_1_OUTRO_120_CHAR	$HEA
$LINE_4_1_OUTRO_120_TEXT	他们在追捕我们。
$LINE_4_1_OUTRO_130_CHAR	$HEA
$LINE_4_1_OUTRO_130_TEXT	我们唯一的选择就是寻找出口。
$LINE_4_1_OUTRO_140_CHAR	$MCG
$LINE_4_1_OUTRO_140_TEXT	然后呢？
$LINE_4_1_OUTRO_150_CHAR	$HEA
$LINE_4_1_OUTRO_150_TEXT	我们随后再议。
$LINE_4_1_OUTRO_160_CHAR	$HEA
$LINE_4_1_OUTRO_160_TEXT	现在最重要的事情就是摆脱他们。
$LINE_4_1_OUTRO_170_CHAR	$MCG
$LINE_4_1_OUTRO_170_TEXT	他们到……
$LINE_4_1_OUTRO_180_CHAR	$HEA
$LINE_4_1_OUTRO_180_TEXT	如果这都是真的，那我们就面临着比舍里米尔更强大的敌人了。
$LINE_4_1_OUTRO_190_CHAR	$HEA
$LINE_4_1_OUTRO_190_TEXT	强大自身。对手只会越来越强大的。
$SCENE_4_2_INTRO_TITLE	术士领地
$LINE_4_2_INTRO_00_CHAR	$MCG
$LINE_4_2_INTRO_00_TEXT	这是哪里？另一个奎德城市？
$LINE_4_2_INTRO_10_CHAR	$MAG
$LINE_4_2_INTRO_10_TEXT	不，这和我们的建筑完全不同。
$LINE_4_2_INTRO_20_CHAR	$MAG
$LINE_4_2_INTRO_20_TEXT	语言也听不懂。
$LINE_4_2_INTRO_30_CHAR	$MCG
$LINE_4_2_INTRO_30_TEXT	从未有过的一种……古朴的感觉。
$LINE_4_2_INTRO_40_CHAR	$MCG
$LINE_4_2_INTRO_40_TEXT	为什么之前没有人注意到呢？这个地方是对外开放的啊。
$LINE_4_2_INTRO_50_CHAR	$MAG
$LINE_4_2_INTRO_50_TEXT	很多年之前，我来过这里，这里是一片沙漠。没有看到这些遗迹。
$LINE_4_2_INTRO_60_CHAR	$MAG
$LINE_4_2_INTRO_60_TEXT	这些一定被深埋在沙子之下。
$LINE_4_2_INTRO_70_CHAR	$MCG
$LINE_4_2_INTRO_70_TEXT	看这些符号。
$LINE_4_2_INTRO_80_CHAR	$MCG
$LINE_4_2_INTRO_80_TEXT	……你觉得会不会是亡者们把这些挖出来的？
$LINE_4_2_INTRO_90_CHAR	$MAG
$LINE_4_2_INTRO_90_TEXT	小心点！貌似这个陵墓里还有人。
$SCENE_4_2_OUTRO_TITLE	深入虎穴
$LINE_4_2_OUTRO_00_CHAR	$MCG
$LINE_4_2_OUTRO_00_TEXT	你认识这墙上的铭文吗？
$LINE_4_2_OUTRO_10_CHAR	$MCG
$LINE_4_2_OUTRO_10_TEXT	也许能让我们知道自己在哪里。
$LINE_4_2_OUTRO_20_CHAR	$HEA
$LINE_4_2_OUTRO_20_TEXT	这里的语言和北方语言很相似，不过是古老得多。
$LINE_4_2_OUTRO_30_CHAR	$HEA
$LINE_4_2_OUTRO_30_TEXT	我可以看懂一些词……
$LINE_4_2_OUTRO_40_CHAR	$MCG
$LINE_4_2_OUTRO_40_TEXT	说了什么？
$LINE_4_2_OUTRO_50_CHAR	$HEA
$LINE_4_2_OUTRO_50_TEXT	<LQ>这里设有……力量之座……<RQ>
$LINE_4_2_OUTRO_60_CHAR	$HEA
$LINE_4_2_OUTRO_60_TEXT	然后有个我不理解的词语……接下来是……
$LINE_4_2_OUTRO_70_CHAR	$HEA
$LINE_4_2_OUTRO_70_TEXT	<LQ>……来自天堂……<RQ>
$LINE_4_2_OUTRO_80_CHAR	$HEA
$LINE_4_2_OUTRO_80_TEXT	<LQ>艾斯里-特诺奇<RQ>
$LINE_4_2_OUTRO_90_CHAR	$MCG
$LINE_4_2_OUTRO_90_TEXT	我们在他家里。
$LINE_4_2_OUTRO_100_CHAR	$HEA
$LINE_4_2_OUTRO_100_TEXT	小心脚下。
$LINE_4_2_OUTRO_110_CHAR	$HEA
$LINE_4_2_OUTRO_110_TEXT	还有一些他的老仆从在这里。
$SCENE_4_3_INTRO_TITLE	神王之厅
$LINE_4_3_INTRO_00_CHAR	$BER
$LINE_4_3_INTRO_00_TEXT	这里发生了什么？
$LINE_4_3_INTRO_10_CHAR	$MCG
$LINE_4_3_INTRO_10_TEXT	这里似乎曾经是正殿。
$LINE_4_3_INTRO_20_CHAR	$BER
$LINE_4_3_INTRO_20_TEXT	有人把这里完全捣毁了。
$LINE_4_3_INTRO_30_CHAR	$MCG
$LINE_4_3_INTRO_30_TEXT	然后在墙上雕下了他们的名字……
$LINE_4_3_INTRO_40_CHAR	$BER
$LINE_4_3_INTRO_40_TEXT	王权主义！
$LINE_4_3_INTRO_50_CHAR	$MCG
$LINE_4_3_INTRO_50_TEXT	是用古代艾殊语写的。
$LINE_4_3_INTRO_60_CHAR	$MCG
$LINE_4_3_INTRO_60_TEXT	<LQ>……这里众人……朝圣……<RQ>
$LINE_4_3_INTRO_70_CHAR	$MCG
$LINE_4_3_INTRO_70_TEXT	<LQ>恶魔被打倒，然后被牺牲品封印……<RQ>
$LINE_4_3_INTRO_80_CHAR	$MCG
$LINE_4_3_INTRO_80_TEXT	<LQ>……他的城市被摧毁了<RQ>
$LINE_4_3_INTRO_90_CHAR	$RAN
$LINE_4_3_INTRO_90_TEXT	*$MCG，我们正在被追杀。
$LINE_4_3_INTRO_100_CHAR	$RAN
$LINE_4_3_INTRO_100_TEXT	有多少人还不清楚……
$LINE_4_3_INTRO_110_CHAR	$RAN
$LINE_4_3_INTRO_110_TEXT	但是有好多……非常多。
$LINE_4_3_INTRO_120_CHAR	$MCG
$LINE_4_3_INTRO_120_TEXT	大家做好准备。我们就在这里迎战。
$LINE_4_3_INTRO_130_CHAR	狂血邪教徒
$LINE_4_3_INTRO_130_TEXT	你们听不到召唤吗？
$LINE_4_3_INTRO_140_CHAR	狂血邪教徒
$LINE_4_3_INTRO_140_TEXT	在这么多年的沉寂之后。
$LINE_4_3_INTRO_150_CHAR	狂血邪教徒
$LINE_4_3_INTRO_150_TEXT	他召唤我们去巨石那里。
$LINE_4_3_INTRO_160_CHAR	狂血邪教徒
$LINE_4_3_INTRO_160_TEXT	你们必须解放他。
$LINE_4_3_INTRO_170_CHAR	狂血邪教徒
$LINE_4_3_INTRO_170_TEXT	我们会帮助你们感知到自己的召唤。
$SCENE_4_3_OUTRO_TITLE	说话的声音
$LINE_4_3_OUTRO_00_CHAR	$MCG
$LINE_4_3_OUTRO_00_TEXT	还有吗？
$LINE_4_3_OUTRO_10_CHAR	$RAN
$LINE_4_3_OUTRO_10_TEXT	我想我们已经清理干净了……至少现在是的。
$LINE_4_3_OUTRO_20_CHAR	$RAN
$LINE_4_3_OUTRO_20_TEXT	我去周围查看下，确保万无一失。
$LINE_4_3_OUTRO_30_CHAR	神秘的声音
$LINE_4_3_OUTRO_30_TEXT	这么多年了……
$LINE_4_3_OUTRO_40_CHAR	$MCG
$LINE_4_3_OUTRO_40_TEXT	那个声音！
$LINE_4_3_OUTRO_50_CHAR	艾斯里-特诺奇
$LINE_4_3_OUTRO_50_TEXT	被囚禁了这么多年，无人陪伴，只有思想伴随着自己。
$LINE_4_3_OUTRO_60_CHAR	$MCG
$LINE_4_3_OUTRO_60_TEXT	那个……金人……
$LINE_4_3_OUTRO_61_CHAR	艾斯里-特诺奇
$LINE_4_3_OUTRO_61_TEXT	被我的女王抛弃
$LINE_4_3_OUTRO_70_CHAR	艾斯里-特诺奇
$LINE_4_3_OUTRO_70_TEXT	被抛弃……但是现在……你的血脉帮助了我，你的双手也帮助了我。这是一种二元性……
$LINE_4_3_OUTRO_80_CHAR	艾斯里-特诺奇
$LINE_4_3_OUTRO_80_TEXT	但是我怎么能选择死亡呢？怎么能……
$LINE_4_3_OUTRO_90_CHAR	艾斯里-特诺奇
$LINE_4_3_OUTRO_90_TEXT	我不能放弃我的神威！
$LINE_4_3_OUTRO_91_CHAR	艾斯里-特诺奇
$LINE_4_3_OUTRO_91_TEXT	你会死的！
$LINE_4_3_OUTRO_100_CHAR	$MCG
$LINE_4_3_OUTRO_100_TEXT	离我远点！
$LINE_4_3_OUTRO_110_CHAR	$MCG
$LINE_4_3_OUTRO_110_TEXT	从我的脑袋里出来！
$LINE_4_3_OUTRO_120_CHAR	$MCG
$LINE_4_3_OUTRO_120_TEXT	……
$LINE_4_3_OUTRO_130_CHAR	$BER
$LINE_4_3_OUTRO_130_TEXT	*嘿，你还好么， $MCG？
$LINE_4_3_OUTRO_140_CHAR	$MCG
$LINE_4_3_OUTRO_140_TEXT	我刚刚又看见他了……艾斯里-特诺奇。
$LINE_4_3_OUTRO_150_CHAR	$MCG
$LINE_4_3_OUTRO_150_TEXT	不大战一场他是不会放我们走的……
$LINE_4_3_OUTRO_160_CHAR	$MCG
$LINE_4_3_OUTRO_160_TEXT	那我们就满足他。
$LINE_4_3_OUTRO_170_CHAR	$BER
$LINE_4_3_OUTRO_170_TEXT	……！
$SCENE_TREASURE_CHAMBER_INTRO_TITLE	真爱
$LINE_TREASURE_CHAMBER_INTRO_00_CHAR	$DRA
$LINE_TREASURE_CHAMBER_INTRO_00_TEXT	凡人……附近有什么东西……
$LINE_TREASURE_CHAMBER_INTRO_10_CHAR	$DRA
$LINE_TREASURE_CHAMBER_INTRO_10_TEXT	我可以闻到。
$LINE_TREASURE_CHAMBER_INTRO_20_CHAR	$MCG
$LINE_TREASURE_CHAMBER_INTRO_20_TEXT	亡者？做好作战准备！
$LINE_TREASURE_CHAMBER_INTRO_30_CHAR	$DRA
$LINE_TREASURE_CHAMBER_INTRO_30_TEXT	不……是……其他东西……
$LINE_TREASURE_CHAMBER_INTRO_40_CHAR	$MCG
$LINE_TREASURE_CHAMBER_INTRO_40_TEXT	什么？
$LINE_TREASURE_CHAMBER_INTRO_50_CHAR	$DRA
$LINE_TREASURE_CHAMBER_INTRO_50_TEXT	宝藏！
$LINE_TREASURE_CHAMBER_INTRO_60_CHAR	$BER
$LINE_TREASURE_CHAMBER_INTRO_60_TEXT	哇哦！看看这些！
$LINE_TREASURE_CHAMBER_INTRO_70_CHAR	$DRA
$LINE_TREASURE_CHAMBER_INTRO_70_TEXT	小心点，凡人。
$LINE_TREASURE_CHAMBER_INTRO_80_CHAR	$BER
$LINE_TREASURE_CHAMBER_INTRO_80_TEXT	什么？
$LINE_TREASURE_CHAMBER_INTRO_90_CHAR	$DRA
$LINE_TREASURE_CHAMBER_INTRO_90_TEXT	作为发现者，这些理应属于我。
$LINE_TREASURE_CHAMBER_INTRO_100_CHAR	$BER
$LINE_TREASURE_CHAMBER_INTRO_100_TEXT	但是你都不要用武器！
$LINE_TREASURE_CHAMBER_INTRO_110_CHAR	$BER
$LINE_TREASURE_CHAMBER_INTRO_110_TEXT	我们已经绑定了！我叫她：
$LINE_TREASURE_CHAMBER_INTRO_120_CHAR	$BER
$LINE_TREASURE_CHAMBER_INTRO_120_TEXT	超级碎骨机，非凡剜眼者，敌人胃囔切割机，对手去势器……
$LINE_TREASURE_CHAMBER_INTRO_130_CHAR	$BER
$LINE_TREASURE_CHAMBER_INTRO_130_TEXT	她尝过成千上万个人的血！
$LINE_TREASURE_CHAMBER_INTRO_140_CHAR	$BER
$LINE_TREASURE_CHAMBER_INTRO_140_TEXT	或者叫伊夫尼，简称。
$LINE_TREASURE_CHAMBER_INTRO_150_CHAR	$BER
$LINE_TREASURE_CHAMBER_INTRO_150_TEXT	你不会插足进来吧，对吗？我们是……真爱……
$LINE_TREASURE_CHAMBER_INTRO_160_CHAR	$DRA
$LINE_TREASURE_CHAMBER_INTRO_160_TEXT	好吧……价格合适的话，我可以考虑一下。
$SCENE_TREASURE_CHAMBER_OUTRO_TITLE	触手可及
$LINE_TREASURE_CHAMBER_OUTRO_00_CHAR	$MCG
$LINE_TREASURE_CHAMBER_OUTRO_00_TEXT	从这里我可以看到山口！我们快出去了！
$LINE_TREASURE_CHAMBER_OUTRO_10_CHAR	$HEA
$LINE_TREASURE_CHAMBER_OUTRO_10_TEXT	*$MCG……我要待在这里。
$LINE_TREASURE_CHAMBER_OUTRO_20_CHAR	$MCG
$LINE_TREASURE_CHAMBER_OUTRO_20_TEXT	什么？
$LINE_TREASURE_CHAMBER_OUTRO_30_CHAR	$HEA
$LINE_TREASURE_CHAMBER_OUTRO_30_TEXT	胜利已经触手可及了。没有我你也一样能做到。
$LINE_TREASURE_CHAMBER_OUTRO_40_CHAR	$HEA
$LINE_TREASURE_CHAMBER_OUTRO_40_TEXT	我根本没有想过活着结束这段旅程。
$LINE_TREASURE_CHAMBER_OUTRO_50_CHAR	$HEA
$LINE_TREASURE_CHAMBER_OUTRO_50_TEXT	这座堕落之城就像个完美的坟墓。
$LINE_TREASURE_CHAMBER_OUTRO_60_CHAR	$MCG
$LINE_TREASURE_CHAMBER_OUTRO_60_TEXT	你答应过我领我出去的。我不允许你现在食言。
$LINE_TREASURE_CHAMBER_OUTRO_70_CHAR	$HEA
$LINE_TREASURE_CHAMBER_OUTRO_70_TEXT	*$MCG，我手上粘上了数百万人的鲜血。
$LINE_TREASURE_CHAMBER_OUTRO_80_CHAR	$HEA
$LINE_TREASURE_CHAMBER_OUTRO_80_TEXT	舍里米尔已经付出了代价。
$LINE_TREASURE_CHAMBER_OUTRO_90_CHAR	$HEA
$LINE_TREASURE_CHAMBER_OUTRO_90_TEXT	现在轮到我了。
$LINE_TREASURE_CHAMBER_OUTRO_100_CHAR	$MCG
$LINE_TREASURE_CHAMBER_OUTRO_100_TEXT	我……
$LINE_TREASURE_CHAMBER_OUTRO_110_CHAR	$HEA
$LINE_TREASURE_CHAMBER_OUTRO_110_TEXT	没什么可说的了。快走。
$LINE_TREASURE_CHAMBER_OUTRO_120_CHAR	$MCG
$LINE_TREASURE_CHAMBER_OUTRO_120_TEXT	……
$LINE_TREASURE_CHAMBER_OUTRO_130_CHAR	$MAG
$LINE_TREASURE_CHAMBER_OUTRO_130_TEXT	长老……
$LINE_TREASURE_CHAMBER_OUTRO_140_CHAR	$HEA
$LINE_TREASURE_CHAMBER_OUTRO_140_TEXT	*$MAG……你想让舍里米尔死。而我和他一样罪行累累。
$LINE_TREASURE_CHAMBER_OUTRO_150_CHAR	$MAG
$LINE_TREASURE_CHAMBER_OUTRO_150_TEXT	我知道……
$LINE_TREASURE_CHAMBER_OUTRO_160_CHAR	$HEA
$LINE_TREASURE_CHAMBER_OUTRO_160_TEXT	那就让我去死吧。
$LINE_TREASURE_CHAMBER_OUTRO_170_CHAR	$MAG
$LINE_TREASURE_CHAMBER_OUTRO_170_TEXT	在没有人愿意帮助我的时候，你帮助了我。我……
$LINE_TREASURE_CHAMBER_OUTRO_180_CHAR	$HEA
$LINE_TREASURE_CHAMBER_OUTRO_180_TEXT	*$MAG，我杀了你的人民。
$LINE_TREASURE_CHAMBER_OUTRO_190_CHAR	$HEA
$LINE_TREASURE_CHAMBER_OUTRO_190_TEXT	让我付出代价吧。
$LINE_TREASURE_CHAMBER_OUTRO_200_CHAR	$MAG
$LINE_TREASURE_CHAMBER_OUTRO_200_TEXT	不。
$LINE_TREASURE_CHAMBER_OUTRO_210_CHAR	$MAG
$LINE_TREASURE_CHAMBER_OUTRO_210_TEXT	不，你不能轻易舍弃你的生命！
$LINE_TREASURE_CHAMBER_OUTRO_220_CHAR	$MAG
$LINE_TREASURE_CHAMBER_OUTRO_220_TEXT	你的命属于我，你要偿还我人民的性命。你没有自杀这么奢侈的权利！
$LINE_TREASURE_CHAMBER_OUTRO_230_CHAR	$HEA
$LINE_TREASURE_CHAMBER_OUTRO_230_TEXT	就这样吧。
$LINE_TREASURE_CHAMBER_OUTRO_240_CHAR	$HEA
$LINE_TREASURE_CHAMBER_OUTRO_240_TEXT	夺走我的性命吧。这样才对。
$LINE_TREASURE_CHAMBER_OUTRO_250_CHAR	$MAG
$LINE_TREASURE_CHAMBER_OUTRO_250_TEXT	……
$LINE_TREASURE_CHAMBER_OUTRO_260_CHAR	$MAG
$LINE_TREASURE_CHAMBER_OUTRO_260_TEXT	我才是做决定的人，不是你。
$LINE_TREASURE_CHAMBER_OUTRO_270_CHAR	$MAG
$LINE_TREASURE_CHAMBER_OUTRO_270_TEXT	我会自己选择什么时候应该结束它。
$LINE_TREASURE_CHAMBER_OUTRO_280_CHAR	$MAG
$LINE_TREASURE_CHAMBER_OUTRO_280_TEXT	现在起来，跟我们走。
$SCENE_4_4_INTRO_TITLE	陷入绝境
$LINE_4_4_INTRO_00_CHAR	$RAN
$LINE_4_4_INTRO_00_TEXT	嘿大伙儿？我想我知道为什么城里没有亡者了。
$LINE_4_4_INTRO_10_CHAR	$RAN
$LINE_4_4_INTRO_10_TEXT	它们都在这里等着我们。
$LINE_4_4_INTRO_20_CHAR	$MCG
$LINE_4_4_INTRO_20_TEXT	这里一定有成千上百。
$LINE_4_4_INTRO_30_CHAR	$RAN
$LINE_4_4_INTRO_30_TEXT	是的。
$LINE_4_4_INTRO_40_CHAR	$BER
$LINE_4_4_INTRO_40_TEXT	我从来没想着会这样死……
$LINE_4_4_INTRO_50_CHAR	$BER
$LINE_4_4_INTRO_50_TEXT	但是我希望如此！
$LINE_4_4_INTRO_60_CHAR	$BER
$LINE_4_4_INTRO_60_TEXT	鲜血！！
$LINE_4_4_INTRO_70_CHAR	$RAN
$LINE_4_4_INTRO_70_TEXT	好吧……
$LINE_4_4_INTRO_80_CHAR	$MCG
$LINE_4_4_INTRO_80_TEXT	要做的事情并不多了。
$LINE_4_4_INTRO_90_CHAR	$RAN
$LINE_4_4_INTRO_90_TEXT	很高兴能认识你。
$LINE_4_4_INTRO_100_CHAR	$DRA
$LINE_4_4_INTRO_100_TEXT	凡人……
$LINE_4_4_INTRO_110_CHAR	$MCG
$LINE_4_4_INTRO_110_TEXT	我想我们的协议不是那么美好了……
$LINE_4_4_INTRO_120_CHAR	$DRA
$LINE_4_4_INTRO_120_TEXT	我想教你一些事。
$LINE_4_4_INTRO_130_CHAR	$MCG
$LINE_4_4_INTRO_130_TEXT	什么？
$LINE_4_4_INTRO_140_CHAR	$DRA
$LINE_4_4_INTRO_140_TEXT	在我们的历史上...还没有凡人学过这个。
$LINE_4_4_INTRO_150_CHAR	$DRA
$LINE_4_4_INTRO_150_TEXT	我想现在正是时候。
$SCENE_4_4_OUTRO_TITLE	独自一人
$LINE_4_4_OUTRO_00_CHAR	$RAN
$LINE_4_4_OUTRO_00_TEXT	我不信。
$LINE_4_4_OUTRO_10_CHAR	$MCG
$LINE_4_4_OUTRO_10_TEXT	我们住的地方？
$LINE_4_4_OUTRO_20_CHAR	$RAN
$LINE_4_4_OUTRO_20_TEXT	好吧，那里也是。
$LINE_4_4_OUTRO_30_CHAR	$RAN
$LINE_4_4_OUTRO_30_TEXT	但是周围什么也没有。
$LINE_4_4_OUTRO_40_CHAR	$RAN
$LINE_4_4_OUTRO_40_TEXT	一个亡者都没有。
$LINE_4_4_OUTRO_50_CHAR	$RAN
$LINE_4_4_OUTRO_50_TEXT	没人跟着我们。
$SCENE_4_5_INTRO_TITLE	艾斯里-特诺奇的右手
$LINE_4_5_INTRO_00_CHAR	$RAN
$LINE_4_5_INTRO_00_TEXT	哦神啊，我从来没想过会发生这样的事情。
$LINE_4_5_INTRO_10_CHAR	$RAN
$LINE_4_5_INTRO_10_TEXT	我们在出口了！
$LINE_4_5_INTRO_20_CHAR	$RAN
$LINE_4_5_INTRO_20_TEXT	
$LINE_4_5_INTRO_30_CHAR	$RAN
$LINE_4_5_INTRO_30_TEXT	*$MCG！再也没有亡者了！
$LINE_4_5_INTRO_40_CHAR	狂血教徒
$LINE_4_5_INTRO_40_TEXT	*啊，这个叫$MCG的确实是最幸运的一个了。
$LINE_4_5_INTRO_50_CHAR	狂血教徒
$LINE_4_5_INTRO_50_TEXT	很少有人能看到艾斯里-特诺奇伸出荣耀的右手……
$LINE_4_5_INTRO_60_CHAR	狂血教徒
$LINE_4_5_INTRO_60_TEXT	然后取走……
$LINE_4_5_INTRO_70_CHAR	狂血教徒
$LINE_4_5_INTRO_70_TEXT	这个人的性命。
$SCENE_4_5_OUTRO_TITLE	舍里米尔的代价
$NARR_4_5_OUTRO_00_TEXT	第七幕
$NARR_4_5_OUTRO_00_SUB_TEXT	常言道人都怕死，但根據我的經驗，他們真正懼怕的是死後的未知性。在所有的疼苦中，當死亡是唯一可以想像的結果，我心內感受到前所未有的平靜。$N$N那唯一可以生存的機會$N$N才是我真正懼怕的。
$NARR_4_5_OUTRO_00_SUB_SUB_TEXT	*$N$N$N$N$N$N$N——摘自箭神哥德蒙達拉巴的回憶錄：$N伺奉艾殊王的冒險和探險經歷。
$LINE_4_5_OUTRO_00_CHAR	$MCG
$LINE_4_5_OUTRO_00_TEXT	如果战斗是你所想要的——
$LINE_4_5_OUTRO_10_CHAR	舍里米尔
$LINE_4_5_OUTRO_10_TEXT	我来这里的唯一原因就是防止你落到敌人的手里。
$LINE_4_5_OUTRO_20_CHAR	舍里米尔
$LINE_4_5_OUTRO_20_TEXT	既然确信你已经逃脱了，我没有理由阻止你。
$LINE_4_5_OUTRO_30_CHAR	舍里米尔
$LINE_4_5_OUTRO_30_TEXT	事实上，你会成功地分散敌人的注意力。
$LINE_4_5_OUTRO_40_CHAR	$DRA
$LINE_4_5_OUTRO_40_TEXT	你对我的孩子做了什么，卑鄙的家伙？
$LINE_4_5_OUTRO_50_CHAR	舍里米尔
$LINE_4_5_OUTRO_50_TEXT	我给了他更好的安排，防止他变成像你那样的可怜虫。
$LINE_4_5_OUTRO_60_CHAR	$DRA
$LINE_4_5_OUTRO_60_TEXT	你杀了我的孩子们！
$LINE_4_5_OUTRO_70_CHAR	舍里米尔
$LINE_4_5_OUTRO_70_TEXT	他们的牺牲会拯救世界。
$LINE_4_5_OUTRO_80_CHAR	舍里米尔
$LINE_4_5_OUTRO_80_TEXT	现在，你的孩子还分散在墓坑下面的矿井里，等待我的指示。
$LINE_4_5_OUTRO_90_CHAR	舍里米尔
$LINE_4_5_OUTRO_90_TEXT	只要我发出命令，这些亡者就会启动炸弹。
$LINE_4_5_OUTRO_100_CHAR	舍里米尔
$LINE_4_5_OUTRO_100_TEXT	墓坑会崩塌……
$LINE_4_5_OUTRO_110_CHAR	舍里米尔
$LINE_4_5_OUTRO_110_TEXT	一切都将不复存在。
$LINE_4_5_OUTRO_120_CHAR	舍里米尔
$LINE_4_5_OUTRO_120_TEXT	利用这大量的死亡，我就可以创建一个新的血印。
$LINE_4_5_OUTRO_130_CHAR	舍里米尔
$LINE_4_5_OUTRO_130_TEXT	一个强大数千倍的血印。
$LINE_4_5_OUTRO_140_CHAR	舍里米尔
$LINE_4_5_OUTRO_140_TEXT	所有的继承者都将死去。
$LINE_4_5_OUTRO_150_CHAR	舍里米尔
$LINE_4_5_OUTRO_150_TEXT	艾斯里-特诺奇会永远被困住。
$LINE_4_5_OUTRO_160_CHAR	$DRA
$LINE_4_5_OUTRO_160_TEXT	我要烧死你！
$LINE_4_5_OUTRO_170_CHAR	舍里米尔
$LINE_4_5_OUTRO_170_TEXT	我不这样认为。
$LINE_4_5_OUTRO_180_CHAR	舍里米尔
$LINE_4_5_OUTRO_180_TEXT	要知道，一旦你跟着我，你就会被摧毁。
$LINE_4_5_OUTRO_190_CHAR	舍里米尔
$LINE_4_5_OUTRO_190_TEXT	*再见了，$MCG。
$LINE_4_5_OUTRO_200_CHAR	舍里米尔
$LINE_4_5_OUTRO_200_TEXT	很快，一切都会结束。
$LINE_4_5_OUTRO_210_CHAR	$DRA
$LINE_4_5_OUTRO_210_TEXT	这个懦夫跑到了中途世界！
$LINE_4_5_OUTRO_220_CHAR	$DRA
$LINE_4_5_OUTRO_220_TEXT	快点！拉我们过去追上他！
$LINE_4_5_OUTRO_230_CHAR	$RAN
$LINE_4_5_OUTRO_230_TEXT	哇哦，让我们等一下。
$LINE_4_5_OUTRO_240_CHAR	$RAN
$LINE_4_5_OUTRO_240_TEXT	我是唯一一个记得出口的人吗？
$LINE_4_5_OUTRO_250_CHAR	$RAN
$LINE_4_5_OUTRO_250_TEXT	你们知道的，让我们能够逃离的那个出口？
$LINE_4_5_OUTRO_260_CHAR	$DRA
$LINE_4_5_OUTRO_260_TEXT	没时间畏畏缩缩了！
$LINE_4_5_OUTRO_270_CHAR	$RAN
$LINE_4_5_OUTRO_270_TEXT	没时间自杀了！
$LINE_4_5_OUTRO_280_CHAR	$RAN
$LINE_4_5_OUTRO_280_TEXT	*$MCG？
$SCENE_4_6_INTRO_TITLE	出路
$LINE_4_6_INTRO_00_CHAR	$MAG
$LINE_4_6_INTRO_00_TEXT	所以你决定就这么走了？
$LINE_4_6_INTRO_10_CHAR	$MCG
$LINE_4_6_INTRO_10_TEXT	我别无选择。
$LINE_4_6_INTRO_20_CHAR	$MAG
$LINE_4_6_INTRO_20_TEXT	我不会眼睁睁地看着我们中的最后一个人牺牲！
$LINE_4_6_INTRO_30_CHAR	$MAG
$LINE_4_6_INTRO_30_TEXT	亏我还把你当作朋友……
$LINE_4_6_INTRO_40_CHAR	$MAG
$LINE_4_6_INTRO_40_TEXT	……终有一天，你会知道，和战友一起死，比独自一人苟延残喘要好得多。
$LINE_4_6_INTRO_50_CHAR	$MAG
$LINE_4_6_INTRO_50_TEXT	愿你到时候能感受到教训的苦涩。
$LINE_4_6_INTRO_60_CHAR	$MCG
$LINE_4_6_INTRO_60_TEXT	……
$LINE_4_6_INTRO_70_CHAR	$HEA
$LINE_4_6_INTRO_70_TEXT	*你做出了最明智的选择， $MCG。
$LINE_4_6_INTRO_80_CHAR	$MCG
$LINE_4_6_INTRO_80_TEXT	是吗？
$LINE_4_6_INTRO_90_CHAR	$HEA
$LINE_4_6_INTRO_90_TEXT	你必须走，未来靠你了。
$LINE_4_6_INTRO_100_CHAR	$HEA
$LINE_4_6_INTRO_100_TEXT	我必须和我创造的一切一起死。
$LINE_4_6_INTRO_110_CHAR	$MCG
$LINE_4_6_INTRO_110_TEXT	再见，朋友。
$LINE_4_6_INTRO_120_CHAR	$HEA
$LINE_4_6_INTRO_120_TEXT	瑟连达之路指引着你。
$LINE_4_6_INTRO_130_CHAR	$DRA
$LINE_4_6_INTRO_130_TEXT	我告诉过你火的秘密！
$LINE_4_6_INTRO_140_CHAR	$DRA
$LINE_4_6_INTRO_140_TEXT	你竟然要背叛我们？
$LINE_4_6_INTRO_150_CHAR	$DRA
$LINE_4_6_INTRO_150_TEXT	凡人就是不可靠……
$LINE_4_6_INTRO_160_CHAR	$MCG
$LINE_4_6_INTRO_160_TEXT	*$DRA，世界危在旦夕。
$LINE_4_6_INTRO_170_CHAR	$DRA
$LINE_4_6_INTRO_170_TEXT	我不关心什么世界！
$LINE_4_6_INTRO_180_CHAR	$DRA
$LINE_4_6_INTRO_180_TEXT	我要为我的孩子报仇。
$LINE_4_6_INTRO_190_CHAR	$DRA
$LINE_4_6_INTRO_190_TEXT	凡人的懦弱.……
$LINE_4_6_INTRO_200_CHAR	$BER
$LINE_4_6_INTRO_200_TEXT	*哟， $MCG！
$LINE_4_6_INTRO_210_CHAR	$MCG
$LINE_4_6_INTRO_210_TEXT	你也在？
$LINE_4_6_INTRO_220_CHAR	$BER
$LINE_4_6_INTRO_220_TEXT	一切都很有趣，但是我刚刚放弃了一个与世界上最恐怖的巫师决斗的机会。
$LINE_4_6_INTRO_230_CHAR	$BER
$LINE_4_6_INTRO_230_TEXT	我从不当逃兵的。
$LINE_4_6_INTRO_240_CHAR	$MCG
$LINE_4_6_INTRO_240_TEXT	这不是战斗，是自杀！
$LINE_4_6_INTRO_250_CHAR	$BER
$LINE_4_6_INTRO_250_TEXT	噢，我不是很了解情况。酸甜苦辣我都品尝过，死而无憾了。
$LINE_4_6_INTRO_260_CHAR	$BER
$LINE_4_6_INTRO_260_TEXT	特别是那段时光，吃的炸水饺竟然不是炸水饺……
$LINE_4_6_INTRO_270_CHAR	$BER
$LINE_4_6_INTRO_270_TEXT	无论如何，只要我能把某人剁成肉酱，别的都无所谓了。
$LINE_4_6_INTRO_280_CHAR	$BER
$LINE_4_6_INTRO_280_TEXT	再见！
$LINE_4_6_INTRO_290_CHAR	$MCG
$LINE_4_6_INTRO_290_TEXT	……再见。
$LINE_4_6_INTRO_300_CHAR	$MCG
$LINE_4_6_INTRO_300_TEXT	……
$LINE_4_6_INTRO_310_CHAR	$MCG
$LINE_4_6_INTRO_310_TEXT	还有人吗？
$LINE_4_6_INTRO_320_CHAR	$KNI
$LINE_4_6_INTRO_320_TEXT	我被我的债务绑定了。
$LINE_4_6_INTRO_330_CHAR	$KNI
$LINE_4_6_INTRO_330_TEXT	不管你做出什么选择，我都会跟随你。
$LINE_4_6_INTRO_340_CHAR	$MCG
$LINE_4_6_INTRO_340_TEXT	*谢谢你，$KNI。
$LINE_4_6_INTRO_350_CHAR	$MCG
$LINE_4_6_INTRO_350_TEXT	*$RAN？
$LINE_4_6_INTRO_360_CHAR	$RAN
$LINE_4_6_INTRO_360_TEXT	嘿，别看我。我要从这里出去。
$LINE_4_6_INTRO_370_CHAR	$RAN
$LINE_4_6_INTRO_370_TEXT	我大老远跑来，不是为了回去被人杀掉的。
$LINE_4_6_INTRO_380_CHAR	$MCG
$LINE_4_6_INTRO_380_TEXT	好吧，那我们最好现在出去。
$LINE_4_6_INTRO_390_CHAR	$RAN
$LINE_4_6_INTRO_390_TEXT	……
$LINE_4_6_INTRO_400_CHAR	$RAN
$LINE_4_6_INTRO_400_TEXT	*嗨， $BER！
$LINE_4_6_INTRO_410_CHAR	$BER
$LINE_4_6_INTRO_410_TEXT	哟。
$LINE_4_6_INTRO_420_CHAR	$RAN
$LINE_4_6_INTRO_420_TEXT	你知道自己要死了，是吧？
$LINE_4_6_INTRO_430_CHAR	$BER
$LINE_4_6_INTRO_430_TEXT	当然。
$LINE_4_6_INTRO_440_CHAR	$RAN
$LINE_4_6_INTRO_440_TEXT	那……这样你也不再重新考虑一下整件事情吗？
$LINE_4_6_INTRO_450_CHAR	$BER
$LINE_4_6_INTRO_450_TEXT	*嘿，$RAN，你和我都成功逃生了。
$LINE_4_6_INTRO_460_CHAR	$BER
$LINE_4_6_INTRO_460_TEXT	但是你不可能永远都这么幸运。总有一天，你会死去。
$LINE_4_6_INTRO_470_CHAR	$BER
$LINE_4_6_INTRO_470_TEXT	这是个给生命赋予意义的机会。
$LINE_4_6_INTRO_480_CHAR	$RAN
$LINE_4_6_INTRO_480_TEXT	*$BER……
$LINE_4_6_INTRO_490_CHAR	$BER
$LINE_4_6_INTRO_490_TEXT	还有，欠你那些东西我再也不用还了。
$LINE_4_6_INTRO_500_CHAR	$BER
$LINE_4_6_INTRO_500_TEXT	回头见！
$LINE_4_6_INTRO_510_CHAR	$RAN
$LINE_4_6_INTRO_510_TEXT	……再见……
$LINE_4_6_INTRO_520_CHAR	$MCG
$LINE_4_6_INTRO_520_TEXT	*$RAN？
$LINE_4_6_INTRO_530_CHAR	$RAN
$LINE_4_6_INTRO_530_TEXT	好吧，让我们出去
$SCENE_ENDING_4_6_OUTRO_TITLE	现在呢？
$LINE_ENDING_4_6_OUTRO_00_CHAR	$MCG
$LINE_ENDING_4_6_OUTRO_00_TEXT	我们出来了。
$LINE_ENDING_4_6_OUTRO_10_CHAR	$RAN
$LINE_ENDING_4_6_OUTRO_10_TEXT	我们自由了。
$LINE_ENDING_4_6_OUTRO_20_CHAR	$KNI
$LINE_ENDING_4_6_OUTRO_20_TEXT	现在呢，女士？
$LINE_ENDING_4_6_OUTRO_30_CHAR	$MCG
$LINE_ENDING_4_6_OUTRO_30_TEXT	我不知道……
$LINE_ENDING_4_6_OUTRO_40_CHAR	$MCG
$LINE_ENDING_4_6_OUTRO_40_TEXT	墓坑……
$LINE_ENDING_4_6_OUTRO_50_CHAR	$KNI
$LINE_ENDING_4_6_OUTRO_50_TEXT	我们做了必须要做的事情。
$LINE_ENDING_4_6_OUTRO_60_CHAR	$KNI
$LINE_ENDING_4_6_OUTRO_60_TEXT	我们无法阻止舍里米尔……
$LINE_ENDING_4_6_OUTRO_70_CHAR	$KNI
$LINE_ENDING_4_6_OUTRO_70_TEXT	如果你死了，艾斯里-特诺奇就自由了。
$LINE_ENDING_4_6_OUTRO_80_CHAR	$MCG
$LINE_ENDING_4_6_OUTRO_80_TEXT	那也不会让情况好转。
$LINE_ENDING_4_6_OUTRO_90_CHAR	$MCG
$LINE_ENDING_4_6_OUTRO_90_TEXT	所有的那些人……
$LINE_ENDING_4_6_OUTRO_100_CHAR	$KNI
$LINE_ENDING_4_6_OUTRO_100_TEXT	这是个悲剧……
$LINE_ENDING_4_6_OUTRO_110_CHAR	$KNI
$LINE_ENDING_4_6_OUTRO_110_TEXT	不要因为生存而责备自己。
$LINE_ENDING_4_6_OUTRO_120_CHAR	$MCG
$LINE_ENDING_4_6_OUTRO_120_TEXT	……
$LINE_ENDING_4_6_OUTRO_121_TEXT	当我闭上眼睛，我仍能感受到墓坑坍塌的回响，以及无数受害者的尖叫。
$LINE_ENDING_4_6_OUTRO_122_TEXT	两个月的时间对这种强烈的感受没有任何的缓解作用。我嘴里的血腥味再也不会消失了。
$LINE_ENDING_4_6_OUTRO_123_TEXT	我也不想这样。
$LINE_ENDING_4_6_OUTRO_124_TEXT	在这场残酷的冒险之中，他们挥洒了无数的鲜血，而我，困在我自己的牢笼之中，无法将我的血也撒进其中。
$LINE_ENDING_4_6_OUTRO_125_TEXT	我的回忆就是我的参与。在我这借来的余生之中，我会永远将我的思绪沉浸其中。
$LINE_ENDING_4_6_OUTRO_126_TEXT	*$RAN埋葬了她的狐狸。这对于一个诺曼来说意味着什么，我并不知道。
$LINE_ENDING_4_6_OUTRO_127_TEXT	我本可以问她，这种无聊的好奇心已经给我的生活带来了很多，但这次它并没有像以前一样牢牢抓住抓住我的思绪。
$LINE_ENDING_4_6_OUTRO_128_TEXT	最终，这也已经不重要了。一天早上，她走了，这是一个结论，我们共同的冒险将永远存在。
$LINE_ENDING_4_6_OUTRO_129_TEXT	我认为*$KNI应该会留下的，如果我去问他的话。但似乎这也是不对的。
$LINE_ENDING_4_6_OUTRO_130_TEXT	我解放了他，这个世界正在慢慢重建，我让他去做他自己想做的事情。在这里，我还需要一个保镖吗？
$LINE_ENDING_4_6_OUTRO_131_TEXT	瘟疫退散了。奎德也灭亡了。
$LINE_ENDING_4_6_OUTRO_132_TEXT	再也没有邪恶了，除了我们自己的。
$LINE_ENDING_4_6_OUTRO_133_TEXT	*——$MCG·雅琪·利佛巴
$SCENE_4_7_INTRO_TITLE	跟随舍里米尔
$LINE_4_7_INTRO_00_CHAR	$MCG
$LINE_4_7_INTRO_00_TEXT	我知道那样可以拯救世界……
$LINE_4_7_INTRO_10_CHAR	$MCG
$LINE_4_7_INTRO_10_TEXT	但是我不能对舍里米尔的所作所为置之不理。
$LINE_4_7_INTRO_20_CHAR	$MCG
$LINE_4_7_INTRO_20_TEXT	代价太沉重了。
$LINE_4_7_INTRO_30_CHAR	$HEA
$LINE_4_7_INTRO_30_TEXT	你知道去那里的风险有多大吗？
$LINE_4_7_INTRO_40_CHAR	$HEA
$LINE_4_7_INTRO_40_TEXT	我不会允许他的计划得逞的，但是你的到来把一切都置于危险的境地。
$LINE_4_7_INTRO_50_CHAR	$MCG
$LINE_4_7_INTRO_50_TEXT	你的唯一的一线希望就是我，你知道的。
$LINE_4_7_INTRO_60_CHAR	$HEA
$LINE_4_7_INTRO_60_TEXT	很好，这是你的选择。
$LINE_4_7_INTRO_70_CHAR	$BER
$LINE_4_7_INTRO_70_TEXT	好吧！自杀冲击时间！
$LINE_4_7_INTRO_80_CHAR	$BER
$LINE_4_7_INTRO_80_TEXT	我喜欢暴力！
$LINE_4_7_INTRO_90_CHAR	$MAG
$LINE_4_7_INTRO_90_TEXT	我和你一起。不会让这个野兽毁掉剩下的人。
$LINE_4_7_INTRO_100_CHAR	$DRA
$LINE_4_7_INTRO_100_TEXT	勇气可嘉，凡人。干得好。
$LINE_4_7_INTRO_110_CHAR	$DRA
$LINE_4_7_INTRO_110_TEXT	我的孩子们不应该去复仇。
$LINE_4_7_INTRO_120_CHAR	$RAN
$LINE_4_7_INTRO_120_TEXT	我很欣赏你的道德原则和其他品质，但是我要出去。
$LINE_4_7_INTRO_130_CHAR	$RAN
$LINE_4_7_INTRO_130_TEXT	我千辛万苦来到出口前，我不会回去再被人杀死的。
$LINE_4_7_INTRO_140_CHAR	$MCG
$LINE_4_7_INTRO_140_TEXT	我知道。
$LINE_4_7_INTRO_150_CHAR	$RAN
$LINE_4_7_INTRO_150_TEXT	好吧……再见。
$LINE_4_7_INTRO_160_CHAR	$MCG
$LINE_4_7_INTRO_160_TEXT	*再见了， $RAN。
$LINE_4_7_INTRO_170_CHAR	$RAN
$LINE_4_7_INTRO_170_TEXT	……
$LINE_4_7_INTRO_180_CHAR	$RAN
$LINE_4_7_INTRO_180_TEXT	*$BER！
$LINE_4_7_INTRO_190_CHAR	$BER
$LINE_4_7_INTRO_190_TEXT	哟。
$LINE_4_7_INTRO_200_CHAR	$RAN
$LINE_4_7_INTRO_200_TEXT	你知道自己要死了，是吧？
$LINE_4_7_INTRO_210_CHAR	$BER
$LINE_4_7_INTRO_210_TEXT	当然。
$LINE_4_7_INTRO_220_CHAR	$RAN
$LINE_4_7_INTRO_220_TEXT	那……这样你也不再重新考虑一下整件事情吗？
$LINE_4_7_INTRO_230_CHAR	$BER
$LINE_4_7_INTRO_230_TEXT	*嘿，$RAN，你和我都成功逃生了。
$LINE_4_7_INTRO_240_CHAR	$BER
$LINE_4_7_INTRO_240_TEXT	但是你不可能永远都这么幸运。总有一天，你会死去。
$LINE_4_7_INTRO_250_CHAR	$BER
$LINE_4_7_INTRO_250_TEXT	这是个给生命赋予意义的机会。
$LINE_4_7_INTRO_260_CHAR	$RAN
$LINE_4_7_INTRO_260_TEXT	*$BER……
$LINE_4_7_INTRO_270_CHAR	$BER
$LINE_4_7_INTRO_270_TEXT	还有，欠你那些东西我再也不用还了。
$LINE_4_7_INTRO_280_CHAR	$BER
$LINE_4_7_INTRO_280_TEXT	回头见！
$LINE_4_7_INTRO_290_CHAR	$RAN
$LINE_4_7_INTRO_290_TEXT	……再见……
$SCENE_4_7_OUTRO_TITLE	许多
$LINE_4_7_OUTRO_00_CHAR	$KNI
$LINE_4_7_OUTRO_00_TEXT	先锋倒下了，但是大部队在包抄我们。
$LINE_4_7_OUTRO_10_CHAR	$KNI
$LINE_4_7_OUTRO_10_TEXT	要是我们对付他们，可能就无法立刻跟上舍里米尔了。
$LINE_4_7_OUTRO_20_CHAR	$MCG
$LINE_4_7_OUTRO_20_TEXT	你有什么建议？
$LINE_4_7_OUTRO_30_CHAR	$KNI
$LINE_4_7_OUTRO_30_TEXT	嗯……
$LINE_4_7_OUTRO_40_CHAR	$KNI
$LINE_4_7_OUTRO_40_TEXT	老实说？直接突入敌人内部，杀掉所有会动的。
$LINE_4_7_OUTRO_50_CHAR	$MCG
$LINE_4_7_OUTRO_50_TEXT	听起来不错。
$LINE_4_7_OUTRO_60_CHAR	$BER
$LINE_4_7_OUTRO_60_TEXT	不错啊，好家伙！
$LINE_4_7_OUTRO_70_CHAR	$BER
$LINE_4_7_OUTRO_70_TEXT	好主意！
$LINE_4_7_OUTRO_80_CHAR	$KNI
$LINE_4_7_OUTRO_80_TEXT	那是什么？你在干什么？
$LINE_4_7_OUTRO_90_CHAR	$BER
$LINE_4_7_OUTRO_90_TEXT	来一个男子汉的顶拳仪式啊！
$LINE_4_7_OUTRO_100_CHAR	$KNI
$LINE_4_7_OUTRO_100_TEXT	不，不要。
$LINE_4_7_OUTRO_110_CHAR	$KNI
$LINE_4_7_OUTRO_110_TEXT	别碰我。
$LINE_4_7_OUTRO_120_CHAR	$KNI
$LINE_4_7_OUTRO_120_TEXT	还有，如果你不介意的话，请待在我的下风向就更好了。
$SCENE_4_8_INTRO_TITLE	舍里米尔的军队
$LINE_4_8_INTRO_00_CHAR	$MAG
$LINE_4_8_INTRO_00_TEXT	我们到了
$LINE_4_8_INTRO_10_CHAR	$MAG
$LINE_4_8_INTRO_10_TEXT	敌人大部队。
$LINE_4_8_INTRO_20_CHAR	$BER
$LINE_4_8_INTRO_20_TEXT	真的好多人啊。
$LINE_4_8_INTRO_30_CHAR	$MAG
$LINE_4_8_INTRO_30_TEXT	我是火的女儿，对抗我的人都会被烧死。
$LINE_4_8_INTRO_40_CHAR	$BER
$LINE_4_8_INTRO_40_TEXT	噢，我也希望自己能有帅气的战吼……
$LINE_4_8_INTRO_50_CHAR	$BER
$LINE_4_8_INTRO_50_TEXT	<LQ>哇啊啊啊嗷嗷嗷<RQ>听起来不太尽如人意。
$LINE_4_8_INTRO_60_CHAR	$RAN
$LINE_4_8_INTRO_60_TEXT	我不知道，我还挺喜欢<LQ>哇啊啊啊嗷嗷嗷<RQ>的。
$LINE_4_8_INTRO_70_CHAR	$RAN
$LINE_4_8_INTRO_70_TEXT	你应该保持。
$LINE_4_8_INTRO_80_CHAR	$BER
$LINE_4_8_INTRO_80_TEXT	嘿，你回来了。
$LINE_4_8_INTRO_90_CHAR	$RAN
$LINE_4_8_INTRO_90_TEXT	嘿，我回来了。
$LINE_4_8_INTRO_100_CHAR	$BER
$LINE_4_8_INTRO_100_TEXT	你知道我还是不会还你的，对吧？
$LINE_4_8_INTRO_110_CHAR	$RAN
$LINE_4_8_INTRO_110_TEXT	让我们先好好应付这次自杀式冲锋，好吗？
$LINE_4_8_INTRO_120_CHAR	$BER
$LINE_4_8_INTRO_120_TEXT	是的，但是首先。
$LINE_4_8_INTRO_130_CHAR	$RAN
$LINE_4_8_INTRO_130_TEXT	什么，那是什么？
$LINE_4_8_INTRO_140_CHAR	$BER
$LINE_4_8_INTRO_140_TEXT	男子汉的顶拳！
$LINE_4_8_INTRO_150_CHAR	$RAN
$LINE_4_8_INTRO_150_TEXT	我为什么要这么做？
$LINE_4_8_INTRO_160_CHAR	$BER
$LINE_4_8_INTRO_160_TEXT	因为我们这么了不起，我们应该把顶拳作为打招呼的方式！
$LINE_4_8_INTRO_170_CHAR	$RAN
$LINE_4_8_INTRO_170_TEXT	好吧，我回来了—— 希望不要顶走你的运气。
$LINE_4_8_INTRO_180_CHAR	$BER
$LINE_4_8_INTRO_180_TEXT	……太烂了。
$LINE_4_8_INTRO_190_CHAR	$RAN
$LINE_4_8_INTRO_190_TEXT	让我们去赴死吧，准备好了吗？
$LINE_4_8_INTRO_200_CHAR	$BER
$LINE_4_8_INTRO_200_TEXT	哇啊啊嗷嗷。
$SCENE_4_8_OUTRO_TITLE	还有一人
$LINE_4_8_OUTRO_00_CHAR	$MAG
$LINE_4_8_OUTRO_00_TEXT	最后一个敌人倒下了。
$LINE_4_8_OUTRO_10_CHAR	$DRA
$LINE_4_8_OUTRO_10_TEXT	不，不是最后一个。
$LINE_4_8_OUTRO_20_CHAR	$DRA
$LINE_4_8_OUTRO_20_TEXT	还有一个。
$LINE_4_8_OUTRO_30_CHAR	$DRA
$LINE_4_8_OUTRO_30_TEXT	还有一个将直面我复仇的人
$LINE_4_8_OUTRO_40_CHAR	$MAG
$LINE_4_8_OUTRO_40_TEXT	以及直面宇宙之焰的正义。
$LINE_4_8_OUTRO_50_CHAR	$MAG
$LINE_4_8_OUTRO_50_TEXT	舍里米尔
$SCENE_4_9_INTRO_TITLE	直面疯狂
$LINE_4_9_INTRO_00_CHAR	舍里米尔
$LINE_4_9_INTRO_00_TEXT	鲜血已经溢出了了，如果现在还不凝固——
$LINE_4_9_INTRO_10_CHAR	$MCG
$LINE_4_9_INTRO_10_TEXT	住手！
$LINE_4_9_INTRO_20_CHAR	舍里米尔
$LINE_4_9_INTRO_20_TEXT	*……$MCG。
$LINE_4_9_INTRO_30_CHAR	舍里米尔
$LINE_4_9_INTRO_30_TEXT	你看到了，多亏了我们的英勇战斗——可恶的男巫被囚禁了。
$LINE_4_9_INTRO_40_CHAR	舍里米尔
$LINE_4_9_INTRO_40_TEXT	事到如今，他还想负隅顽抗。
$LINE_4_9_INTRO_50_CHAR	舍里米尔
$LINE_4_9_INTRO_50_TEXT	他知道，自己会永久地被锁起来。
$LINE_4_9_INTRO_60_CHAR	$MCG
$LINE_4_9_INTRO_60_TEXT	我才不会让你动手。
$LINE_4_9_INTRO_70_CHAR	舍里米尔
$LINE_4_9_INTRO_70_TEXT	我不想这样做。
$LINE_4_9_INTRO_80_CHAR	舍里米尔
$LINE_4_9_INTRO_80_TEXT	但是，如果你自己选择死亡，新血印会更加威力强大的。
$LINE_4_9_INTRO_90_CHAR	$MCG
$LINE_4_9_INTRO_90_TEXT	我不会让你杀掉这些人的。
$LINE_4_9_INTRO_100_CHAR	舍里米尔
$LINE_4_9_INTRO_100_TEXT	*$MCG，我已经杀了成千上万人了……
$LINE_4_9_INTRO_110_CHAR	舍里米尔
$LINE_4_9_INTRO_110_TEXT	还剩几千人，我就能停止这一切。我就能阻止他。
$LINE_4_9_INTRO_120_CHAR	舍里米尔
$LINE_4_9_INTRO_120_TEXT	这些生命，相对于已经死在我手上的来说，只是九牛一毛。
$LINE_4_9_INTRO_130_CHAR	$MCG
$LINE_4_9_INTRO_130_TEXT	我不会容许你这样做的！
$SCENE_4_9_OUTRO_TITLE	为时已晚
$LINE_4_9_OUTRO_00_CHAR	舍里米尔
$LINE_4_9_OUTRO_00_TEXT	*干的不错， $MCG。
$LINE_4_9_OUTRO_10_CHAR	舍里米尔
$LINE_4_9_OUTRO_10_TEXT	但是太迟了。
$LINE_4_9_OUTRO_20_CHAR	舍里米尔
$LINE_4_9_OUTRO_20_TEXT	信号灯已经熄灭……
$LINE_4_9_OUTRO_30_CHAR	舍里米尔
$LINE_4_9_OUTRO_30_TEXT	现在……
$LINE_4_9_OUTRO_40_CHAR	舍里米尔
$LINE_4_9_OUTRO_40_TEXT	墓坑崩塌……
$LINE_4_9_OUTRO_50_CHAR	舍里米尔
$LINE_4_9_OUTRO_50_TEXT	……我们为了永远囚禁艾斯里-特诺奇付出了生命。
$LINE_4_9_OUTRO_60_CHAR	$MCG
$LINE_4_9_OUTRO_60_TEXT	你不能杀掉这些人……
$LINE_4_9_OUTRO_70_CHAR	$MCG
$LINE_4_9_OUTRO_70_TEXT	……不……
$LINE_4_9_OUTRO_80_CHAR	$MCG
$LINE_4_9_OUTRO_80_TEXT	不！
$SCENE_FINAL_INTRO_TITLE	艾斯里-特诺奇
$LINE_FINAL_INTRO_00_CHAR	$KNI
$LINE_FINAL_INTRO_00_TEXT	刚才发生了什么？
$LINE_FINAL_INTRO_10_CHAR	$MCG
$LINE_FINAL_INTRO_10_TEXT	我们在……半……中途世界...
$LINE_FINAL_INTRO_20_CHAR	$KNI
$LINE_FINAL_INTRO_20_TEXT	其他人呢？
$LINE_FINAL_INTRO_30_CHAR	$MCG
$LINE_FINAL_INTRO_30_TEXT	他们……在这里。
$LINE_FINAL_INTRO_40_CHAR	$KNI
$LINE_FINAL_INTRO_40_TEXT	什么？所有人？
$LINE_FINAL_INTRO_50_CHAR	$MCG
$LINE_FINAL_INTRO_50_TEXT	墓坑里的所有人……我把他们拉进来了……他们……安全了……
$LINE_FINAL_INTRO_60_CHAR	$KNI
$LINE_FINAL_INTRO_60_TEXT	那可是好几千人啊！怎么能……
$LINE_FINAL_INTRO_70_CHAR	$KNI
$LINE_FINAL_INTRO_70_TEXT	*$MCG，你受伤了。
$LINE_FINAL_INTRO_80_CHAR	$KNI
$LINE_FINAL_INTRO_80_TEXT	你在流血！
$LINE_FINAL_INTRO_90_CHAR	舍里米尔
$LINE_FINAL_INTRO_90_TEXT	不……血！
$LINE_FINAL_INTRO_100_CHAR	舍里米尔
$LINE_FINAL_INTRO_100_TEXT	新封印还没有完成！你不能让血……
$LINE_FINAL_INTRO_110_CHAR	艾斯里-特诺奇
$LINE_FINAL_INTRO_110_TEXT	终于，我自由了。
$SCENE_GAMEOVER_A_TITLE	一切尽失
$LINE_GAMEOVER_A_00_CHAR	艾斯里-特诺奇
$LINE_GAMEOVER_A_00_TEXT	终于。
$LINE_GAMEOVER_A_10_CHAR	艾斯里-特诺奇
$LINE_GAMEOVER_A_10_TEXT	世界终于回到了我的手中。
$SCENE_ENDING_ZELEMIR_DEAD_TITLE	痛苦的结局
$NARR_ENDING_ZELEMIR_DEAD_00_TEXT	我们忙着逃跑。
$NARR_ENDING_ZELEMIR_DEAD_10_TEXT	岩石不断崩塌。
$NARR_ENDING_ZELEMIR_DEAD_20_TEXT	很多人死了。
$NARR_ENDING_ZELEMIR_DEAD_30_TEXT	我们讨论了好几天。
$NARR_ENDING_ZELEMIR_DEAD_40_TEXT	诺曼商队断断续续地买我们的废料。
$NARR_ENDING_ZELEMIR_DEAD_50_TEXT	我们中很多人都食不果腹。
$NARR_ENDING_ZELEMIR_DEAD_60_TEXT	难民里出现了各种领导者。
$NARR_ENDING_ZELEMIR_DEAD_70_TEXT	但是谁也懒得管了。
$NARR_ENDING_ZELEMIR_DEAD_80_TEXT	呼吸新鲜空气对我而言依旧是很奇怪的感觉。
$NARR_ENDING_ZELEMIR_DEAD_90_TEXT	最终一切都达成了一致。
$NARR_ENDING_ZELEMIR_DEAD_100_TEXT	我的命运永远地发生了改变。
$NARR_ENDING_ZELEMIR_DEAD_110_TEXT	世界也永远地发生改变了。
$LINE_ENDING_ZELEMIR_DEAD_00_CHAR	$HEA
$LINE_ENDING_ZELEMIR_DEAD_00_TEXT	……我们可能追不上他……
$LINE_ENDING_ZELEMIR_DEAD_10_CHAR	$HEA
$LINE_ENDING_ZELEMIR_DEAD_10_TEXT	……但是我们可以困住他！
$LINE_ENDING_ZELEMIR_DEAD_20_CHAR	$MCG
$LINE_ENDING_ZELEMIR_DEAD_20_TEXT	长老？
$LINE_ENDING_ZELEMIR_DEAD_30_CHAR	$HEA
$LINE_ENDING_ZELEMIR_DEAD_30_TEXT	一个新的血印，把他囚禁在他撤退到的地方。
$LINE_ENDING_ZELEMIR_DEAD_40_CHAR	$MCG
$LINE_ENDING_ZELEMIR_DEAD_40_TEXT	长老，不！
$LINE_ENDING_ZELEMIR_DEAD_50_CHAR	$HEA
$LINE_ENDING_ZELEMIR_DEAD_50_TEXT	事情本该如此。
$LINE_ENDING_ZELEMIR_DEAD_60_CHAR	$HEA
$LINE_ENDING_ZELEMIR_DEAD_60_TEXT	舍里米尔启动的咒语仍然有效。
$LINE_ENDING_ZELEMIR_DEAD_70_CHAR	$HEA
$LINE_ENDING_ZELEMIR_DEAD_70_TEXT	舍里米尔已经死了……
$LINE_ENDING_ZELEMIR_DEAD_80_CHAR	$HEA
$LINE_ENDING_ZELEMIR_DEAD_80_TEXT	用他的血和我的血，我们能再次封住这个邪恶的男巫！
$LINE_ENDING_ZELEMIR_DEAD_90_CHAR	艾斯里-特诺奇
$LINE_ENDING_ZELEMIR_DEAD_90_TEXT	蠢货！我会逃走的。这么多年……终有一天，你的血会会自己来找到我的。
$LINE_ENDING_ZELEMIR_DEAD_100_CHAR	艾斯里-特诺奇
$LINE_ENDING_ZELEMIR_DEAD_100_TEXT	你的儿子，你的孙子。我会等着的。世世代代中谁能够战胜我？
$LINE_ENDING_ZELEMIR_DEAD_110_CHAR	$HEA
$LINE_ENDING_ZELEMIR_DEAD_110_TEXT	但是你应该被囚禁。现在人们该接受教训了，他们应该时刻做好准备。
$LINE_ENDING_ZELEMIR_DEAD_120_CHAR	艾斯里-特诺奇
$LINE_ENDING_ZELEMIR_DEAD_120_TEXT	你已有通过谎言才能忍受真相了。
$LINE_ENDING_ZELEMIR_DEAD_130_CHAR	$HEA
$LINE_ENDING_ZELEMIR_DEAD_130_TEXT	你低估了这个世界。
$LINE_ENDING_ZELEMIR_DEAD_140_CHAR	艾斯里-特诺奇
$LINE_ENDING_ZELEMIR_DEAD_140_TEXT	你的世界需要我，僧侣。终有一天，会有人把我救出去，求我拯救他们。
$LINE_ENDING_ZELEMIR_DEAD_150_CHAR	艾斯里-特诺奇
$LINE_ENDING_ZELEMIR_DEAD_150_TEXT	你的后代同样会洒下他们的鲜血，就像你一样。
$LINE_ENDING_ZELEMIR_DEAD_160_CHAR	$KNI
$LINE_ENDING_ZELEMIR_DEAD_160_TEXT	我没结婚，没孩子。
$LINE_ENDING_ZELEMIR_DEAD_170_CHAR	$KNI
$LINE_ENDING_ZELEMIR_DEAD_170_TEXT	这一辈子都不会有了。
$LINE_ENDING_ZELEMIR_DEAD_180_CHAR	$MCG
$LINE_ENDING_ZELEMIR_DEAD_180_TEXT	*$KNI？
$LINE_ENDING_ZELEMIR_DEAD_190_CHAR	$KNI
$LINE_ENDING_ZELEMIR_DEAD_190_TEXT	要封住这个野兽，一个血印还不够。
$LINE_ENDING_ZELEMIR_DEAD_200_CHAR	$KNI
$LINE_ENDING_ZELEMIR_DEAD_200_TEXT	原来的血印是一般的三倍效果……而我们已经看到了，当它削弱到一倍的时候发生了什么。
$LINE_ENDING_ZELEMIR_DEAD_210_CHAR	$KNI
$LINE_ENDING_ZELEMIR_DEAD_210_TEXT	*再会，$MCG。带领我的人去安全的地方吧。
$LINE_ENDING_ZELEMIR_DEAD_220_CHAR	$MCG
$LINE_ENDING_ZELEMIR_DEAD_220_TEXT	不！
$LINE_ENDING_ZELEMIR_DEAD_230_CHAR	$HEA
$LINE_ENDING_ZELEMIR_DEAD_230_TEXT	现在我们要挥洒我们的血液，将你永远的封印。
$LINE_ENDING_ZELEMIR_DEAD_240_CHAR	$MCG
$LINE_ENDING_ZELEMIR_DEAD_240_TEXT	长老，求求你了！
$LINE_ENDING_ZELEMIR_DEAD_250_CHAR	$HEA
$LINE_ENDING_ZELEMIR_DEAD_250_TEXT	绑定，封印，隐藏。完成了。
$LINE_ENDING_ZELEMIR_DEAD_260_CHAR	$MCG
$LINE_ENDING_ZELEMIR_DEAD_260_TEXT	……
$LINE_ENDING_ZELEMIR_DEAD_270_CHAR	艾斯里-特诺奇
$LINE_ENDING_ZELEMIR_DEAD_270_TEXT	什么是一千多年？
$LINE_ENDING_ZELEMIR_DEAD_280_CHAR	艾斯里-特诺奇
$LINE_ENDING_ZELEMIR_DEAD_280_TEXT	十万年？人心都是一样的！我会——
$LINE_ENDING_ZELEMIR_DEAD_290_CHAR	$MCG
$LINE_ENDING_ZELEMIR_DEAD_290_TEXT	……
$LINE_ENDING_ZELEMIR_DEAD_300_CHAR	$RAN
$LINE_ENDING_ZELEMIR_DEAD_300_TEXT	*$MCG，墓坑在崩塌！
$LINE_ENDING_ZELEMIR_DEAD_310_CHAR	$RAN
$LINE_ENDING_ZELEMIR_DEAD_310_TEXT	我们现在必须离开这儿！
$LINE_ENDING_ZELEMIR_DEAD_320_CHAR	$MCG
$LINE_ENDING_ZELEMIR_DEAD_320_TEXT	大家都跟我来！
$LINE_ENDING_ZELEMIR_DEAD_330_CHAR	$MCG
$LINE_ENDING_ZELEMIR_DEAD_330_TEXT	去出口那里！
$LINE_ENDING_ZELEMIR_DEAD_340_CHAR	$MCG
$LINE_ENDING_ZELEMIR_DEAD_340_TEXT	所以几乎没有人跟我们逃出来……
$LINE_ENDING_ZELEMIR_DEAD_350_CHAR	$RAN
$LINE_ENDING_ZELEMIR_DEAD_350_TEXT	已经很多了，如果舍里米尔得逞的话，只有更少。
$LINE_ENDING_ZELEMIR_DEAD_360_CHAR	$MCG
$LINE_ENDING_ZELEMIR_DEAD_360_TEXT	*好多人死了……还有$HEA和$KNI。
$LINE_ENDING_ZELEMIR_DEAD_370_CHAR	$RAN
$LINE_ENDING_ZELEMIR_DEAD_370_TEXT	*你做了件勇敢的事，$MCG。
$LINE_ENDING_ZELEMIR_DEAD_380_CHAR	$RAN
$LINE_ENDING_ZELEMIR_DEAD_380_TEXT	如果你不试试，他们现在都会死。
$LINE_ENDING_ZELEMIR_DEAD_390_CHAR	$RAN
$LINE_ENDING_ZELEMIR_DEAD_390_TEXT	我们得关注当下。
$LINE_ENDING_ZELEMIR_DEAD_400_CHAR	$RAN
$LINE_ENDING_ZELEMIR_DEAD_400_TEXT	我们现在得考虑更多人了。
$LINE_ENDING_ZELEMIR_DEAD_410_CHAR	$RAN
$LINE_ENDING_ZELEMIR_DEAD_410_TEXT	我们该怎么对付他们？
$LINE_ENDING_ZELEMIR_DEAD_420_CHAR	$MAG
$LINE_ENDING_ZELEMIR_DEAD_420_TEXT	朋友，这是一段漫长的旅程。
$LINE_ENDING_ZELEMIR_DEAD_430_CHAR	$MCG
$LINE_ENDING_ZELEMIR_DEAD_430_TEXT	确实。你们确定准备好了么？
$LINE_ENDING_ZELEMIR_DEAD_440_CHAR	$MCG
$LINE_ENDING_ZELEMIR_DEAD_440_TEXT	你们只剩这么几个人了……
$LINE_ENDING_ZELEMIR_DEAD_450_CHAR	$MAG
$LINE_ENDING_ZELEMIR_DEAD_450_TEXT	我们是奎德帝国最后的残存者了。
$LINE_ENDING_ZELEMIR_DEAD_460_CHAR	$MAG
$LINE_ENDING_ZELEMIR_DEAD_460_TEXT	我们将带回光荣，否则我们应该在我们人民的尸体堆中死去。
$LINE_ENDING_ZELEMIR_DEAD_470_CHAR	$MAG
$LINE_ENDING_ZELEMIR_DEAD_470_TEXT	我们没有其他选择了。
$LINE_ENDING_ZELEMIR_DEAD_480_CHAR	$MCG
$LINE_ENDING_ZELEMIR_DEAD_480_TEXT	但是没有任何力量了……
$LINE_ENDING_ZELEMIR_DEAD_490_CHAR	$MAG
$LINE_ENDING_ZELEMIR_DEAD_490_TEXT	我很高兴能够摆脱冰霜……尽管这感觉……很奇怪……这么久我已经太过习惯它了。
$LINE_ENDING_ZELEMIR_DEAD_500_CHAR	$MCG
$LINE_ENDING_ZELEMIR_DEAD_500_TEXT	是的，失去了力量，我几乎觉得自己已经不完整了。
$LINE_ENDING_ZELEMIR_DEAD_510_CHAR	$MCG
$LINE_ENDING_ZELEMIR_DEAD_510_TEXT	我想艾斯里-特诺奇的魔法已经随他而去了。
$LINE_ENDING_ZELEMIR_DEAD_520_CHAR	$MCG
$LINE_ENDING_ZELEMIR_DEAD_520_TEXT	尽管我们的身体里还残留一些。
$LINE_ENDING_ZELEMIR_DEAD_530_CHAR	$MCG
$LINE_ENDING_ZELEMIR_DEAD_530_TEXT	*我相信长老$HEA知道为什么会这样……
$LINE_ENDING_ZELEMIR_DEAD_540_CHAR	$MAG
$LINE_ENDING_ZELEMIR_DEAD_540_TEXT	*他是个伟大的人，$MCG。
$LINE_ENDING_ZELEMIR_DEAD_550_CHAR	$MAG
$LINE_ENDING_ZELEMIR_DEAD_550_TEXT	他应该在被火焰大厅被铭记。
$LINE_ENDING_ZELEMIR_DEAD_560_CHAR	$MCG
$LINE_ENDING_ZELEMIR_DEAD_560_TEXT	那么祝你旅途愉快。
$LINE_ENDING_ZELEMIR_DEAD_570_CHAR	$MAG
$LINE_ENDING_ZELEMIR_DEAD_570_TEXT	也祝福你。
$LINE_ENDING_ZELEMIR_DEAD_580_CHAR	$MCG
$LINE_ENDING_ZELEMIR_DEAD_580_TEXT	希望再见时情形会好点。
$LINE_ENDING_ZELEMIR_DEAD_590_CHAR	$RAN
$LINE_ENDING_ZELEMIR_DEAD_590_TEXT	嘿。
$LINE_ENDING_ZELEMIR_DEAD_600_CHAR	$MCG
$LINE_ENDING_ZELEMIR_DEAD_600_TEXT	你和其他诺曼人一起离开？
$LINE_ENDING_ZELEMIR_DEAD_610_CHAR	$RAN
$LINE_ENDING_ZELEMIR_DEAD_610_TEXT	不，我想我会自己走。
$LINE_ENDING_ZELEMIR_DEAD_620_CHAR	$RAN
$LINE_ENDING_ZELEMIR_DEAD_620_TEXT	我真的从没想过这么远……
$LINE_ENDING_ZELEMIR_DEAD_630_CHAR	$RAN
$LINE_ENDING_ZELEMIR_DEAD_630_TEXT	我想我会去北方……谁知道呢，或许有其他革卡人仍然在那。
$LINE_ENDING_ZELEMIR_DEAD_640_CHAR	$MCG
$LINE_ENDING_ZELEMIR_DEAD_640_TEXT	朋友，旅途愉快。
$LINE_ENDING_ZELEMIR_DEAD_650_CHAR	$RAN
$LINE_ENDING_ZELEMIR_DEAD_650_TEXT	也祝福你。
$LINE_ENDING_ZELEMIR_DEAD_660_CHAR	$DRA
$LINE_ENDING_ZELEMIR_DEAD_660_TEXT	*$MCG。
$LINE_ENDING_ZELEMIR_DEAD_670_CHAR	$MCG
$LINE_ENDING_ZELEMIR_DEAD_670_TEXT	*$DRA。
$LINE_ENDING_ZELEMIR_DEAD_680_CHAR	$DRA
$LINE_ENDING_ZELEMIR_DEAD_680_TEXT	我们已满足了彼此的需求，我们的合作就此结束了。
$LINE_ENDING_ZELEMIR_DEAD_690_CHAR	$DRA
$LINE_ENDING_ZELEMIR_DEAD_690_TEXT	或许我已经在崩塌中失去了我的宝库宝库，但是我和剩下的孩子们仍然活着……
$LINE_ENDING_ZELEMIR_DEAD_700_CHAR	$DRA
$LINE_ENDING_ZELEMIR_DEAD_700_TEXT	……这可不是什么讨价还价的事情……
$LINE_ENDING_ZELEMIR_DEAD_710_CHAR	$MCG
$LINE_ENDING_ZELEMIR_DEAD_710_TEXT	你打算去哪儿？
$LINE_ENDING_ZELEMIR_DEAD_720_CHAR	$DRA
$LINE_ENDING_ZELEMIR_DEAD_720_TEXT	一年的时间里，我已经看尽凡人所做的一切。
$LINE_ENDING_ZELEMIR_DEAD_730_CHAR	$DRA
$LINE_ENDING_ZELEMIR_DEAD_730_TEXT	我会寻找我的同类。
$LINE_ENDING_ZELEMIR_DEAD_740_CHAR	$MCG
$LINE_ENDING_ZELEMIR_DEAD_740_TEXT	那么旅途愉快。
$LINE_ENDING_ZELEMIR_DEAD_750_CHAR	$DRA
$LINE_ENDING_ZELEMIR_DEAD_750_TEXT	如果你想成为火焰师的一员，那么就去找我们吧。
$LINE_ENDING_ZELEMIR_DEAD_760_CHAR	$MCG
$LINE_ENDING_ZELEMIR_DEAD_760_TEXT	谢谢你。
$LINE_ENDING_ZELEMIR_DEAD_770_CHAR	$BER
$LINE_ENDING_ZELEMIR_DEAD_770_TEXT	哟。
$LINE_ENDING_ZELEMIR_DEAD_780_CHAR	$MCG
$LINE_ENDING_ZELEMIR_DEAD_780_TEXT	*你的计划是什么，$BER？
$LINE_ENDING_ZELEMIR_DEAD_790_CHAR	$BER
$LINE_ENDING_ZELEMIR_DEAD_790_TEXT	当然是开始另一段冒险！
$LINE_ENDING_ZELEMIR_DEAD_800_CHAR	$BER
$LINE_ENDING_ZELEMIR_DEAD_800_TEXT	我需要一些东西来让我忘记嘴巴里的味道……
$LINE_ENDING_ZELEMIR_DEAD_810_CHAR	$BER
$LINE_ENDING_ZELEMIR_DEAD_810_TEXT	所有的……牺牲的味道……
$LINE_ENDING_ZELEMIR_DEAD_820_CHAR	$BER
$LINE_ENDING_ZELEMIR_DEAD_820_TEXT	这不是我擅长的事情。
$LINE_ENDING_ZELEMIR_DEAD_830_CHAR	$BER
$LINE_ENDING_ZELEMIR_DEAD_830_TEXT	我得回到自己的家乡……
$LINE_ENDING_ZELEMIR_DEAD_840_CHAR	$BER
$LINE_ENDING_ZELEMIR_DEAD_840_TEXT	寻找宝藏！
$LINE_ENDING_ZELEMIR_DEAD_850_CHAR	$BER
$LINE_ENDING_ZELEMIR_DEAD_850_TEXT	但是我需要一个可靠的搭档……
$LINE_ENDING_ZELEMIR_DEAD_860_CHAR	$MCG
$LINE_ENDING_ZELEMIR_DEAD_860_TEXT	*……$RAN正在往北走。如果你现在出发，或许还能追上她。
$LINE_ENDING_ZELEMIR_DEAD_870_CHAR	$BER
$LINE_ENDING_ZELEMIR_DEAD_870_TEXT	太棒了！
$LINE_ENDING_ZELEMIR_DEAD_880_CHAR	$BER
$LINE_ENDING_ZELEMIR_DEAD_880_TEXT	她那里大概有好几吨宝藏我可以偷！
$LINE_ENDING_ZELEMIR_DEAD_890_CHAR	$MCG
$LINE_ENDING_ZELEMIR_DEAD_890_TEXT	我可没有——
$LINE_ENDING_ZELEMIR_DEAD_900_CHAR	$BER
$LINE_ENDING_ZELEMIR_DEAD_900_TEXT	太晚了！计划已经进行了！
$LINE_ENDING_ZELEMIR_DEAD_910_CHAR	$MCG
$LINE_ENDING_ZELEMIR_DEAD_910_TEXT	*……再见，$BER。
$LINE_ENDING_ZELEMIR_DEAD_920_CHAR	艾殊难民
$LINE_ENDING_ZELEMIR_DEAD_920_TEXT	女士，如果我们想一天之内到达，现在必须出发了。
$LINE_ENDING_ZELEMIR_DEAD_930_CHAR	$MCG
$LINE_ENDING_ZELEMIR_DEAD_930_TEXT	我知道……
$LINE_ENDING_ZELEMIR_DEAD_940_CHAR	$MCG
$LINE_ENDING_ZELEMIR_DEAD_940_TEXT	给我点时间。
$LINE_ENDING_ZELEMIR_DEAD_950_CHAR	$MCG
$LINE_ENDING_ZELEMIR_DEAD_950_TEXT	……
$SCENE_ENDING_ZELEMIR_WOUNDED_TITLE	苦乐参半的结局
$NARR_ENDING_ZELEMIR_WOUNDED_00_TEXT	我们讨论了很多天。
$NARR_ENDING_ZELEMIR_WOUNDED_10_TEXT	诺曼商队很乐意用食物交换我们的金币。
$NARR_ENDING_ZELEMIR_WOUNDED_20_TEXT	听说难民中有各种各样的领导者。
$NARR_ENDING_ZELEMIR_WOUNDED_30_TEXT	但是每个人都因为活着而高兴，因此不会争吵。
$NARR_ENDING_ZELEMIR_WOUNDED_40_TEXT	呼吸新鲜空气对我而言依旧是很奇怪的感觉。
$NARR_ENDING_ZELEMIR_WOUNDED_50_TEXT	最终所有一切都达成了一致。
$LINE_ENDING_ZELEMIR_WOUNDED_00_CHAR	$RAN
$LINE_ENDING_ZELEMIR_WOUNDED_00_TEXT	*$MCG，墓坑塌陷了！
$LINE_ENDING_ZELEMIR_WOUNDED_10_CHAR	$RAN
$LINE_ENDING_ZELEMIR_WOUNDED_10_TEXT	在这样的中途世界里，我们还能安全多久？
$LINE_ENDING_ZELEMIR_WOUNDED_20_CHAR	$MCG
$LINE_ENDING_ZELEMIR_WOUNDED_20_TEXT	不会太久——而且，如果一个巨石压到我，我们全完蛋！
$LINE_ENDING_ZELEMIR_WOUNDED_30_CHAR	$MCG
$LINE_ENDING_ZELEMIR_WOUNDED_30_TEXT	*等等！如果我把舍里米尔和$HEA送去另一个世界……
$LINE_ENDING_ZELEMIR_WOUNDED_40_CHAR	$MCG
$LINE_ENDING_ZELEMIR_WOUNDED_40_TEXT	或许我可以把我们大家……都送过去……
$LINE_ENDING_ZELEMIR_WOUNDED_50_CHAR	$RAN
$LINE_ENDING_ZELEMIR_WOUNDED_50_TEXT	什么，所有的路都通向……另一边？
$LINE_ENDING_ZELEMIR_WOUNDED_60_CHAR	$RAN
$LINE_ENDING_ZELEMIR_WOUNDED_60_TEXT	谢谢，但是我宁愿在塌陷中被压扁。
$LINE_ENDING_ZELEMIR_WOUNDED_70_CHAR	$MCG
$LINE_ENDING_ZELEMIR_WOUNDED_70_TEXT	不，是另一个方向！我可以把我们大家送出……墓坑……但仍然在我们的世界……
$LINE_ENDING_ZELEMIR_WOUNDED_80_CHAR	$RAN
$LINE_ENDING_ZELEMIR_WOUNDED_80_TEXT	好吧，你最好快点——
$LINE_ENDING_ZELEMIR_WOUNDED_90_CHAR	$RAN
$LINE_ENDING_ZELEMIR_WOUNDED_90_TEXT	——因为一切都……啊。
$LINE_ENDING_ZELEMIR_WOUNDED_100_CHAR	$RAN
$LINE_ENDING_ZELEMIR_WOUNDED_100_TEXT	*就这么做吧，$MCG！
$LINE_ENDING_ZELEMIR_WOUNDED_110_CHAR	$MCG
$LINE_ENDING_ZELEMIR_WOUNDED_110_TEXT	这里有没有人知道怎么……把四肢接上？因为我的手臂感觉像是……不再是我身体的一部分了。
$LINE_ENDING_ZELEMIR_WOUNDED_120_CHAR	$MAG
$LINE_ENDING_ZELEMIR_WOUNDED_120_TEXT	没有苦难，就没有光荣。
$LINE_ENDING_ZELEMIR_WOUNDED_121_CHAR	$MCG
$LINE_ENDING_ZELEMIR_WOUNDED_121_TEXT	……现在真的是非常、非常得光荣……
$LINE_ENDING_ZELEMIR_WOUNDED_130_CHAR	$MAG
$LINE_ENDING_ZELEMIR_WOUNDED_130_TEXT	……这样暂时应该就可以了，一会儿我们得把它吊起来再用夹板固定。
$LINE_ENDING_ZELEMIR_WOUNDED_140_CHAR	$MAG
$LINE_ENDING_ZELEMIR_WOUNDED_140_TEXT	当我在医院的时候，他们告诉我疼痛……疼痛是我们对于完美的渴望……
$LINE_ENDING_ZELEMIR_WOUNDED_150_CHAR	$MAG
$LINE_ENDING_ZELEMIR_WOUNDED_150_TEXT	...
$LINE_ENDING_ZELEMIR_WOUNDED_160_CHAR	$MCG
$LINE_ENDING_ZELEMIR_WOUNDED_160_TEXT	*$MAG？
$LINE_ENDING_ZELEMIR_WOUNDED_170_CHAR	$MAG
$LINE_ENDING_ZELEMIR_WOUNDED_170_TEXT	他死了……
$LINE_ENDING_ZELEMIR_WOUNDED_180_CHAR	$MCG
$LINE_ENDING_ZELEMIR_WOUNDED_180_TEXT	他们两个都死了。
$LINE_ENDING_ZELEMIR_WOUNDED_190_CHAR	$MAG
$LINE_ENDING_ZELEMIR_WOUNDED_190_TEXT	这是正义的……然而我感觉……
$LINE_ENDING_ZELEMIR_WOUNDED_200_CHAR	$MCG
$LINE_ENDING_ZELEMIR_WOUNDED_200_TEXT	正义必然远不及慈悲的感受。
$LINE_ENDING_ZELEMIR_WOUNDED_210_CHAR	$MAG
$LINE_ENDING_ZELEMIR_WOUNDED_210_TEXT	……
$LINE_ENDING_ZELEMIR_WOUNDED_220_CHAR	$MAG
$LINE_ENDING_ZELEMIR_WOUNDED_220_TEXT	*$MCG，我们现在该怎么对付这些人？
$LINE_ENDING_ZELEMIR_WOUNDED_230_CHAR	$MAG
$LINE_ENDING_ZELEMIR_WOUNDED_230_TEXT	有成千上万人呢。
$LINE_ENDING_ZELEMIR_WOUNDED_240_CHAR	$MAG
$LINE_ENDING_ZELEMIR_WOUNDED_240_TEXT	我们得供养整个军队。
$LINE_ENDING_ZELEMIR_WOUNDED_250_CHAR	$MAG
$LINE_ENDING_ZELEMIR_WOUNDED_250_TEXT	当地的诺曼人不会交易废铁的。
$LINE_ENDING_ZELEMIR_WOUNDED_260_CHAR	$DRA
$LINE_ENDING_ZELEMIR_WOUNDED_260_TEXT	你！人类！
$LINE_ENDING_ZELEMIR_WOUNDED_270_CHAR	$MAG
$LINE_ENDING_ZELEMIR_WOUNDED_270_TEXT	……
$LINE_ENDING_ZELEMIR_WOUNDED_280_CHAR	$DRA
$LINE_ENDING_ZELEMIR_WOUNDED_280_TEXT	我命令你把这些恶心的凡人小玩意儿拿走！
$LINE_ENDING_ZELEMIR_WOUNDED_290_CHAR	$DRA
$LINE_ENDING_ZELEMIR_WOUNDED_290_TEXT	它们闻起来向你们一样臭。
$LINE_ENDING_ZELEMIR_WOUNDED_300_CHAR	$DRA
$LINE_ENDING_ZELEMIR_WOUNDED_300_TEXT	他们在神的周围可没容身之地。
$LINE_ENDING_ZELEMIR_WOUNDED_310_CHAR	$MAG
$LINE_ENDING_ZELEMIR_WOUNDED_310_TEXT	……谢谢你……
$LINE_ENDING_ZELEMIR_WOUNDED_320_CHAR	$DRA
$LINE_ENDING_ZELEMIR_WOUNDED_320_TEXT	什么？你误会了，人类！那是命令！
$LINE_ENDING_ZELEMIR_WOUNDED_330_CHAR	$DRA
$LINE_ENDING_ZELEMIR_WOUNDED_330_TEXT	马上把这些讨厌的东西拿开！
$LINE_ENDING_ZELEMIR_WOUNDED_340_CHAR	$MCG
$LINE_ENDING_ZELEMIR_WOUNDED_340_TEXT	当然，大人。
$LINE_ENDING_ZELEMIR_WOUNDED_350_CHAR	$MCG
$LINE_ENDING_ZELEMIR_WOUNDED_350_TEXT	……那么，你现在要做什么？
$LINE_ENDING_ZELEMIR_WOUNDED_360_CHAR	$DRA
$LINE_ENDING_ZELEMIR_WOUNDED_360_TEXT	我已经受够了凡人所做的愚行。
$LINE_ENDING_ZELEMIR_WOUNDED_370_CHAR	$DRA
$LINE_ENDING_ZELEMIR_WOUNDED_370_TEXT	我要回到我的种族中去……
$LINE_ENDING_ZELEMIR_WOUNDED_380_CHAR	$DRA
$LINE_ENDING_ZELEMIR_WOUNDED_380_TEXT	我得找个伴侣教我的孩子。
$LINE_ENDING_ZELEMIR_WOUNDED_390_CHAR	$DRA
$LINE_ENDING_ZELEMIR_WOUNDED_390_TEXT	这些残废的翅膀，无法传递飞行的荣耀了。
$LINE_ENDING_ZELEMIR_WOUNDED_400_CHAR	$MAG
$LINE_ENDING_ZELEMIR_WOUNDED_400_TEXT	再见，大人。愿你永远能感觉到火焰的温暖。
$LINE_ENDING_ZELEMIR_WOUNDED_410_CHAR	$DRA
$LINE_ENDING_ZELEMIR_WOUNDED_410_TEXT	也祝福你……
$LINE_ENDING_ZELEMIR_WOUNDED_420_CHAR	$MAG
$LINE_ENDING_ZELEMIR_WOUNDED_420_TEXT	……火焰之子，我错怪你了。
$LINE_ENDING_ZELEMIR_WOUNDED_430_CHAR	$MCG
$LINE_ENDING_ZELEMIR_WOUNDED_430_TEXT	她刚刚是不是……？
$LINE_ENDING_ZELEMIR_WOUNDED_440_CHAR	$MAG
$LINE_ENDING_ZELEMIR_WOUNDED_440_TEXT	好吧，我们不会再挨饿了，那是肯定的。
$LINE_ENDING_ZELEMIR_WOUNDED_450_CHAR	$MCG
$LINE_ENDING_ZELEMIR_WOUNDED_450_TEXT	*$MAG。
$LINE_ENDING_ZELEMIR_WOUNDED_460_CHAR	$MAG
$LINE_ENDING_ZELEMIR_WOUNDED_460_TEXT	*$MCG。
$LINE_ENDING_ZELEMIR_WOUNDED_470_CHAR	$MAG
$LINE_ENDING_ZELEMIR_WOUNDED_470_TEXT	把他丢下真是太奇怪了……
$LINE_ENDING_ZELEMIR_WOUNDED_480_CHAR	$MAG
$LINE_ENDING_ZELEMIR_WOUNDED_480_TEXT	我欠他一条命。
$LINE_ENDING_ZELEMIR_WOUNDED_490_CHAR	$MAG
$LINE_ENDING_ZELEMIR_WOUNDED_490_TEXT	而现在他去世了，我永远无法偿还这份债。
$LINE_ENDING_ZELEMIR_WOUNDED_500_CHAR	$MCG
$LINE_ENDING_ZELEMIR_WOUNDED_500_TEXT	最好的偿还便是治好他造成的伤害……
$LINE_ENDING_ZELEMIR_WOUNDED_510_CHAR	$MCG
$LINE_ENDING_ZELEMIR_WOUNDED_510_TEXT	……这也是他希望的。
$LINE_ENDING_ZELEMIR_WOUNDED_520_CHAR	$MAG
$LINE_ENDING_ZELEMIR_WOUNDED_520_TEXT	哦，朋友，我们会重建城市的。
$LINE_ENDING_ZELEMIR_WOUNDED_530_CHAR	$MAG
$LINE_ENDING_ZELEMIR_WOUNDED_530_TEXT	火焰荣耀的要求可是很高的。
$LINE_ENDING_ZELEMIR_WOUNDED_540_CHAR	$MAG
$LINE_ENDING_ZELEMIR_WOUNDED_540_TEXT	我将把剩下的人带领到我们的土地，然后将荣耀带回奎德帝国。
$LINE_ENDING_ZELEMIR_WOUNDED_550_CHAR	$MCG
$LINE_ENDING_ZELEMIR_WOUNDED_550_TEXT	你失去了……力量，这没事吗？
$LINE_ENDING_ZELEMIR_WOUNDED_560_CHAR	$MAG
$LINE_ENDING_ZELEMIR_WOUNDED_560_TEXT	*$MCG，我是火的女儿！我之前可是参加过弓术和剑术的训练的。
$LINE_ENDING_ZELEMIR_WOUNDED_570_CHAR	$MAG
$LINE_ENDING_ZELEMIR_WOUNDED_570_TEXT	但是……我失去了……能力……感觉跟奇怪……但我很高兴看到我的心中已经没有冰霜了。
$LINE_ENDING_ZELEMIR_WOUNDED_580_CHAR	$MAG
$LINE_ENDING_ZELEMIR_WOUNDED_580_TEXT	那你自己怎么办？
$LINE_ENDING_ZELEMIR_WOUNDED_590_CHAR	$MCG
$LINE_ENDING_ZELEMIR_WOUNDED_590_TEXT	失去了力量……我几乎觉得自己已经不完整了。
$LINE_ENDING_ZELEMIR_WOUNDED_600_CHAR	$MCG
$LINE_ENDING_ZELEMIR_WOUNDED_600_TEXT	但是……再次做回自己还是很不错的。
$LINE_ENDING_ZELEMIR_WOUNDED_610_CHAR	$MCG
$LINE_ENDING_ZELEMIR_WOUNDED_610_TEXT	我想艾斯里-特诺奇的魔法已经随他而去了。
$LINE_ENDING_ZELEMIR_WOUNDED_620_CHAR	$MCG
$LINE_ENDING_ZELEMIR_WOUNDED_620_TEXT	尽管我们的身体里还残留一些。
$LINE_ENDING_ZELEMIR_WOUNDED_630_CHAR	$MCG
$LINE_ENDING_ZELEMIR_WOUNDED_630_TEXT	*我相信长老$HEA知道为什么会这样……
$LINE_ENDING_ZELEMIR_WOUNDED_640_CHAR	$MAG
$LINE_ENDING_ZELEMIR_WOUNDED_640_TEXT	*他是个伟大的人，$MCG。
$LINE_ENDING_ZELEMIR_WOUNDED_650_CHAR	$MAG
$LINE_ENDING_ZELEMIR_WOUNDED_650_TEXT	他应该在被火焰大厅被铭记。
$LINE_ENDING_ZELEMIR_WOUNDED_660_CHAR	$MCG
$LINE_ENDING_ZELEMIR_WOUNDED_660_TEXT	希望你所有的努力都能有好的结果。
$LINE_ENDING_ZELEMIR_WOUNDED_670_CHAR	$MAG
$LINE_ENDING_ZELEMIR_WOUNDED_670_TEXT	也祝愿你，火焰之友。
$LINE_ENDING_ZELEMIR_WOUNDED_680_CHAR	$MAG
$LINE_ENDING_ZELEMIR_WOUNDED_680_TEXT	我将永远记住我的恩人们……
$LINE_ENDING_ZELEMIR_WOUNDED_690_CHAR	$MAG
$LINE_ENDING_ZELEMIR_WOUNDED_690_TEXT	希望还能再见。
$LINE_ENDING_ZELEMIR_WOUNDED_700_CHAR	$MCG
$LINE_ENDING_ZELEMIR_WOUNDED_700_TEXT	再见！
$LINE_ENDING_ZELEMIR_WOUNDED_710_CHAR	$BER
$LINE_ENDING_ZELEMIR_WOUNDED_710_TEXT	哟。
$LINE_ENDING_ZELEMIR_WOUNDED_720_CHAR	$MCG
$LINE_ENDING_ZELEMIR_WOUNDED_720_TEXT	*所以你的计划是什么，$BER？
$LINE_ENDING_ZELEMIR_WOUNDED_730_CHAR	$MCG
$LINE_ENDING_ZELEMIR_WOUNDED_730_TEXT	你会和我们一起回到艾殊么？
$LINE_ENDING_ZELEMIR_WOUNDED_740_CHAR	$BER
$LINE_ENDING_ZELEMIR_WOUNDED_740_TEXT	不，我有些事情必须先照顾一下……
$LINE_ENDING_ZELEMIR_WOUNDED_750_CHAR	$BER
$LINE_ENDING_ZELEMIR_WOUNDED_750_TEXT	*$HEA是个伟人……
$LINE_ENDING_ZELEMIR_WOUNDED_760_CHAR	$MCG
$LINE_ENDING_ZELEMIR_WOUNDED_760_TEXT	是的，他是的。
$LINE_ENDING_ZELEMIR_WOUNDED_770_CHAR	$BER
$LINE_ENDING_ZELEMIR_WOUNDED_770_TEXT	我得以传统的方式……纪念他……的离去。
$LINE_ENDING_ZELEMIR_WOUNDED_780_CHAR	$MCG
$LINE_ENDING_ZELEMIR_WOUNDED_780_TEXT	传统方式？
$LINE_ENDING_ZELEMIR_WOUNDED_790_CHAR	$BER
$LINE_ENDING_ZELEMIR_WOUNDED_790_TEXT	杀死一堆东西。喝得烂醉如泥。杀死更多东西。
$LINE_ENDING_ZELEMIR_WOUNDED_800_CHAR	$BER
$LINE_ENDING_ZELEMIR_WOUNDED_800_TEXT	脱光衣服。把自己涂成蓝色。杀死更多东西。
$LINE_ENDING_ZELEMIR_WOUNDED_810_CHAR	$MCG
$LINE_ENDING_ZELEMIR_WOUNDED_810_TEXT	呃……这个，我不觉得他想要这个。
$LINE_ENDING_ZELEMIR_WOUNDED_820_CHAR	$BER
$LINE_ENDING_ZELEMIR_WOUNDED_820_TEXT	我说过他曾是个伟人，但我没说他总是对的！
$LINE_ENDING_ZELEMIR_WOUNDED_830_CHAR	$BER
$LINE_ENDING_ZELEMIR_WOUNDED_830_TEXT	现在，来点暴力吧！
$LINE_ENDING_ZELEMIR_WOUNDED_840_CHAR	$MCG
$LINE_ENDING_ZELEMIR_WOUNDED_840_TEXT	我想我几乎已经开始想念他了。
$LINE_ENDING_ZELEMIR_WOUNDED_850_CHAR	$RAN
$LINE_ENDING_ZELEMIR_WOUNDED_850_TEXT	喂。
$LINE_ENDING_ZELEMIR_WOUNDED_860_CHAR	$MCG
$LINE_ENDING_ZELEMIR_WOUNDED_860_TEXT	喂。我以为你和诺曼人一起走了？
$LINE_ENDING_ZELEMIR_WOUNDED_870_CHAR	$RAN
$LINE_ENDING_ZELEMIR_WOUNDED_870_TEXT	不……我还是决定不去了。
$LINE_ENDING_ZELEMIR_WOUNDED_880_CHAR	$RAN
$LINE_ENDING_ZELEMIR_WOUNDED_880_TEXT	我只是……
$LINE_ENDING_ZELEMIR_WOUNDED_890_CHAR	$RAN
$LINE_ENDING_ZELEMIR_WOUNDED_890_TEXT	世界大着呢。
$LINE_ENDING_ZELEMIR_WOUNDED_900_CHAR	$RAN
$LINE_ENDING_ZELEMIR_WOUNDED_900_TEXT	或许有其他革卡人还活着。
$LINE_ENDING_ZELEMIR_WOUNDED_910_CHAR	$RAN
$LINE_ENDING_ZELEMIR_WOUNDED_910_TEXT	如果是这样，那他们肯定需要一切帮助。
$LINE_ENDING_ZELEMIR_WOUNDED_920_CHAR	$RAN
$LINE_ENDING_ZELEMIR_WOUNDED_920_TEXT	或者我只是要，你知道的，去游荡一会儿。
$LINE_ENDING_ZELEMIR_WOUNDED_930_CHAR	$MCG
$LINE_ENDING_ZELEMIR_WOUNDED_930_TEXT	*……我想$BER正在寻求冒险。
$LINE_ENDING_ZELEMIR_WOUNDED_940_CHAR	$RAN
$LINE_ENDING_ZELEMIR_WOUNDED_940_TEXT	真的么？他……呃……
$LINE_ENDING_ZELEMIR_WOUNDED_950_CHAR	$RAN
$LINE_ENDING_ZELEMIR_WOUNDED_950_TEXT	他是是个还可以接受的战友。
$LINE_ENDING_ZELEMIR_WOUNDED_960_CHAR	$RAN
$LINE_ENDING_ZELEMIR_WOUNDED_960_TEXT	而且他还欠我钱……
$LINE_ENDING_ZELEMIR_WOUNDED_970_CHAR	$MCG
$LINE_ENDING_ZELEMIR_WOUNDED_970_TEXT	他向那边去了。
$LINE_ENDING_ZELEMIR_WOUNDED_980_CHAR	$RAN
$LINE_ENDING_ZELEMIR_WOUNDED_980_TEXT	*谢谢你，$MCG。
$LINE_ENDING_ZELEMIR_WOUNDED_990_CHAR	$MCG
$LINE_ENDING_ZELEMIR_WOUNDED_990_TEXT	随时找我。
$LINE_ENDING_ZELEMIR_WOUNDED_1000_CHAR	$KNI
$LINE_ENDING_ZELEMIR_WOUNDED_1000_TEXT	女士。
$LINE_ENDING_ZELEMIR_WOUNDED_1010_CHAR	$MCG
$LINE_ENDING_ZELEMIR_WOUNDED_1010_TEXT	*$KNI。
$LINE_ENDING_ZELEMIR_WOUNDED_1020_CHAR	$KNI
$LINE_ENDING_ZELEMIR_WOUNDED_1020_TEXT	艾殊难民准备好随时跟你离开。
$LINE_ENDING_ZELEMIR_WOUNDED_1030_CHAR	$MCG
$LINE_ENDING_ZELEMIR_WOUNDED_1030_TEXT	*你呢，$KNI？你想回到首都么？
$LINE_ENDING_ZELEMIR_WOUNDED_1040_CHAR	$KNI
$LINE_ENDING_ZELEMIR_WOUNDED_1040_TEXT	这是我的子民。而且，我的债务依然束缚着我，女士。
$LINE_ENDING_ZELEMIR_WOUNDED_1050_CHAR	$KNI
$LINE_ENDING_ZELEMIR_WOUNDED_1050_TEXT	我会一直陪着你，直到我偿清债务。
$LINE_ENDING_ZELEMIR_WOUNDED_1060_CHAR	$MCG
$LINE_ENDING_ZELEMIR_WOUNDED_1060_TEXT	朋友，你的债务已经偿清。我会遵守诺言，还你自由。
$LINE_ENDING_ZELEMIR_WOUNDED_1070_CHAR	$KNI
$LINE_ENDING_ZELEMIR_WOUNDED_1070_TEXT	那么我能以朋友的身份陪着你么？
$LINE_ENDING_ZELEMIR_WOUNDED_1080_CHAR	$MCG
$LINE_ENDING_ZELEMIR_WOUNDED_1080_TEXT	当然。这是一次漫长而又危险的旅程……我——大家都很高兴你能和我们一起。
$LINE_ENDING_ZELEMIR_WOUNDED_1090_CHAR	$KNI
$LINE_ENDING_ZELEMIR_WOUNDED_1090_TEXT	我也很高兴能和他们一起，女士。
$LINE_ENDING_ZELEMIR_WOUNDED_1100_CHAR	$MCG
$LINE_ENDING_ZELEMIR_WOUNDED_1100_TEXT	*你知道吗，你可以叫我$MCG。
$LINE_ENDING_ZELEMIR_WOUNDED_1110_CHAR	$KNI
$LINE_ENDING_ZELEMIR_WOUNDED_1110_TEXT	*好的，$MCG女士。
$LINE_ENDING_ZELEMIR_WOUNDED_1120_CHAR	$MCG
$LINE_ENDING_ZELEMIR_WOUNDED_1120_TEXT	好吧，现在再试一遍，这次去掉<LQ>女士<RQ>两个字。
$LINE_ENDING_ZELEMIR_WOUNDED_1130_CHAR	$KNI
$LINE_ENDING_ZELEMIR_WOUNDED_1130_TEXT	不要贪得无厌。
$SCENE_ENDING_ZELEMIR_UNSCATHED_TITLE	荣耀的结局
$NARR_ENDING_ZELEMIR_UNSCATHED_00_TEXT	我们讨论了很多天。
$NARR_ENDING_ZELEMIR_UNSCATHED_10_TEXT	诺曼商队很乐意用食物交换我们的金币。
$NARR_ENDING_ZELEMIR_UNSCATHED_20_TEXT	听说难民中有各种各样的领导者。
$NARR_ENDING_ZELEMIR_UNSCATHED_30_TEXT	但是每个人都因为活着而高兴，因此不会争吵。
$NARR_ENDING_ZELEMIR_UNSCATHED_40_TEXT	呼吸新鲜空气对我而言依旧是很奇怪的感觉。
$NARR_ENDING_ZELEMIR_UNSCATHED_50_TEXT	最终所有一切都达成了一致。
$LINE_ENDING_ZELEMIR_UNSCATHED_00_CHAR	$RAN
$LINE_ENDING_ZELEMIR_UNSCATHED_00_TEXT	*$MCG，墓坑塌陷了！
$LINE_ENDING_ZELEMIR_UNSCATHED_10_CHAR	$RAN
$LINE_ENDING_ZELEMIR_UNSCATHED_10_TEXT	在这样的中途世界里，我们还能安全多久？
$LINE_ENDING_ZELEMIR_UNSCATHED_20_CHAR	$MCG
$LINE_ENDING_ZELEMIR_UNSCATHED_20_TEXT	不会太久——而且，如果一个巨石压到我，我们全完蛋！
$LINE_ENDING_ZELEMIR_UNSCATHED_30_CHAR	$MCG
$LINE_ENDING_ZELEMIR_UNSCATHED_30_TEXT	*等等！如果我把舍里米尔和$HEA送去另一个世界……
$LINE_ENDING_ZELEMIR_UNSCATHED_40_CHAR	$MCG
$LINE_ENDING_ZELEMIR_UNSCATHED_40_TEXT	或许我可以把我们大家……都送过去……
$LINE_ENDING_ZELEMIR_UNSCATHED_50_CHAR	$RAN
$LINE_ENDING_ZELEMIR_UNSCATHED_50_TEXT	什么，所有的路都通向……另一边？
$LINE_ENDING_ZELEMIR_UNSCATHED_60_CHAR	$RAN
$LINE_ENDING_ZELEMIR_UNSCATHED_60_TEXT	谢谢，但是我宁愿在塌陷中被压扁。
$LINE_ENDING_ZELEMIR_UNSCATHED_70_CHAR	$MCG
$LINE_ENDING_ZELEMIR_UNSCATHED_70_TEXT	不，是另一个方向！我可以把我们大家送出……墓坑……但仍然在我们的世界……
$LINE_ENDING_ZELEMIR_UNSCATHED_80_CHAR	$RAN
$LINE_ENDING_ZELEMIR_UNSCATHED_80_TEXT	好吧，你最好快点——
$LINE_ENDING_ZELEMIR_UNSCATHED_90_CHAR	$RAN
$LINE_ENDING_ZELEMIR_UNSCATHED_90_TEXT	——因为一切都……啊。
$LINE_ENDING_ZELEMIR_UNSCATHED_100_CHAR	$RAN
$LINE_ENDING_ZELEMIR_UNSCATHED_100_TEXT	*就这么做吧，$MCG！
$LINE_ENDING_ZELEMIR_UNSCATHED_110_CHAR	$MCG
$LINE_ENDING_ZELEMIR_UNSCATHED_110_TEXT	这里有没有人知道怎么……把四肢接上？因为我的手臂感觉像是……不再是我身体的一部分了。
$LINE_ENDING_ZELEMIR_UNSCATHED_120_CHAR	$MAG
$LINE_ENDING_ZELEMIR_UNSCATHED_120_TEXT	拜托，我在十岁的时候双臂就都经历过这样的情况……但我依然依靠一系列时机正好的脚踢和我鞋头藏着的小刀，赢得了一场战斗。
$LINE_ENDING_ZELEMIR_UNSCATHED_121_CHAR	$MAG
$LINE_ENDING_ZELEMIR_UNSCATHED_121_TEXT	梆！鞋刃，弱者！打赌你一定没有看到它过来的样子！
$LINE_ENDING_ZELEMIR_UNSCATHED_122_CHAR	$MAG
$LINE_ENDING_ZELEMIR_UNSCATHED_122_TEXT	或者其实你根本没看到任何东西！你知道的……因为你正好被一个十岁的孩子用鞋子里的小刀踢飞了眼球。
$LINE_ENDING_ZELEMIR_UNSCATHED_123_CHAR	$MAG
$LINE_ENDING_ZELEMIR_UNSCATHED_123_TEXT	……
$LINE_ENDING_ZELEMIR_UNSCATHED_124_CHAR	$MAG
$LINE_ENDING_ZELEMIR_UNSCATHED_124_TEXT	……有什么问题吗？
$LINE_ENDING_ZELEMIR_UNSCATHED_125_CHAR	$MAG
$LINE_ENDING_ZELEMIR_UNSCATHED_125_TEXT	嗯，比如我的手臂还断着？
$LINE_ENDING_ZELEMIR_UNSCATHED_130_CHAR	$DRA
$LINE_ENDING_ZELEMIR_UNSCATHED_130_TEXT	对！
$LINE_ENDING_ZELEMIR_UNSCATHED_131_CHAR	$MAG
$LINE_ENDING_ZELEMIR_UNSCATHED_131_TEXT	……这样暂时应该就可以了，一会儿我们得把它吊起来再用夹板固定。
$LINE_ENDING_ZELEMIR_UNSCATHED_140_CHAR	$MAG
$LINE_ENDING_ZELEMIR_UNSCATHED_140_TEXT	*$MCG，我们现在该怎么对付这些人？
$LINE_ENDING_ZELEMIR_UNSCATHED_150_CHAR	$MAG
$LINE_ENDING_ZELEMIR_UNSCATHED_150_TEXT	有成千上万人呢。
$LINE_ENDING_ZELEMIR_UNSCATHED_160_CHAR	$MAG
$LINE_ENDING_ZELEMIR_UNSCATHED_160_TEXT	我们得供养整个军队。
$LINE_ENDING_ZELEMIR_UNSCATHED_170_CHAR	$MAG
$LINE_ENDING_ZELEMIR_UNSCATHED_170_TEXT	当地诺曼人不会交易废铁的。
$LINE_ENDING_ZELEMIR_UNSCATHED_180_CHAR	$DRA
$LINE_ENDING_ZELEMIR_UNSCATHED_180_TEXT	你！人类！
$LINE_ENDING_ZELEMIR_UNSCATHED_190_CHAR	$MAG
$LINE_ENDING_ZELEMIR_UNSCATHED_190_TEXT	……
$LINE_ENDING_ZELEMIR_UNSCATHED_200_CHAR	$DRA
$LINE_ENDING_ZELEMIR_UNSCATHED_200_TEXT	我命令你把这些恶心的凡人小玩意儿拿走！
$LINE_ENDING_ZELEMIR_UNSCATHED_210_CHAR	$DRA
$LINE_ENDING_ZELEMIR_UNSCATHED_210_TEXT	它们闻起来向你们一样臭。
$LINE_ENDING_ZELEMIR_UNSCATHED_220_CHAR	$DRA
$LINE_ENDING_ZELEMIR_UNSCATHED_220_TEXT	他们在神的周围可没容身之地。
$LINE_ENDING_ZELEMIR_UNSCATHED_230_CHAR	$MAG
$LINE_ENDING_ZELEMIR_UNSCATHED_230_TEXT	……谢谢你……
$LINE_ENDING_ZELEMIR_UNSCATHED_240_CHAR	$DRA
$LINE_ENDING_ZELEMIR_UNSCATHED_240_TEXT	什么？你误会了，人类！那是命令！
$LINE_ENDING_ZELEMIR_UNSCATHED_250_CHAR	$DRA
$LINE_ENDING_ZELEMIR_UNSCATHED_250_TEXT	马上把这些讨厌的东西拿开！
$LINE_ENDING_ZELEMIR_UNSCATHED_260_CHAR	$MCG
$LINE_ENDING_ZELEMIR_UNSCATHED_260_TEXT	当然，大人。
$LINE_ENDING_ZELEMIR_UNSCATHED_270_CHAR	$MCG
$LINE_ENDING_ZELEMIR_UNSCATHED_270_TEXT	……那么，你现在要做什么？
$LINE_ENDING_ZELEMIR_UNSCATHED_280_CHAR	$DRA
$LINE_ENDING_ZELEMIR_UNSCATHED_280_TEXT	我已经受够了凡人所做的愚行。
$LINE_ENDING_ZELEMIR_UNSCATHED_290_CHAR	$DRA
$LINE_ENDING_ZELEMIR_UNSCATHED_290_TEXT	我要回到我的种族中去……
$LINE_ENDING_ZELEMIR_UNSCATHED_300_CHAR	$DRA
$LINE_ENDING_ZELEMIR_UNSCATHED_300_TEXT	我得找个伴侣教我的孩子。
$LINE_ENDING_ZELEMIR_UNSCATHED_310_CHAR	$DRA
$LINE_ENDING_ZELEMIR_UNSCATHED_310_TEXT	这些残废的翅膀，无法传递飞行的荣耀了。
$LINE_ENDING_ZELEMIR_UNSCATHED_320_CHAR	$MAG
$LINE_ENDING_ZELEMIR_UNSCATHED_320_TEXT	再见，大人。愿你永远能感觉到火焰的温暖。
$LINE_ENDING_ZELEMIR_UNSCATHED_330_CHAR	$DRA
$LINE_ENDING_ZELEMIR_UNSCATHED_330_TEXT	也祝福你……
$LINE_ENDING_ZELEMIR_UNSCATHED_340_CHAR	$MAG
$LINE_ENDING_ZELEMIR_UNSCATHED_340_TEXT	……火焰之子，我错怪你了。
$LINE_ENDING_ZELEMIR_UNSCATHED_350_CHAR	$MCG
$LINE_ENDING_ZELEMIR_UNSCATHED_350_TEXT	她刚刚是不是……？
$LINE_ENDING_ZELEMIR_UNSCATHED_360_CHAR	$MAG
$LINE_ENDING_ZELEMIR_UNSCATHED_360_TEXT	好吧，我们不会再挨饿了，那是肯定的。
$LINE_ENDING_ZELEMIR_UNSCATHED_370_CHAR	$MCG
$LINE_ENDING_ZELEMIR_UNSCATHED_370_TEXT	长老，你愿意跟我们一起回去么？
$LINE_ENDING_ZELEMIR_UNSCATHED_380_CHAR	$HEA
$LINE_ENDING_ZELEMIR_UNSCATHED_380_TEXT	我不知道……
$LINE_ENDING_ZELEMIR_UNSCATHED_390_CHAR	$HEA
$LINE_ENDING_ZELEMIR_UNSCATHED_390_TEXT	看到这一天，可真是苦乐参半。
$LINE_ENDING_ZELEMIR_UNSCATHED_400_CHAR	$HEA
$LINE_ENDING_ZELEMIR_UNSCATHED_400_TEXT	我……我从来没打算活这么久。
$LINE_ENDING_ZELEMIR_UNSCATHED_410_CHAR	$MCG
$LINE_ENDING_ZELEMIR_UNSCATHED_410_TEXT	或许你的偿还不是一时的，而是一生。
$LINE_ENDING_ZELEMIR_UNSCATHED_420_CHAR	$HEA
$LINE_ENDING_ZELEMIR_UNSCATHED_420_TEXT	*……你拥有超越年龄的指挥，$MCG。
$LINE_ENDING_ZELEMIR_UNSCATHED_430_CHAR	$HEA
$LINE_ENDING_ZELEMIR_UNSCATHED_430_TEXT	世界仍有苦难和吵闹……
$LINE_ENDING_ZELEMIR_UNSCATHED_440_CHAR	$HEA
$LINE_ENDING_ZELEMIR_UNSCATHED_440_TEXT	同样，瑟连里也有很多机会。
$LINE_ENDING_ZELEMIR_UNSCATHED_450_CHAR	$HEA
$LINE_ENDING_ZELEMIR_UNSCATHED_450_TEXT	*但是，你怎么办，$MCG？你能回到图书馆么？
$LINE_ENDING_ZELEMIR_UNSCATHED_460_CHAR	$MCG
$LINE_ENDING_ZELEMIR_UNSCATHED_460_TEXT	我在图书馆的旧生活对于这些冒险经历而言是个很受欢迎的避难所。
$LINE_ENDING_ZELEMIR_UNSCATHED_470_CHAR	$MCG
$LINE_ENDING_ZELEMIR_UNSCATHED_470_TEXT	而且失去了我的……力量……感觉很奇怪……
$LINE_ENDING_ZELEMIR_UNSCATHED_480_CHAR	$MCG
$LINE_ENDING_ZELEMIR_UNSCATHED_480_TEXT	我很高兴能再次感觉到我自己。
$LINE_ENDING_ZELEMIR_UNSCATHED_490_CHAR	$HEA
$LINE_ENDING_ZELEMIR_UNSCATHED_490_TEXT	是的……我一直很想知道这种奇怪的能力是来自哪里。
$LINE_ENDING_ZELEMIR_UNSCATHED_500_CHAR	$HEA
$LINE_ENDING_ZELEMIR_UNSCATHED_500_TEXT	我相信当艾斯里-特诺奇试图腐化你的时候，他将自己精神的一小部分灌注到了你的体内。
$LINE_ENDING_ZELEMIR_UNSCATHED_510_CHAR	$HEA
$LINE_ENDING_ZELEMIR_UNSCATHED_510_TEXT	为了不被腐化，你使用了他的力量来对抗他。
$LINE_ENDING_ZELEMIR_UNSCATHED_520_CHAR	$HEA
$LINE_ENDING_ZELEMIR_UNSCATHED_520_TEXT	现在他死了，魔法也随他而去。
$LINE_ENDING_ZELEMIR_UNSCATHED_530_CHAR	$MCG
$LINE_ENDING_ZELEMIR_UNSCATHED_530_TEXT	感觉很奇怪，但看见它消失我也并不会觉得难过。
$LINE_ENDING_ZELEMIR_UNSCATHED_540_CHAR	$MCG
$LINE_ENDING_ZELEMIR_UNSCATHED_540_TEXT	此时此刻，简单的生活是无法想象的奢侈。
$LINE_ENDING_ZELEMIR_UNSCATHED_550_CHAR	$HEA
$LINE_ENDING_ZELEMIR_UNSCATHED_550_TEXT	愿我们都能遇见这种奢侈。
$LINE_ENDING_ZELEMIR_UNSCATHED_560_CHAR	$HEA
$LINE_ENDING_ZELEMIR_UNSCATHED_560_TEXT	但是我留你太久了。你的旅程还很长。
$LINE_ENDING_ZELEMIR_UNSCATHED_570_CHAR	$HEA
$LINE_ENDING_ZELEMIR_UNSCATHED_570_TEXT	*再见，$MCG，直到我们再次相见。
$LINE_ENDING_ZELEMIR_UNSCATHED_580_CHAR	$MCG
$LINE_ENDING_ZELEMIR_UNSCATHED_580_TEXT	长老，希望很快能再见。
$LINE_ENDING_ZELEMIR_UNSCATHED_590_CHAR	$MAG
$LINE_ENDING_ZELEMIR_UNSCATHED_590_TEXT	尊敬的长老，我欠你太多了。
$LINE_ENDING_ZELEMIR_UNSCATHED_600_CHAR	$MAG
$LINE_ENDING_ZELEMIR_UNSCATHED_600_TEXT	如果你愿意接受我的感激——
$LINE_ENDING_ZELEMIR_UNSCATHED_610_CHAR	$HEA
$LINE_ENDING_ZELEMIR_UNSCATHED_610_TEXT	*$MAG，你的子民比我更需要这个宝物。
$LINE_ENDING_ZELEMIR_UNSCATHED_620_CHAR	$MAG
$LINE_ENDING_ZELEMIR_UNSCATHED_620_TEXT	那么请接受我的邀请。当火焰大厅再次燃烧的时候，过来看看我们。
$LINE_ENDING_ZELEMIR_UNSCATHED_630_CHAR	$MAG
$LINE_ENDING_ZELEMIR_UNSCATHED_630_TEXT	或许你那种瑟林达的智慧将使宇宙之焰越燃越旺。
$LINE_ENDING_ZELEMIR_UNSCATHED_640_CHAR	$HEA
$LINE_ENDING_ZELEMIR_UNSCATHED_640_TEXT	我很荣幸，火的女儿。
$LINE_ENDING_ZELEMIR_UNSCATHED_650_CHAR	$HEA
$LINE_ENDING_ZELEMIR_UNSCATHED_650_TEXT	我现在必须走了。遵从瑟林达的道路正在召唤我去历经苦难。
$LINE_ENDING_ZELEMIR_UNSCATHED_660_CHAR	$HEA
$LINE_ENDING_ZELEMIR_UNSCATHED_660_TEXT	但是我们还会再见。
$LINE_ENDING_ZELEMIR_UNSCATHED_670_CHAR	$MAG
$LINE_ENDING_ZELEMIR_UNSCATHED_670_TEXT	再见，尊敬的长老。愿你永远能感觉到火焰的温暖。
$LINE_ENDING_ZELEMIR_UNSCATHED_680_CHAR	$MAG
$LINE_ENDING_ZELEMIR_UNSCATHED_680_TEXT	*$MCG。
$LINE_ENDING_ZELEMIR_UNSCATHED_690_CHAR	$MCG
$LINE_ENDING_ZELEMIR_UNSCATHED_690_TEXT	*$MAG。
$LINE_ENDING_ZELEMIR_UNSCATHED_700_CHAR	$MAG
$LINE_ENDING_ZELEMIR_UNSCATHED_700_TEXT	你确定没有我们你会很好？
$LINE_ENDING_ZELEMIR_UNSCATHED_710_CHAR	$MAG
$LINE_ENDING_ZELEMIR_UNSCATHED_710_TEXT	没有奎德势力，我很担心你的安全。
$LINE_ENDING_ZELEMIR_UNSCATHED_720_CHAR	$MAG
$LINE_ENDING_ZELEMIR_UNSCATHED_720_TEXT	到艾殊还有很长的路要走。
$LINE_ENDING_ZELEMIR_UNSCATHED_730_CHAR	$MAG
$LINE_ENDING_ZELEMIR_UNSCATHED_730_TEXT	土匪，狼群，或者可能是轻微的一阵风都能将你摧毁。
$LINE_ENDING_ZELEMIR_UNSCATHED_740_CHAR	$MCG
$LINE_ENDING_ZELEMIR_UNSCATHED_740_TEXT	那你怎么办？你也没有力量了。
$LINE_ENDING_ZELEMIR_UNSCATHED_750_CHAR	$MAG
$LINE_ENDING_ZELEMIR_UNSCATHED_750_TEXT	我是奎德公主，生来就手握利剑！
$LINE_ENDING_ZELEMIR_UNSCATHED_760_CHAR	$MAG
$LINE_ENDING_ZELEMIR_UNSCATHED_760_TEXT	我一直都在练习战争之术。
$LINE_ENDING_ZELEMIR_UNSCATHED_770_CHAR	$MAG
$LINE_ENDING_ZELEMIR_UNSCATHED_770_TEXT	尽管冰霜……很有用……但当看见它离开了我的心，我还是很高兴。
$LINE_ENDING_ZELEMIR_UNSCATHED_780_CHAR	$MAG
$LINE_ENDING_ZELEMIR_UNSCATHED_780_TEXT	我们将把一直以来的荣耀带回给火焰：用剑和弓和军队的力量！
$LINE_ENDING_ZELEMIR_UNSCATHED_790_CHAR	$MAG
$LINE_ENDING_ZELEMIR_UNSCATHED_790_TEXT	我和剩下的子民将回到家乡。
$LINE_ENDING_ZELEMIR_UNSCATHED_800_CHAR	$MAG
$LINE_ENDING_ZELEMIR_UNSCATHED_800_TEXT	我们会找到剩余的世界……
$LINE_ENDING_ZELEMIR_UNSCATHED_810_CHAR	$MAG
$LINE_ENDING_ZELEMIR_UNSCATHED_810_TEXT	然后在那之上，建立一个更伟大的世界。
$LINE_ENDING_ZELEMIR_UNSCATHED_820_CHAR	$MCG
$LINE_ENDING_ZELEMIR_UNSCATHED_820_TEXT	朋友，看见你丝毫未变真是高兴。
$LINE_ENDING_ZELEMIR_UNSCATHED_830_CHAR	$MCG
$LINE_ENDING_ZELEMIR_UNSCATHED_830_TEXT	希望你所有的努力都能有好的结果。
$LINE_ENDING_ZELEMIR_UNSCATHED_840_CHAR	$MAG
$LINE_ENDING_ZELEMIR_UNSCATHED_840_TEXT	也祝愿你，火焰之友。
$LINE_ENDING_ZELEMIR_UNSCATHED_850_CHAR	$MAG
$LINE_ENDING_ZELEMIR_UNSCATHED_850_TEXT	希望我们会再次相见。
$LINE_ENDING_ZELEMIR_UNSCATHED_860_CHAR	$MCG
$LINE_ENDING_ZELEMIR_UNSCATHED_860_TEXT	再见！
$LINE_ENDING_ZELEMIR_UNSCATHED_870_CHAR	$BER
$LINE_ENDING_ZELEMIR_UNSCATHED_870_TEXT	哟。
$LINE_ENDING_ZELEMIR_UNSCATHED_880_CHAR	$MCG
$LINE_ENDING_ZELEMIR_UNSCATHED_880_TEXT	*所以你的计划是什么，$BER？
$LINE_ENDING_ZELEMIR_UNSCATHED_890_CHAR	$MCG
$LINE_ENDING_ZELEMIR_UNSCATHED_890_TEXT	你会和我们一起回到艾殊吗？
$LINE_ENDING_ZELEMIR_UNSCATHED_900_CHAR	$BER
$LINE_ENDING_ZELEMIR_UNSCATHED_900_TEXT	你在开玩笑吗？过上有钱又奢侈的生活？
$LINE_ENDING_ZELEMIR_UNSCATHED_910_CHAR	$BER
$LINE_ENDING_ZELEMIR_UNSCATHED_910_TEXT	现在还不行，因为还有杀戮要进行！
$LINE_ENDING_ZELEMIR_UNSCATHED_920_CHAR	$BER
$LINE_ENDING_ZELEMIR_UNSCATHED_920_TEXT	我一直在和诺曼难民聊天，他们告诉我遥远的北边有个怪兽叫做“岩石之眼”！
$LINE_ENDING_ZELEMIR_UNSCATHED_930_CHAR	$BER
$LINE_ENDING_ZELEMIR_UNSCATHED_930_TEXT	他有大概，七个脑袋，每个脑袋上有七只眼睛！
$LINE_ENDING_ZELEMIR_UNSCATHED_940_CHAR	$BER
$LINE_ENDING_ZELEMIR_UNSCATHED_940_TEXT	我可从来没有让七个脑袋的东西身首异处过！
$LINE_ENDING_ZELEMIR_UNSCATHED_950_CHAR	$BER
$LINE_ENDING_ZELEMIR_UNSCATHED_950_TEXT	而且，那之后我可以向东走，把血腥邪教徒打得屁滚尿流！
$LINE_ENDING_ZELEMIR_UNSCATHED_960_CHAR	$BER
$LINE_ENDING_ZELEMIR_UNSCATHED_960_TEXT	我只需要三个以上的浴血的斗篷来完成我的……
$LINE_ENDING_ZELEMIR_UNSCATHED_970_CHAR	$BER
$LINE_ENDING_ZELEMIR_UNSCATHED_970_TEXT	……史诗暴力头巾！
$LINE_ENDING_ZELEMIR_UNSCATHED_980_CHAR	$MCG
$LINE_ENDING_ZELEMIR_UNSCATHED_980_TEXT	看到你有个计划，我很高兴。
$LINE_ENDING_ZELEMIR_UNSCATHED_990_CHAR	$BER
$LINE_ENDING_ZELEMIR_UNSCATHED_990_TEXT	但是看看我，在这个世界随时都可能发生暴力的时候还在聊天！
$LINE_ENDING_ZELEMIR_UNSCATHED_1000_CHAR	$MCG
$LINE_ENDING_ZELEMIR_UNSCATHED_1000_TEXT	保持联系！
$LINE_ENDING_ZELEMIR_UNSCATHED_1010_CHAR	$MCG
$LINE_ENDING_ZELEMIR_UNSCATHED_1010_TEXT	我想我几乎已经开始想念他了。
$LINE_ENDING_ZELEMIR_UNSCATHED_1020_CHAR	$RAN
$LINE_ENDING_ZELEMIR_UNSCATHED_1020_TEXT	嘿。
$LINE_ENDING_ZELEMIR_UNSCATHED_1030_CHAR	$MCG
$LINE_ENDING_ZELEMIR_UNSCATHED_1030_TEXT	嘿。我以为你和诺曼人一起走了呢？
$LINE_ENDING_ZELEMIR_UNSCATHED_1040_CHAR	$RAN
$LINE_ENDING_ZELEMIR_UNSCATHED_1040_TEXT	不……我还是决定不去了。
$LINE_ENDING_ZELEMIR_UNSCATHED_1050_CHAR	$RAN
$LINE_ENDING_ZELEMIR_UNSCATHED_1050_TEXT	我只是……
$LINE_ENDING_ZELEMIR_UNSCATHED_1060_CHAR	$RAN
$LINE_ENDING_ZELEMIR_UNSCATHED_1060_TEXT	世界大着呢。
$LINE_ENDING_ZELEMIR_UNSCATHED_1070_CHAR	$RAN
$LINE_ENDING_ZELEMIR_UNSCATHED_1070_TEXT	或许有其他革卡人还活着。
$LINE_ENDING_ZELEMIR_UNSCATHED_1080_CHAR	$RAN
$LINE_ENDING_ZELEMIR_UNSCATHED_1080_TEXT	如果是这样，那他们肯定需要一切帮助。
$LINE_ENDING_ZELEMIR_UNSCATHED_1090_CHAR	$RAN
$LINE_ENDING_ZELEMIR_UNSCATHED_1090_TEXT	或者我只是要，你知道的，去游荡一会儿。
$LINE_ENDING_ZELEMIR_UNSCATHED_1100_CHAR	$MCG
$LINE_ENDING_ZELEMIR_UNSCATHED_1100_TEXT	*……我想$BER正在寻求冒险。
$LINE_ENDING_ZELEMIR_UNSCATHED_1110_CHAR	$RAN
$LINE_ENDING_ZELEMIR_UNSCATHED_1110_TEXT	真的么？他……呃……
$LINE_ENDING_ZELEMIR_UNSCATHED_1120_CHAR	$RAN
$LINE_ENDING_ZELEMIR_UNSCATHED_1120_TEXT	他是是个还可以接受的战友。
$LINE_ENDING_ZELEMIR_UNSCATHED_1130_CHAR	$RAN
$LINE_ENDING_ZELEMIR_UNSCATHED_1130_TEXT	而且他还欠我钱……
$LINE_ENDING_ZELEMIR_UNSCATHED_1140_CHAR	$MCG
$LINE_ENDING_ZELEMIR_UNSCATHED_1140_TEXT	他向那边去了。
$LINE_ENDING_ZELEMIR_UNSCATHED_1150_CHAR	$RAN
$LINE_ENDING_ZELEMIR_UNSCATHED_1150_TEXT	*谢谢你，$MCG。
$LINE_ENDING_ZELEMIR_UNSCATHED_1160_CHAR	$MCG
$LINE_ENDING_ZELEMIR_UNSCATHED_1160_TEXT	随时找我。
$LINE_ENDING_ZELEMIR_UNSCATHED_1170_CHAR	$KNI
$LINE_ENDING_ZELEMIR_UNSCATHED_1170_TEXT	女士。
$LINE_ENDING_ZELEMIR_UNSCATHED_1180_CHAR	$MCG
$LINE_ENDING_ZELEMIR_UNSCATHED_1180_TEXT	*$KNI。
$LINE_ENDING_ZELEMIR_UNSCATHED_1190_CHAR	$KNI
$LINE_ENDING_ZELEMIR_UNSCATHED_1190_TEXT	艾殊难民准备好随时跟你离开。
$LINE_ENDING_ZELEMIR_UNSCATHED_1200_CHAR	$MCG
$LINE_ENDING_ZELEMIR_UNSCATHED_1200_TEXT	*你呢，$KNI？你想回到首都么？
$LINE_ENDING_ZELEMIR_UNSCATHED_1210_CHAR	$KNI
$LINE_ENDING_ZELEMIR_UNSCATHED_1210_TEXT	这是我的子民。而且，我的债务依然束缚着我，女士。
$LINE_ENDING_ZELEMIR_UNSCATHED_1220_CHAR	$KNI
$LINE_ENDING_ZELEMIR_UNSCATHED_1220_TEXT	我会一直陪着你，直到我偿清债务。
$LINE_ENDING_ZELEMIR_UNSCATHED_1230_CHAR	$MCG
$LINE_ENDING_ZELEMIR_UNSCATHED_1230_TEXT	朋友，你的债务已经偿清。我会遵守诺言，还你自由。
$LINE_ENDING_ZELEMIR_UNSCATHED_1240_CHAR	$KNI
$LINE_ENDING_ZELEMIR_UNSCATHED_1240_TEXT	那么我能以朋友的身份陪着你么？
$LINE_ENDING_ZELEMIR_UNSCATHED_1250_CHAR	$MCG
$LINE_ENDING_ZELEMIR_UNSCATHED_1250_TEXT	这一路上会有很多危险。我很——我们都很高兴你能跟我们一起。
$LINE_ENDING_ZELEMIR_UNSCATHED_1260_CHAR	$KNI
$LINE_ENDING_ZELEMIR_UNSCATHED_1260_TEXT	我也很高兴和他们一起。
$LINE_ENDING_ZELEMIR_UNSCATHED_1270_CHAR	$KNI
$LINE_ENDING_ZELEMIR_UNSCATHED_1270_TEXT	你知道的……
$LINE_ENDING_ZELEMIR_UNSCATHED_1280_CHAR	$KNI
$LINE_ENDING_ZELEMIR_UNSCATHED_1280_TEXT	……路上没有人想着要杀我们，可真的是很奇怪又好无聊。
$LINE_ENDING_ZELEMIR_UNSCATHED_1290_CHAR	$MCG
$LINE_ENDING_ZELEMIR_UNSCATHED_1290_TEXT	好吧，我敢打赌<LQ>醉虎<RQ>歌可以用来消磨时间了……
$LINE_ENDING_ZELEMIR_UNSCATHED_1300_CHAR	$KNI
$LINE_ENDING_ZELEMIR_UNSCATHED_1300_TEXT	想法很不错，但是我既然现在不再负债于你，那么就不需要再听从这些愚蠢的建议了，我恐怕我会很忙。
$LINE_ENDING_ZELEMIR_UNSCATHED_1310_CHAR	$MCG
$LINE_ENDING_ZELEMIR_UNSCATHED_1310_TEXT	真的吗？因为我有一大堆愚蠢的建议呢。
$LINE_ENDING_ZELEMIR_UNSCATHED_1320_CHAR	$MCG
$LINE_ENDING_ZELEMIR_UNSCATHED_1320_TEXT	鉴于我们不喜欢听醉虎歌，我也不得不重温一下，自娱自乐了。
$LINE_ENDING_ZELEMIR_UNSCATHED_1330_CHAR	$MCG
$LINE_ENDING_ZELEMIR_UNSCATHED_1330_TEXT	一：不要穿紫色裙子。之前我是穿的紫色裙子，比你穿的好看。
$LINE_ENDING_ZELEMIR_UNSCATHED_1340_CHAR	$KNI
$LINE_ENDING_ZELEMIR_UNSCATHED_1340_TEXT	嘿！
$LINE_ENDING_ZELEMIR_UNSCATHED_1350_CHAR	$MCG
$LINE_ENDING_ZELEMIR_UNSCATHED_1350_TEXT	二：把蜜袋鼯放在两鬓，因为，嘿，谁不喜欢蜜袋鼯？他们可以攻击任何一个激怒自己的人。
$LINE_ENDING_ZELEMIR_UNSCATHED_1360_CHAR	$MCG
$LINE_ENDING_ZELEMIR_UNSCATHED_1360_TEXT	三：为蜜袋鼯的左右手起名字，但是将其放在两鬓的相反方向以混淆敌人。
$LINE_ENDING_ZELEMIR_UNSCATHED_1370_CHAR	$KNI
$LINE_ENDING_ZELEMIR_UNSCATHED_1370_TEXT	*你在$BER身边待太久了。
$LINE_ENDING_ZELEMIR_UNSCATHED_1380_CHAR	$MCG
$LINE_ENDING_ZELEMIR_UNSCATHED_1380_TEXT	顺便说一句，我已经有几百首这样的歌呢，去艾殊还有很长的路要走。
$LINE_ENDING_ZELEMIR_UNSCATHED_1390_CHAR	$KNI
$LINE_ENDING_ZELEMIR_UNSCATHED_1390_TEXT	……
$LINE_ENDING_ZELEMIR_UNSCATHED_1400_CHAR	$KNI
$LINE_ENDING_ZELEMIR_UNSCATHED_1400_TEXT	“啊，我是一只醉醉虎……”
$LINE_ENDING_ZELEMIR_UNSCATHED_1410_CHAR	$MCG
$LINE_ENDING_ZELEMIR_UNSCATHED_1410_TEXT	好了，现在开始单脚并且用假声！
$SCENE_EPILOGUE_TITLE	秘密尾声
$LINE_EPILOGUE_00_CHAR	$KNI
$LINE_EPILOGUE_00_TEXT	……<LQ>醉虎<RQ>歌就是这样的。
$LINE_EPILOGUE_10_CHAR	$MCG
$LINE_EPILOGUE_10_TEXT	真令人印象深刻……我都不知道你的音域……如此之广……
$LINE_EPILOGUE_20_CHAR	$MCG
$LINE_EPILOGUE_20_TEXT	我是说，我想我是无法唱出这样的高音的。
$LINE_EPILOGUE_30_CHAR	$KNI
$LINE_EPILOGUE_30_TEXT	这是成为太监的好处之一。
$LINE_EPILOGUE_40_CHAR	$MCG
$LINE_EPILOGUE_40_TEXT	什么？！
$LINE_EPILOGUE_50_CHAR	$KNI
$LINE_EPILOGUE_50_TEXT	只是吓唬吓唬你。
$LINE_EPILOGUE_60_CHAR	$MCG
$LINE_EPILOGUE_60_TEXT	哇……这真的……有很多事我得重新想想……
$LINE_EPILOGUE_70_CHAR	$KNI
$LINE_EPILOGUE_70_TEXT	想哪些——
$LINE_EPILOGUE_80_CHAR	$BER
$LINE_EPILOGUE_80_TEXT	哟！
$LINE_EPILOGUE_90_CHAR	$MCG
$LINE_EPILOGUE_90_TEXT	*$BER？$RAN？你们在这里干什么？
$LINE_EPILOGUE_100_CHAR	$BER
$LINE_EPILOGUE_100_TEXT	好吧，最终证明<LQ>岩石之眼<RQ>是个容易控制的家伙！一击便可杀了他！
$LINE_EPILOGUE_110_CHAR	$RAN
$LINE_EPILOGUE_110_TEXT	拿上这个，他就只有五个脑袋了！
$LINE_EPILOGUE_120_CHAR	$BER
$LINE_EPILOGUE_120_TEXT	我知道！我感觉上当受骗了！
$LINE_EPILOGUE_130_CHAR	$RAN
$LINE_EPILOGUE_130_TEXT	不管怎样，我们对着一些邪教徒欢呼起来了——
$LINE_EPILOGUE_140_CHAR	$BER
$LINE_EPILOGUE_140_TEXT	伙计，这些家伙现在一定很难过！
$LINE_EPILOGUE_150_CHAR	$RAN
$LINE_EPILOGUE_150_TEXT	——但是我们听说宝石是<LQ>龙眼<RQ>。一些食人魔把它锁在满是巨蛇的塔里。
$LINE_EPILOGUE_160_CHAR	$BER
$LINE_EPILOGUE_160_TEXT	拿上这个，食人魔有七个……
$LINE_EPILOGUE_170_CHAR	$RAN
$LINE_EPILOGUE_170_TEXT	他们不想知道那些！
$LINE_EPILOGUE_180_CHAR	$BER
$LINE_EPILOGUE_180_TEXT	我只是说，它会弄些奇怪的战利品。
$LINE_EPILOGUE_190_CHAR	$RAN
$LINE_EPILOGUE_190_TEXT	不管怎样，我们就是恰好经过，觉得应该过来打声招呼。
$LINE_EPILOGUE_200_CHAR	$MCG
$LINE_EPILOGUE_200_TEXT	……只过了四天……
$LINE_EPILOGUE_210_CHAR	$BER
$LINE_EPILOGUE_210_TEXT	哦，这倒提醒我了，当你到达艾殊时，你能把这封信给我爸爸吗？
$LINE_EPILOGUE_220_CHAR	$BER
$LINE_EPILOGUE_220_TEXT	他以为我还在北方的城里学习呢，所以别说墓坑的事。
$LINE_EPILOGUE_230_CHAR	$BER
$LINE_EPILOGUE_230_TEXT	他要是知道了，可能会很生气，然后流放别人什么的。
$LINE_EPILOGUE_240_CHAR	$KNI
$LINE_EPILOGUE_240_TEXT	流放？
$LINE_EPILOGUE_250_CHAR	$MCG
$LINE_EPILOGUE_250_TEXT	你爸爸是谁？
$LINE_EPILOGUE_260_CHAR	$BER
$LINE_EPILOGUE_260_TEXT	哦，摄政王。
$LINE_EPILOGUE_270_CHAR	$RAN
$LINE_EPILOGUE_270_TEXT	真的？你们都不知道？
$LINE_EPILOGUE_280_CHAR	$BER
$LINE_EPILOGUE_280_TEXT	伙计，我真的很高兴在我能接管之前太子已经适龄了。光是想象一下要管理一个国家，我的脑袋就要爆炸了……
$LINE_EPILOGUE_281_CHAR	$BER
$LINE_EPILOGUE_281_CHAR	那有什么意思啊？我更愿意把别人的脑袋弄爆炸！
$LINE_EPILOGUE_290_CHAR	$RAN
$LINE_EPILOGUE_290_TEXT	别告诉他们我们走哪条路，好吗？
$LINE_EPILOGUE_300_CHAR	$BER
$LINE_EPILOGUE_300_TEXT	好吧，聊得不错，但是我们必须从食人魔那里弄个战利品——
$LINE_EPILOGUE_310_CHAR	$RAN
$LINE_EPILOGUE_310_TEXT	他们不想知道那些！
$LINE_EPILOGUE_320_CHAR	$BER
$LINE_EPILOGUE_320_TEXT	现在前进吧！来点暴力！
$LINE_EPILOGUE_330_CHAR	$KNI
$LINE_EPILOGUE_330_TEXT	……
$LINE_EPILOGUE_340_CHAR	$MCG
$LINE_EPILOGUE_340_TEXT	我完全同意。
$SCENE_SIDEQUEST_1_GET_TITLE	你疯了么？
$LINE_SIDEQUEST_1_GET_00_CHAR	$RAN
$LINE_SIDEQUEST_1_GET_00_TEXT	*嘿，$MCG！这个肮脏的卡莱斯卡人不会卖东西给我们的。
$LINE_SIDEQUEST_1_GET_10_CHAR	$RAN
$LINE_SIDEQUEST_1_GET_10_TEXT	你要是问我，我就会说，他是在妒忌革卡人天生的优越性。
$LINE_SIDEQUEST_1_GET_20_CHAR	$MCG
$LINE_SIDEQUEST_1_GET_20_TEXT	额……除了你，我们其他人都不是革卡人……
$LINE_SIDEQUEST_1_GET_30_CHAR	$RAN
$LINE_SIDEQUEST_1_GET_30_TEXT	大概在五分钟前，我已经让你成为名誉会员。
$LINE_SIDEQUEST_1_GET_40_CHAR	$RAN
$LINE_SIDEQUEST_1_GET_40_TEXT	所以，我的革卡姐妹，你能使用疯狂的瘟疫魔法，融化他的脸什么的吗？
$LINE_SIDEQUEST_1_GET_50_CHAR	$MCG
$LINE_SIDEQUEST_1_GET_50_TEXT	我不想融化任何人的脸。
$LINE_SIDEQUEST_1_GET_60_CHAR	$MCG
$LINE_SIDEQUEST_1_GET_60_TEXT	一，我甚至不知道该怎么使用；二，你到底有什么毛病？
$LINE_SIDEQUEST_1_GET_70_CHAR	$RAN
$LINE_SIDEQUEST_1_GET_70_TEXT	他是卡莱斯卡部落的，如果我们不管他，我们九十在唾弃四百年的世仇传统。
$LINE_SIDEQUEST_1_GET_80_CHAR	$BER
$LINE_SIDEQUEST_1_GET_80_TEXT	有人说要融化脸么？
$LINE_SIDEQUEST_1_GET_90_CHAR	$BER
$LINE_SIDEQUEST_1_GET_90_TEXT	给我目标！我将只会注意到我闪闪发光的腹肌和……
$LINE_SIDEQUEST_1_GET_100_CHAR	$BER
$LINE_SIDEQUEST_1_GET_100_TEXT	看啊……我能看到他已经很虚弱了。
$LINE_SIDEQUEST_1_GET_110_CHAR	$RAN
$LINE_SIDEQUEST_1_GET_110_TEXT	……好吧，所以计划二：你引诱他，使他分心，然后我潜入进去尽可能多的偷些东西。
$LINE_SIDEQUEST_1_GET_120_CHAR	$MCG
$LINE_SIDEQUEST_1_GET_120_TEXT	什么？不。呃。
$LINE_SIDEQUEST_1_GET_130_CHAR	$RAN
$LINE_SIDEQUEST_1_GET_130_TEXT	你说的对，你应该干些更漂亮的工作。
$LINE_SIDEQUEST_1_GET_140_CHAR	$RAN
$LINE_SIDEQUEST_1_GET_140_TEXT	好吧，计划三：趁没人注意的时候杀了他。
$LINE_SIDEQUEST_1_GET_150_CHAR	$MCG
$LINE_SIDEQUEST_1_GET_150_TEXT	难道你不能告诉他我们是来解放大家的吗？
$LINE_SIDEQUEST_1_GET_160_CHAR	$RAN
$LINE_SIDEQUEST_1_GET_160_TEXT	啊，我试过了。他只是一直在说监狱下面的墓穴里被困住的那些孩子。
$LINE_SIDEQUEST_1_GET_170_CHAR	$RAN
$LINE_SIDEQUEST_1_GET_170_TEXT	看吧，我们没有别的理由了，让我们杀了这个卡莱斯卡傻瓜吧。
$LINE_SIDEQUEST_1_GET_180_CHAR	$MCG
$LINE_SIDEQUEST_1_GET_180_TEXT	有孩子被困监狱下面？
$LINE_SIDEQUEST_1_GET_190_CHAR	$RAN
$LINE_SIDEQUEST_1_GET_190_TEXT	是的，很恐怖，但现在关键的是杀了这个卑鄙小人，让我们得到他的那些好东西。
$LINE_SIDEQUEST_1_GET_200_CHAR	$MCG
$LINE_SIDEQUEST_1_GET_200_TEXT	……
$LINE_SIDEQUEST_1_GET_210_CHAR	$RAN
$LINE_SIDEQUEST_1_GET_210_TEXT	嘿！等等！你不能就这样轻易地逃离世仇！
$LINE_SIDEQUEST_1_GET_220_CHAR	$MCG
$LINE_SIDEQUEST_1_GET_220_TEXT	如果你想，你完全可以做个完美的小偷，但是我打算去救孩子们。
$LINE_SIDEQUEST_1_GET_230_CHAR	$RAN
$LINE_SIDEQUEST_1_GET_230_TEXT	你疯了么？奥斯蒙的亡者正在追我们呢！
$LINE_SIDEQUEST_1_GET_240_CHAR	$MCG
$LINE_SIDEQUEST_1_GET_240_TEXT	但是我们回到监狱是他们做梦也不会想到的。
$LINE_SIDEQUEST_1_GET_250_CHAR	$RAN
$LINE_SIDEQUEST_1_GET_250_TEXT	是啊 ，因为那太蠢了！
$LINE_SIDEQUEST_1_GET_260_CHAR	$MCG
$LINE_SIDEQUEST_1_GET_260_TEXT	那么待这别动。
$LINE_SIDEQUEST_1_GET_270_CHAR	$RAN
$LINE_SIDEQUEST_1_GET_270_TEXT	什么？你是我的逃跑计划，我不会让你离开我的视线！
$LINE_SIDEQUEST_1_GET_280_CHAR	$RAN
$LINE_SIDEQUEST_1_GET_280_TEXT	……我要抱怨这条路上的每一步。
$SCENE_SIDEQUEST_1_INTRO_TITLE	火中的手
$LINE_SIDEQUEST_1_INTRO_00_CHAR	$RAN
$LINE_SIDEQUEST_1_INTRO_00_TEXT	啊，看，我们刚刚就是从那间充满僵尸的牢房里逃出来的！
$LINE_SIDEQUEST_1_INTRO_10_CHAR	$RAN
$LINE_SIDEQUEST_1_INTRO_10_TEXT	好的，那么让我来把事情搞清楚：我们刚刚把手从火中拿出来了……
$LINE_SIDEQUEST_1_INTRO_20_CHAR	$RAN
$LINE_SIDEQUEST_1_INTRO_20_TEXT	 而我们现在就像是<LQ>喔，看，有亮闪闪的东西！让我们再把手神回去吧！<RQ>
$LINE_SIDEQUEST_1_INTRO_30_CHAR	$RAN
$LINE_SIDEQUEST_1_INTRO_30_TEXT	也许这并未发生在你们身上，但是——
$LINE_SIDEQUEST_1_INTRO_40_CHAR	$MCG
$LINE_SIDEQUEST_1_INTRO_40_TEXT	让我来把事情说清楚：你是真的在抱怨去救孩子？
$LINE_SIDEQUEST_1_INTRO_50_CHAR	$MCG
$LINE_SIDEQUEST_1_INTRO_50_TEXT	我明白，你抱怨是你的事情，但是是真的吗？孩子？
$LINE_SIDEQUEST_1_INTRO_60_CHAR	$RAN
$LINE_SIDEQUEST_1_INTRO_60_TEXT	那不是我说的。我根本没这么说——
$LINE_SIDEQUEST_1_INTRO_70_CHAR	$MCG
$LINE_SIDEQUEST_1_INTRO_70_TEXT	你讨厌孩子？
$LINE_SIDEQUEST_1_INTRO_80_CHAR	$RAN
$LINE_SIDEQUEST_1_INTRO_80_TEXT	你知道，我真的很讨厌你污蔑我。
$LINE_SIDEQUEST_1_INTRO_90_CHAR	$MCG
$LINE_SIDEQUEST_1_INTRO_90_TEXT	污蔑你就像把水倒进喷泉里一样。
$LINE_SIDEQUEST_1_INTRO_100_CHAR	$BER
$LINE_SIDEQUEST_1_INTRO_100_TEXT	打架啦，大家！打架啦！
$LINE_SIDEQUEST_1_INTRO_110_CHAR	$BER
$LINE_SIDEQUEST_1_INTRO_110_TEXT	我用一双靴子和一把生锈的刀赌漂亮的那一个会赢。
$LINE_SIDEQUEST_1_INTRO_120_CHAR	$MCG
$LINE_SIDEQUEST_1_INTRO_120_TEXT	……
$LINE_SIDEQUEST_1_INTRO_130_CHAR	$BER
$LINE_SIDEQUEST_1_INTRO_130_TEXT	啊，这路上也有一堆亡者。
$LINE_SIDEQUEST_1_INTRO_140_CHAR	$MCG
$LINE_SIDEQUEST_1_INTRO_140_TEXT	漂亮。
$SCENE_SIDEQUEST_1_OUTRO_TITLE	实际世仇
$LINE_SIDEQUEST_1_OUTRO_00_CHAR	$BER
$LINE_SIDEQUEST_1_OUTRO_00_TEXT	没有人想领教我的愤怒了么？
$LINE_SIDEQUEST_1_OUTRO_10_CHAR	$BER
$LINE_SIDEQUEST_1_OUTRO_10_TEXT	<LQ>没有，我们真的都领教够了。<RQ>
$LINE_SIDEQUEST_1_OUTRO_20_CHAR	$BER
$LINE_SIDEQUEST_1_OUTRO_20_TEXT	是吗？是吗？！
$LINE_SIDEQUEST_1_OUTRO_30_CHAR	$BER
$LINE_SIDEQUEST_1_OUTRO_30_TEXT	嗯，是的，我想就是你刚刚说的。
$LINE_SIDEQUEST_1_OUTRO_40_CHAR	罪犯
$LINE_SIDEQUEST_1_OUTRO_40_TEXT	抱歉，疯子，但是刚刚发生什么了呢？
$LINE_SIDEQUEST_1_OUTRO_50_CHAR	$BER
$LINE_SIDEQUEST_1_OUTRO_50_TEXT	他们全不见了！就像 <LQ>哟，我们要把你搞得一团糟！<RQ>
$LINE_SIDEQUEST_1_OUTRO_60_CHAR	$BER
$LINE_SIDEQUEST_1_OUTRO_60_TEXT	……然后我就像这样，<LQ>我不这么想，邪恶的朋友！<RQ>
$LINE_SIDEQUEST_1_OUTRO_70_CHAR	$BER
$LINE_SIDEQUEST_1_OUTRO_70_TEXT	然后我的二头肌就都<LQ>嘣！砰！<RQ>然后——
$LINE_SIDEQUEST_1_OUTRO_80_CHAR	$BER
$LINE_SIDEQUEST_1_OUTRO_80_TEXT	哦，嘿！你肯定是我们要救的罪犯！
$LINE_SIDEQUEST_1_OUTRO_90_CHAR	罪犯
$LINE_SIDEQUEST_1_OUTRO_90_TEXT	救？你是说你不是奥斯蒙的人？
$LINE_SIDEQUEST_1_OUTRO_100_CHAR	$BER
$LINE_SIDEQUEST_1_OUTRO_100_TEXT	你开玩笑吗？我才不会为那样的人干活！
$LINE_SIDEQUEST_1_OUTRO_110_CHAR	$BER
$LINE_SIDEQUEST_1_OUTRO_110_TEXT	他闻起来就跟奶酪一样。
$LINE_SIDEQUEST_1_OUTRO_120_CHAR	$BER
$LINE_SIDEQUEST_1_OUTRO_120_TEXT	这就是我的底线。
$LINE_SIDEQUEST_1_OUTRO_130_CHAR	罪犯
$LINE_SIDEQUEST_1_OUTRO_130_TEXT	所以我们可以走了？我都不明白发生了什么。
$LINE_SIDEQUEST_1_OUTRO_140_CHAR	$BER
$LINE_SIDEQUEST_1_OUTRO_140_TEXT	如果你想知道发生什么了，你应该去问问别人，而不是我。
$LINE_SIDEQUEST_1_OUTRO_150_CHAR	$MCG
$LINE_SIDEQUEST_1_OUTRO_150_TEXT	我们最好在敌人发现前离开这里。
$LINE_SIDEQUEST_1_OUTRO_160_CHAR	$MCG
$LINE_SIDEQUEST_1_OUTRO_160_TEXT	其他罪犯的小营地离这不远。我们可以给你带路。
$LINE_SIDEQUEST_1_OUTRO_170_CHAR	$MCG
$LINE_SIDEQUEST_1_OUTRO_170_TEXT	我不懂，现在你不想对卡拉斯卡那些家伙做些什么吗？
$LINE_SIDEQUEST_1_OUTRO_180_CHAR	$RAN
$LINE_SIDEQUEST_1_OUTRO_180_TEXT	啊，我的革卡姐妹，你要学的还有很多。
$LINE_SIDEQUEST_1_OUTRO_190_CHAR	$RAN
$LINE_SIDEQUEST_1_OUTRO_190_TEXT	我们从战争中得到的东西比他从人们身上压榨的废物要好得多。
$LINE_SIDEQUEST_1_OUTRO_200_CHAR	$RAN
$LINE_SIDEQUEST_1_OUTRO_200_TEXT	现在没有理由要对他做什么。
$LINE_SIDEQUEST_1_OUTRO_210_CHAR	$MCG
$LINE_SIDEQUEST_1_OUTRO_210_TEXT	但你们是世仇……
$LINE_SIDEQUEST_1_OUTRO_220_CHAR	$RAN
$LINE_SIDEQUEST_1_OUTRO_220_TEXT	*$MCG，传统是为我们服务的，而不是为了其他。记住，首要任务是生存。
$LINE_SIDEQUEST_1_OUTRO_230_CHAR	$MCG
$LINE_SIDEQUEST_1_OUTRO_230_TEXT	所以世仇就是你为所欲为的借口？
$LINE_SIDEQUEST_1_OUTRO_240_CHAR	$RAN
$LINE_SIDEQUEST_1_OUTRO_240_TEXT	现在你已经找到窍门了！
$LINE_SIDEQUEST_1_OUTRO_250_CHAR	$RAN
$LINE_SIDEQUEST_1_OUTRO_250_TEXT	所以记住，如果你见到富人，也有更好的理由去讨厌他们了。
$SCENE_SIDEQUEST_2_GET_TITLE	恐惧之海
$LINE_SIDEQUEST_2_GET_00_CHAR	$BER
$LINE_SIDEQUEST_2_GET_00_TEXT	嘿，和尚！
$LINE_SIDEQUEST_2_GET_10_CHAR	$HEA
$LINE_SIDEQUEST_2_GET_10_TEXT	嗯，陌生的朋友？
$LINE_SIDEQUEST_2_GET_20_CHAR	$BER
$LINE_SIDEQUEST_2_GET_20_TEXT	我以为你们和尚都可以帮助别人，医治别人！
$LINE_SIDEQUEST_2_GET_30_CHAR	$HEA
$LINE_SIDEQUEST_2_GET_30_TEXT	好吧，通常是。
$LINE_SIDEQUEST_2_GET_40_CHAR	$BER
$LINE_SIDEQUEST_2_GET_40_TEXT	那么为什么你却想毒死我呢？！
$LINE_SIDEQUEST_2_GET_50_CHAR	$HEA
$LINE_SIDEQUEST_2_GET_50_TEXT	毒死？
$LINE_SIDEQUEST_2_GET_60_CHAR	$BER
$LINE_SIDEQUEST_2_GET_60_TEXT	这食物里有什么？
$LINE_SIDEQUEST_2_GET_70_CHAR	$HEA
$LINE_SIDEQUEST_2_GET_70_TEXT	怎么了？
$LINE_SIDEQUEST_2_GET_80_CHAR	$BER
$LINE_SIDEQUEST_2_GET_80_TEXT	怎么了？全是……全是地上长出来的东西！
$LINE_SIDEQUEST_2_GET_90_CHAR	$HEA
$LINE_SIDEQUEST_2_GET_90_TEXT	蔬菜？
$LINE_SIDEQUEST_2_GET_100_CHAR	$BER
$LINE_SIDEQUEST_2_GET_100_TEXT	是啊，全都是！
$LINE_SIDEQUEST_2_GET_110_CHAR	$BER
$LINE_SIDEQUEST_2_GET_110_TEXT	*蔬菜无法帮我保持体格！你想让我变得和$MCG一样么？骨瘦如柴而且一点用也没有？
$LINE_SIDEQUEST_2_GET_120_CHAR	$MCG
$LINE_SIDEQUEST_2_GET_120_TEXT	嘿！
$LINE_SIDEQUEST_2_GET_130_CHAR	$BER
$LINE_SIDEQUEST_2_GET_130_TEXT	我都觉得我已经开始萎缩了……
$LINE_SIDEQUEST_2_GET_140_CHAR	$HEA
$LINE_SIDEQUEST_2_GET_140_TEXT	好吧，我们以前有稳定的鱼供应，但后来河里全是水亡者。
$LINE_SIDEQUEST_2_GET_150_CHAR	$BER
$LINE_SIDEQUEST_2_GET_150_TEXT	你说的是水僵尸？
$LINE_SIDEQUEST_2_GET_160_CHAR	$BER
$LINE_SIDEQUEST_2_GET_160_TEXT	听起来这像是……
$LINE_SIDEQUEST_2_GET_170_CHAR	$BER
$LINE_SIDEQUEST_2_GET_170_TEXT	*$BER——水生动物死亡的承包商！
$LINE_SIDEQUEST_2_GET_180_CHAR	$BER
$LINE_SIDEQUEST_2_GET_180_TEXT	残缺的水手！流血的渔夫！切片的海员！
$LINE_SIDEQUEST_2_GET_190_CHAR	$MCG
$LINE_SIDEQUEST_2_GET_190_TEXT	陈词滥调的海员。
$LINE_SIDEQUEST_2_GET_200_CHAR	$BER
$LINE_SIDEQUEST_2_GET_200_TEXT	我航行至恐惧之海；你无力的嘲弄讲消失在其荣耀的咆哮声中。
$LINE_SIDEQUEST_2_GET_210_CHAR	$MCG
$LINE_SIDEQUEST_2_GET_210_TEXT	如果你不再沉溺于自我吹嘘，我们或许就可以和亡者战斗了。
$SCENE_SIDEQUEST_2_INTRO_TITLE	花裤子大人
$LINE_SIDEQUEST_2_INTRO_00_CHAR	$RAN
$LINE_SIDEQUEST_2_INTRO_00_TEXT	为什么我们又要这么做？因为花裤子大人不爱吃蔬菜？
$LINE_SIDEQUEST_2_INTRO_10_CHAR	$BER
$LINE_SIDEQUEST_2_INTRO_10_TEXT	瞧瞧他们对你做的一切！
$LINE_SIDEQUEST_2_INTRO_20_CHAR	$RAN
$LINE_SIDEQUEST_2_INTRO_20_TEXT	什么？
$LINE_SIDEQUEST_2_INTRO_30_CHAR	$BER
$LINE_SIDEQUEST_2_INTRO_30_TEXT	你现在就想个土豆似的。
$LINE_SIDEQUEST_2_INTRO_40_CHAR	$RAN
$LINE_SIDEQUEST_2_INTRO_40_TEXT	嘿！
$LINE_SIDEQUEST_2_INTRO_50_CHAR	$MCG
$LINE_SIDEQUEST_2_INTRO_50_TEXT	哈。
$LINE_SIDEQUEST_2_INTRO_60_CHAR	$RAN
$LINE_SIDEQUEST_2_INTRO_60_TEXT	太蠢了。
$LINE_SIDEQUEST_2_INTRO_70_CHAR	$BER
$LINE_SIDEQUEST_2_INTRO_70_TEXT	嗯，这也许是我们有史以来的最蠢的开战理由了。
$LINE_SIDEQUEST_2_INTRO_80_CHAR	$MCG
$LINE_SIDEQUEST_2_INTRO_80_TEXT	什么？我们在这里全是因为你！
$LINE_SIDEQUEST_2_INTRO_90_CHAR	$BER
$LINE_SIDEQUEST_2_INTRO_90_TEXT	虽然我这么做了，但我并不觉得这么做是聪明的。
$LINE_SIDEQUEST_2_INTRO_100_CHAR	$BER
$LINE_SIDEQUEST_2_INTRO_100_TEXT	我就是我！虽然我希望你更好。
$LINE_SIDEQUEST_2_INTRO_110_CHAR	$MCG
$LINE_SIDEQUEST_2_INTRO_110_TEXT	……
$LINE_SIDEQUEST_2_INTRO_120_CHAR	$BER
$LINE_SIDEQUEST_2_INTRO_120_TEXT	顺便说下，貌似河流都在这。
$LINE_SIDEQUEST_2_INTRO_130_CHAR	$MCG
$LINE_SIDEQUEST_2_INTRO_130_TEXT	别说话。
$SCENE_SIDEQUEST_2_OUTRO_TITLE	鱼糕
$LINE_SIDEQUEST_2_OUTRO_00_CHAR	$RAN
$LINE_SIDEQUEST_2_OUTRO_00_TEXT	最后一个。
$LINE_SIDEQUEST_2_OUTRO_10_CHAR	$BER
$LINE_SIDEQUEST_2_OUTRO_10_TEXT	……但是屠杀才刚开始。
$LINE_SIDEQUEST_2_OUTRO_20_CHAR	$BER
$LINE_SIDEQUEST_2_OUTRO_20_TEXT	鱼啊，遵从你的宿命吧！
$LINE_SIDEQUEST_2_OUTRO_30_CHAR	$BER
$LINE_SIDEQUEST_2_OUTRO_30_TEXT	我是赤炎灭绝之王！
$LINE_SIDEQUEST_2_OUTRO_40_CHAR	$RAN
$LINE_SIDEQUEST_2_OUTRO_40_TEXT	所以河流刚刚安全了……
$LINE_SIDEQUEST_2_OUTRO_50_CHAR	$RAN
$LINE_SIDEQUEST_2_OUTRO_50_TEXT	……因此用疯狂驱动的剑，即使不用完全出鞘就能屠杀所有生命。
$LINE_SIDEQUEST_2_OUTRO_60_CHAR	$MCG
$LINE_SIDEQUEST_2_OUTRO_60_TEXT	差不多。
$SCENE_SIDEQUEST_3_GET_TITLE	亲属盟约
$LINE_SIDEQUEST_3_GET_00_CHAR	修女
$LINE_SIDEQUEST_3_GET_00_TEXT	抱歉，但是我知道有个革卡成员和你们一起?
$LINE_SIDEQUEST_3_GET_10_CHAR	$MCG
$LINE_SIDEQUEST_3_GET_10_TEXT	确切的说，有几个，如果<LQ>名誉成员<RQ>也算的话。
$LINE_SIDEQUEST_3_GET_20_CHAR	修女
$LINE_SIDEQUEST_3_GET_20_TEXT	女修道院里有个革卡人生病了，我们在照顾她。
$LINE_SIDEQUEST_3_GET_30_CHAR	修女
$LINE_SIDEQUEST_3_GET_30_TEXT	当她听说这里还有其他革卡人，所以想要见见他们。
$LINE_SIDEQUEST_3_GET_40_CHAR	修女
$LINE_SIDEQUEST_3_GET_40_TEXT	你是否愿意去见她……我们担心如果她变得激动会加重病情。
$LINE_SIDEQUEST_3_GET_50_CHAR	$BER
$LINE_SIDEQUEST_3_GET_50_TEXT	别担心，对于人们而言，我是一种很好的抚慰剂！
$LINE_SIDEQUEST_3_GET_60_CHAR	修女
$LINE_SIDEQUEST_3_GET_60_TEXT	抱歉，但是……只有女人才能进修道院。
$LINE_SIDEQUEST_3_GET_70_CHAR	$BER
$LINE_SIDEQUEST_3_GET_70_TEXT	什么？但那不是——
$LINE_SIDEQUEST_3_GET_80_CHAR	$RAN
$LINE_SIDEQUEST_3_GET_80_TEXT	呀——呀！
$LINE_SIDEQUEST_3_GET_90_CHAR	病人
$LINE_SIDEQUEST_3_GET_90_TEXT	她……在哪儿？
$LINE_SIDEQUEST_3_GET_100_CHAR	$RAN
$LINE_SIDEQUEST_3_GET_100_TEXT	*$RAN·塔基莉·革卡在跟你打招呼。
$LINE_SIDEQUEST_3_GET_110_CHAR	病人
$LINE_SIDEQUEST_3_GET_110_TEXT	阿蒂亚……科利客提·革卡
$LINE_SIDEQUEST_3_GET_120_CHAR	阿蒂亚
$LINE_SIDEQUEST_3_GET_120_TEXT	我……病的有点严重……快支撑不住了……
$LINE_SIDEQUEST_3_GET_130_CHAR	阿蒂亚
$LINE_SIDEQUEST_3_GET_130_TEXT	我在墙外……看见了……我们的革卡同伴。
$LINE_SIDEQUEST_3_GET_140_CHAR	阿蒂亚
$LINE_SIDEQUEST_3_GET_140_TEXT	在……一群……不安宁的死人之中……
$LINE_SIDEQUEST_3_GET_150_CHAR	阿蒂亚
$LINE_SIDEQUEST_3_GET_150_TEXT	他们值得……更好的对待。他们……应该拥有平静。
$LINE_SIDEQUEST_3_GET_160_CHAR	$RAN
$LINE_SIDEQUEST_3_GET_160_TEXT	死者已经抵达和平，姐妹。
$LINE_SIDEQUEST_3_GET_170_CHAR	阿蒂亚
$LINE_SIDEQUEST_3_GET_170_TEXT	他们……一边走……一边寻找……还一边胡言乱语？
$LINE_SIDEQUEST_3_GET_180_CHAR	阿蒂亚
$LINE_SIDEQUEST_3_GET_180_TEXT	你可以……解放他们。
$LINE_SIDEQUEST_3_GET_190_CHAR	$RAN
$LINE_SIDEQUEST_3_GET_190_TEXT	嗯……你应该知道，亡者无法被杀死。
$LINE_SIDEQUEST_3_GET_200_CHAR	阿蒂亚
$LINE_SIDEQUEST_3_GET_200_TEXT	*我知道你的朋友……$MCG，和她的能力。你的团队就可以做到！
$LINE_SIDEQUEST_3_GET_210_CHAR	$RAN
$LINE_SIDEQUEST_3_GET_210_TEXT	抱歉，我不能。这种冒险完全没必要。
$LINE_SIDEQUEST_3_GET_220_CHAR	阿蒂亚
$LINE_SIDEQUEST_3_GET_220_TEXT	你离开他们了？
$LINE_SIDEQUEST_3_GET_230_CHAR	$RAN
$LINE_SIDEQUEST_3_GET_230_TEXT	我不想加入他们。他们会明白的。
$LINE_SIDEQUEST_3_GET_240_CHAR	阿蒂亚
$LINE_SIDEQUEST_3_GET_240_TEXT	……塔基莉的女儿……蔑视……亲属关系。
$LINE_SIDEQUEST_3_GET_250_CHAR	阿蒂亚
$LINE_SIDEQUEST_3_GET_250_TEXT	我已经活得太久了。
$LINE_SIDEQUEST_3_GET_260_CHAR	$RAN
$LINE_SIDEQUEST_3_GET_260_TEXT	我不会牺牲自己去救那些已死的人！
$LINE_SIDEQUEST_3_GET_270_CHAR	阿蒂亚
$LINE_SIDEQUEST_3_GET_270_TEXT	滚……出……我的……视线。
$LINE_SIDEQUEST_3_GET_280_CHAR	$RAN
$LINE_SIDEQUEST_3_GET_280_TEXT	我没意见。
$LINE_SIDEQUEST_3_GET_290_CHAR	阿蒂亚
$LINE_SIDEQUEST_3_GET_290_TEXT	你应该知道……没有血缘关系的那一个……是克莱夫……和他的弟弟卡基特……
$LINE_SIDEQUEST_3_GET_300_CHAR	阿蒂亚
$LINE_SIDEQUEST_3_GET_300_TEXT	……克拉斯特的儿子们。
$LINE_SIDEQUEST_3_GET_310_CHAR	$RAN
$LINE_SIDEQUEST_3_GET_310_TEXT	……
$LINE_SIDEQUEST_3_GET_320_CHAR	$RAN
$LINE_SIDEQUEST_3_GET_320_TEXT	……该死。
$SCENE_SIDEQUEST_3_INTRO_TITLE	偿还债务
$LINE_SIDEQUEST_3_INTRO_00_CHAR	$MCG
$LINE_SIDEQUEST_3_INTRO_00_TEXT	嘿！等等！
$LINE_SIDEQUEST_3_INTRO_10_CHAR	$MCG
$LINE_SIDEQUEST_3_INTRO_10_TEXT	什么，你也在这些死人后跑进沙漠了？
$LINE_SIDEQUEST_3_INTRO_20_CHAR	$RAN
$LINE_SIDEQUEST_3_INTRO_20_TEXT	不死族，嗯，我不打算……杀他们，或者随便怎么样。
$LINE_SIDEQUEST_3_INTRO_30_CHAR	$MCG
$LINE_SIDEQUEST_3_INTRO_30_TEXT	你觉得你可能需要帮助？
$LINE_SIDEQUEST_3_INTRO_40_CHAR	$RAN
$LINE_SIDEQUEST_3_INTRO_40_TEXT	这是……私事。
$LINE_SIDEQUEST_3_INTRO_50_CHAR	$MCG
$LINE_SIDEQUEST_3_INTRO_50_TEXT	嗯，这目前确实困扰着我。难道这不是有点……出乎意料么？
$LINE_SIDEQUEST_3_INTRO_60_CHAR	$RAN
$LINE_SIDEQUEST_3_INTRO_60_TEXT	我欠他们的。
$LINE_SIDEQUEST_3_INTRO_70_CHAR	$MCG
$LINE_SIDEQUEST_3_INTRO_70_TEXT	所以你打算杀了自己么？
$LINE_SIDEQUEST_3_INTRO_80_CHAR	$MCG
$LINE_SIDEQUEST_3_INTRO_80_TEXT	我是说，或许你已经忘了，但是亡者是不可战胜的，除非你是在半路上。
$LINE_SIDEQUEST_3_INTRO_90_CHAR	$RAN
$LINE_SIDEQUEST_3_INTRO_90_TEXT	……你在这，不是么？
$LINE_SIDEQUEST_3_INTRO_100_CHAR	$MCG
$LINE_SIDEQUEST_3_INTRO_100_TEXT	……以及一群模样可怕的亡者也在这。
$SCENE_SIDEQUEST_3_OUTRO_TITLE	克拉斯特之子
$LINE_SIDEQUEST_3_OUTRO_00_CHAR	$RAN
$LINE_SIDEQUEST_3_OUTRO_00_TEXT	克拉斯特之子，请安静。
$LINE_SIDEQUEST_3_OUTRO_10_CHAR	$MCG
$LINE_SIDEQUEST_3_OUTRO_10_TEXT	……那么这些家伙是谁？
$LINE_SIDEQUEST_3_OUTRO_20_CHAR	$RAN
$LINE_SIDEQUEST_3_OUTRO_20_TEXT	这现在不重要，不是吗？
$LINE_SIDEQUEST_3_OUTRO_30_CHAR	$MCG
$LINE_SIDEQUEST_3_OUTRO_30_TEXT	*我只是想查出究竟是谁对残酷生存主义者$RAN如此重要，让她甘愿冒生命危险。
$LINE_SIDEQUEST_3_OUTRO_40_CHAR	$RAN
$LINE_SIDEQUEST_3_OUTRO_40_TEXT	他们曾经救了我的命。
$LINE_SIDEQUEST_3_OUTRO_50_CHAR	$RAN
$LINE_SIDEQUEST_3_OUTRO_50_TEXT	他们救了我们所有人的命。
$LINE_SIDEQUEST_3_OUTRO_60_CHAR	$RAN
$LINE_SIDEQUEST_3_OUTRO_60_TEXT	不管怎么样，都是这些人编造出来的。
$LINE_SIDEQUEST_3_OUTRO_70_CHAR	$MCG
$LINE_SIDEQUEST_3_OUTRO_70_TEXT	编了些什么？
$LINE_SIDEQUEST_3_OUTRO_80_CHAR	$RAN
$LINE_SIDEQUEST_3_OUTRO_80_TEXT	我们中了埋伏。他们留了下来，而我们跑了。这的确是真的。
$LINE_SIDEQUEST_3_OUTRO_90_CHAR	$RAN
$LINE_SIDEQUEST_3_OUTRO_90_TEXT	我们回去告诉那个话篓子，这样她就可以含笑九泉了。
$LINE_SIDEQUEST_3_OUTRO_100_CHAR	$MCG
$LINE_SIDEQUEST_3_OUTRO_100_TEXT	这么多有关我前男友的理论……
$LINE_SIDEQUEST_3_OUTRO_110_CHAR	$RAN
$LINE_SIDEQUEST_3_OUTRO_110_TEXT	我感到自己很太悲哀，因为我忘记了血缘关系。明明自己就已经铸下大错，在很多时候，我还去唾弃别人这一点。
$LINE_SIDEQUEST_3_OUTRO_120_CHAR	$RAN
$LINE_SIDEQUEST_3_OUTRO_120_TEXT	但时光飞逝。当狼群将我围困时，我没有剑，也没有盾。
$LINE_SIDEQUEST_3_OUTRO_130_CHAR	$RAN
$LINE_SIDEQUEST_3_OUTRO_130_TEXT	没有帐篷的我在风中依然苦涩。没有船只的我在海上仍然渺茫。然而无助时却得不到丝毫的慰藉。
$LINE_SIDEQUEST_3_OUTRO_140_CHAR	$RAN
$LINE_SIDEQUEST_3_OUTRO_140_TEXT	我将我自己带向深渊走向黑暗。我撕扯开自己的贪婪和仇恨的外表却得不到救赎，就像我现在这样。
$LINE_SIDEQUEST_3_OUTRO_150_CHAR	$MCG
$LINE_SIDEQUEST_3_OUTRO_150_TEXT	她什么时候死的？
$LINE_SIDEQUEST_3_OUTRO_160_CHAR	$RAN
$LINE_SIDEQUEST_3_OUTRO_160_TEXT	大概在我们带着运气离开五分钟后。
$LINE_SIDEQUEST_3_OUTRO_170_CHAR	$RAN
$LINE_SIDEQUEST_3_OUTRO_170_TEXT	事实便是如此，只要你忽略一个问题的时间足够长，它就会自己消失不见。
$LINE_SIDEQUEST_3_OUTRO_180_CHAR	$MCG
$LINE_SIDEQUEST_3_OUTRO_180_TEXT	这真是一个悲哀的玩笑。
$LINE_SIDEQUEST_3_OUTRO_190_CHAR	$RAN
$LINE_SIDEQUEST_3_OUTRO_190_TEXT	不，最可悲的是我们付出那么多却没有回报。
$LINE_SIDEQUEST_3_OUTRO_200_CHAR	$MCG
$LINE_SIDEQUEST_3_OUTRO_200_TEXT	当你帮助别人一次，就自我救赎了一回。这不是没有回报。
$LINE_SIDEQUEST_3_OUTRO_210_CHAR	$RAN
$LINE_SIDEQUEST_3_OUTRO_210_TEXT	嗯，<LQ>帮助<RQ>……
$LINE_SIDEQUEST_3_OUTRO_220_CHAR	$MCG
$LINE_SIDEQUEST_3_OUTRO_220_TEXT	……你想谈谈这个？
$LINE_SIDEQUEST_3_OUTRO_230_CHAR	$RAN
$LINE_SIDEQUEST_3_OUTRO_230_TEXT	对，让我们一起站在过去的彼岸面对曾经迷茫的内心。
$LINE_SIDEQUEST_3_OUTRO_240_CHAR	$MCG
$LINE_SIDEQUEST_3_OUTRO_240_TEXT	或许很好——
$LINE_SIDEQUEST_3_OUTRO_250_CHAR	$MCG
$LINE_SIDEQUEST_3_OUTRO_250_TEXT	——哦，我知道了，你又在讥讽他们了。
$LINE_SIDEQUEST_3_OUTRO_260_CHAR	$RAN
$LINE_SIDEQUEST_3_OUTRO_260_TEXT	我有没有说过，你不如我有魅力，而且还不会为人处世？
$LINE_SIDEQUEST_3_OUTRO_270_CHAR	$MCG
$LINE_SIDEQUEST_3_OUTRO_270_TEXT	你这个混蛋。
$LINE_SIDEQUEST_3_OUTRO_280_CHAR	$RAN
$LINE_SIDEQUEST_3_OUTRO_280_TEXT	我感觉好多了。
$LINE_SIDEQUEST_3_OUTRO_290_CHAR	$MCG
$LINE_SIDEQUEST_3_OUTRO_290_TEXT	很好！我永远都不会告诉你葡萄干布丁的事！
$LINE_SIDEQUEST_3_OUTRO_300_CHAR	$RAN
$LINE_SIDEQUEST_3_OUTRO_300_TEXT	<LQ>葡萄干布丁<RQ>？
$LINE_SIDEQUEST_3_OUTRO_310_CHAR	$MCG
$LINE_SIDEQUEST_3_OUTRO_310_TEXT	太糟糕了。
$LINE_SIDEQUEST_3_OUTRO_320_CHAR	$RAN
$LINE_SIDEQUEST_3_OUTRO_320_TEXT	可是……我现在备受好奇心的折磨。
$LINE_SIDEQUEST_3_OUTRO_330_CHAR	$RAN
$LINE_SIDEQUEST_3_OUTRO_330_TEXT	该死！
$LINE_SIDEQUEST_3_OUTRO_340_CHAR	$MAG
$LINE_SIDEQUEST_3_OUTRO_340_TEXT	有次我杀了一个带着葡萄干布丁的人。
$LINE_SIDEQUEST_3_OUTRO_350_CHAR	$MAG
$LINE_SIDEQUEST_3_OUTRO_350_TEXT	关键是当他们停止动弹后，还是要多抱一会他们的头。
$LINE_SIDEQUEST_3_OUTRO_360_CHAR	$MAG
$LINE_SIDEQUEST_3_OUTRO_360_TEXT	不然，他们会射出像布丁一样的怪物，你必须用烤火鸡消灭它们。
$LINE_SIDEQUEST_3_OUTRO_370_CHAR	$MAG
$LINE_SIDEQUEST_3_OUTRO_370_TEXT	……然后爸爸你毁掉了火鸡的事情很生气，而你，<LQ>可是爸爸，有刺客！<RQ>
$LINE_SIDEQUEST_3_OUTRO_380_CHAR	$MAG
$LINE_SIDEQUEST_3_OUTRO_380_TEXT	……然后他说，<LQ>那你为什么不用我给你的剑？<RQ>
$LINE_SIDEQUEST_3_OUTRO_390_CHAR	$MAG
$LINE_SIDEQUEST_3_OUTRO_390_TEXT	接着你说道，<LQ>那其他女孩嘲笑我<LQ>，然后他说，<LQ>那就削掉她们的脑袋！现在去你的房间里练习投掷匕首！<LQ>
$LINE_SIDEQUEST_3_OUTRO_400_CHAR	$RAN
$LINE_SIDEQUEST_3_OUTRO_400_TEXT	……
$LINE_SIDEQUEST_3_OUTRO_410_CHAR	$MAG
$LINE_SIDEQUEST_3_OUTRO_410_TEXT	所以能有这样女孩间的谈话，我真的很高兴。
$SCENE_SIDEQUEST_4_GET_TITLE	和平荒地
$NARR_SIDEQUEST_4_GET_00_TEXT	那天早些时候……
$LINE_SIDEQUEST_4_GET_00_CHAR	$BER
$LINE_SIDEQUEST_4_GET_00_TEXT	它已经跟着我整整两天了，因为我杀了什么……
$LINE_SIDEQUEST_4_GET_10_CHAR	$BER
$LINE_SIDEQUEST_4_GET_10_TEXT	我能感觉到寂寞空虚腐蚀了我的灵魂。
$LINE_SIDEQUEST_4_GET_20_CHAR	$BER
$LINE_SIDEQUEST_4_GET_20_TEXT	救命！
$LINE_SIDEQUEST_4_GET_30_CHAR	$HEA
$LINE_SIDEQUEST_4_GET_30_TEXT	怎么了？
$LINE_SIDEQUEST_4_GET_40_CHAR	$BER
$LINE_SIDEQUEST_4_GET_40_TEXT	我在和平荒地！
$LINE_SIDEQUEST_4_GET_50_CHAR	$BER
$LINE_SIDEQUEST_4_GET_50_TEXT	天啊，从未想过居然会这样结束！
$LINE_SIDEQUEST_4_GET_60_CHAR	$BER
$LINE_SIDEQUEST_4_GET_60_TEXT	*这里躺着$BER，被他的朋友残忍的抛弃。死于对缺乏杀戮。
$LINE_SIDEQUEST_4_GET_70_CHAR	$HEA
$LINE_SIDEQUEST_4_GET_70_TEXT	……
$LINE_SIDEQUEST_4_GET_80_CHAR	$BER
$LINE_SIDEQUEST_4_GET_80_TEXT	不，不要帮我。我把自己交付给我的命运。我就坐在这里，等到不再寂寞——
$LINE_SIDEQUEST_4_GET_90_CHAR	$BER
$LINE_SIDEQUEST_4_GET_90_TEXT	噢，那闪闪发光的是什么？
$LINE_SIDEQUEST_4_GET_100_CHAR	$HEA
$LINE_SIDEQUEST_4_GET_100_TEXT	什么？
$LINE_SIDEQUEST_4_GET_110_CHAR	$BER
$LINE_SIDEQUEST_4_GET_110_TEXT	快过来，闪光！
$LINE_SIDEQUEST_4_GET_120_CHAR	$BER
$LINE_SIDEQUEST_4_GET_120_TEXT	我需要杀了你！
$SCENE_SIDEQUEST_4_INTRO_TITLE	神秘女子
$LINE_SIDEQUEST_4_INTRO_00_CHAR	$HEA
$LINE_SIDEQUEST_4_INTRO_00_TEXT	刚刚发生了什么？
$LINE_SIDEQUEST_4_INTRO_10_CHAR	$BER
$LINE_SIDEQUEST_4_INTRO_10_TEXT	*啊，那肯定是$MCG。
$LINE_SIDEQUEST_4_INTRO_20_CHAR	$BER
$LINE_SIDEQUEST_4_INTRO_20_TEXT	我知道没有我，他们不会杀害任何东西！
$LINE_SIDEQUEST_4_INTRO_30_CHAR	$HEA
$LINE_SIDEQUEST_4_INTRO_30_TEXT	但她只会让那些东西靠近她……这不可能是——
$LINE_SIDEQUEST_4_INTRO_40_CHAR	神秘女子
$LINE_SIDEQUEST_4_INTRO_40_TEXT	嗯……这阵不是我所期待的。
$LINE_SIDEQUEST_4_INTRO_50_CHAR	$BER
$LINE_SIDEQUEST_4_INTRO_50_TEXT	你好，神秘的美丽女子！你不会恰好需要一位帅气、强壮而且感性的暴力打手来为你服务吧？
$LINE_SIDEQUEST_4_INTRO_60_CHAR	神秘女子
$LINE_SIDEQUEST_4_INTRO_60_TEXT	为什么你觉得会是我带你来的呢？
$LINE_SIDEQUEST_4_INTRO_70_CHAR	神秘女子
$LINE_SIDEQUEST_4_INTRO_70_TEXT	我需要进入这个神社，但其里面的居民却不同意。你能帮助我杀了里面的人吗？
$LINE_SIDEQUEST_4_INTRO_80_CHAR	$BER
$LINE_SIDEQUEST_4_INTRO_80_TEXT	请嫁给我。
$LINE_SIDEQUEST_4_INTRO_90_CHAR	神秘女子
$LINE_SIDEQUEST_4_INTRO_90_TEXT	这样就对了。
$LINE_SIDEQUEST_4_INTRO_100_CHAR	$HEA
$LINE_SIDEQUEST_4_INTRO_100_TEXT	我不喜欢这个。
$LINE_SIDEQUEST_4_INTRO_110_CHAR	$BER
$LINE_SIDEQUEST_4_INTRO_110_TEXT	我知道你是个和尚，所以你可以假装不知道这个，但她非常迷人。
$LINE_SIDEQUEST_4_INTRO_120_CHAR	$HEA
$LINE_SIDEQUEST_4_INTRO_120_TEXT	所以你对她言听计从？
$LINE_SIDEQUEST_4_INTRO_130_CHAR	$BER
$LINE_SIDEQUEST_4_INTRO_130_TEXT	唔……
$LINE_SIDEQUEST_4_INTRO_140_CHAR	$BER
$LINE_SIDEQUEST_4_INTRO_140_TEXT	没错。
$SCENE_SIDEQUEST_4_OUTRO_TITLE	我说什么了？
$LINE_SIDEQUEST_4_OUTRO_00_CHAR	$HEA
$LINE_SIDEQUEST_4_OUTRO_00_TEXT	等等，我知道废墟。
$LINE_SIDEQUEST_4_OUTRO_10_CHAR	$HEA
$LINE_SIDEQUEST_4_OUTRO_10_TEXT	你是谁？你怎么带我们来这的？
$LINE_SIDEQUEST_4_OUTRO_20_CHAR	$HEA
$LINE_SIDEQUEST_4_OUTRO_20_TEXT	我知道还有一个女人能做类似的事情……但也不是这样的事情。
$LINE_SIDEQUEST_4_OUTRO_30_CHAR	神秘女子
$LINE_SIDEQUEST_4_OUTRO_30_TEXT	*你认识$MCG·莱博？
$LINE_SIDEQUEST_4_OUTRO_40_CHAR	神秘女子
$LINE_SIDEQUEST_4_OUTRO_40_TEXT	当然……我应该感觉到的。
$LINE_SIDEQUEST_4_OUTRO_50_CHAR	神秘女子
$LINE_SIDEQUEST_4_OUTRO_50_TEXT	如果……不。不，太危险了。
$LINE_SIDEQUEST_4_OUTRO_60_CHAR	$HEA
$LINE_SIDEQUEST_4_OUTRO_60_TEXT	*你怎么认识$MCG？
$LINE_SIDEQUEST_4_OUTRO_70_CHAR	神秘女子
$LINE_SIDEQUEST_4_OUTRO_70_TEXT	……
$LINE_SIDEQUEST_4_OUTRO_80_CHAR	神秘女子
$LINE_SIDEQUEST_4_OUTRO_80_TEXT	就一次，你忘了。
$LINE_SIDEQUEST_4_OUTRO_90_CHAR	$HEA
$LINE_SIDEQUEST_4_OUTRO_90_TEXT	什么？
$LINE_SIDEQUEST_4_OUTRO_100_CHAR	$HEA
$LINE_SIDEQUEST_4_OUTRO_100_TEXT	我……我说什么了？
$LINE_SIDEQUEST_4_OUTRO_110_CHAR	$BER
$LINE_SIDEQUEST_4_OUTRO_110_TEXT	整整两天没有暴乱。
$LINE_SIDEQUEST_4_OUTRO_120_CHAR	$BER
$LINE_SIDEQUEST_4_OUTRO_120_TEXT	我能感觉到我的杀戮肌肉在萎缩……
$LINE_SIDEQUEST_4_OUTRO_130_CHAR	$HEA
$LINE_SIDEQUEST_4_OUTRO_130_TEXT	或许你应该花点时间平静地沉思一下。
$LINE_SIDEQUEST_4_OUTRO_140_CHAR	$BER
$LINE_SIDEQUEST_4_OUTRO_140_TEXT	平静会杀了我！
$LINE_SIDEQUEST_4_OUTRO_150_CHAR	$MCG
$LINE_SIDEQUEST_4_OUTRO_150_TEXT	好吧，我们从修道院回来了。那里很……
$LINE_SIDEQUEST_4_OUTRO_160_CHAR	$BER
$LINE_SIDEQUEST_4_OUTRO_160_TEXT	不要再离开我！
$SCENE_SIDEQUEST_7_GET_TITLE	秘密存放
$LINE_SIDEQUEST_7_GET_00_CHAR	$MCG
$LINE_SIDEQUEST_7_GET_00_TEXT	所以……就因为是你发现的，所以这房间里的东西都是你的？
$LINE_SIDEQUEST_7_GET_10_CHAR	$DRA
$LINE_SIDEQUEST_7_GET_10_TEXT	人类，你有什么争议吗？
$LINE_SIDEQUEST_7_GET_20_CHAR	$MCG
$LINE_SIDEQUEST_7_GET_20_TEXT	不，不，完全没有。我只是想搞清楚规则是怎样的。
$LINE_SIDEQUEST_7_GET_30_CHAR	$DRA
$LINE_SIDEQUEST_7_GET_30_TEXT	很好。
$LINE_SIDEQUEST_7_GET_40_CHAR	$MCG
$LINE_SIDEQUEST_7_GET_40_TEXT	所以，比如说，如果我发现了一个充满宝物的房间，那么那里的一切就都是我的。
$LINE_SIDEQUEST_7_GET_50_CHAR	$DRA
$LINE_SIDEQUEST_7_GET_50_TEXT	哈，一个渺小的人类能嗅到金子的味道？你的自大让我觉得好笑。
$LINE_SIDEQUEST_7_GET_60_CHAR	$MCG
$LINE_SIDEQUEST_7_GET_60_TEXT	但是如果我找到了，你就必须认为我是合理的所有者了，是吗？
$LINE_SIDEQUEST_7_GET_70_CHAR	$DRA
$LINE_SIDEQUEST_7_GET_70_TEXT	当然。
$LINE_SIDEQUEST_7_GET_80_CHAR	$MCG
$LINE_SIDEQUEST_7_GET_80_TEXT	所以，这个下边的密室里的一切都属于我，是么？
$LINE_SIDEQUEST_7_GET_90_CHAR	$DRA
$LINE_SIDEQUEST_7_GET_90_TEXT	什么？
$LINE_SIDEQUEST_7_GET_100_CHAR	$MCG
$LINE_SIDEQUEST_7_GET_100_TEXT	要知道，暗门打开就能进去的。
$LINE_SIDEQUEST_7_GET_110_CHAR	$MCG
$LINE_SIDEQUEST_7_GET_110_TEXT	可真是个相当古老的堡垒设计：你建了一个宝库，把你的最好的东西都丢了进去。
$LINE_SIDEQUEST_7_GET_120_CHAR	$MCG
$LINE_SIDEQUEST_7_GET_120_TEXT	然后在那之下会有另一个宝库，储藏着真正的宝藏。
$LINE_SIDEQUEST_7_GET_130_CHAR	$MCG
$LINE_SIDEQUEST_7_GET_130_TEXT	入侵者发现第一个藏匿室然后就走了，并不会意识到他们错过了所有的好东西。
$LINE_SIDEQUEST_7_GET_140_CHAR	$MCG
$LINE_SIDEQUEST_7_GET_140_TEXT	如果你读过南方合并战争，你就会知道克莱蒂安·科里蒂奥就是这么设法保住其首都的财物的。
$LINE_SIDEQUEST_7_GET_150_CHAR	$MCG
$LINE_SIDEQUEST_7_GET_150_TEXT	如果你想看的话，我可以借给你。
$LINE_SIDEQUEST_7_GET_160_CHAR	$MCG
$LINE_SIDEQUEST_7_GET_160_TEXT	……伙计，我想知道那下面有什么。
$LINE_SIDEQUEST_7_GET_170_CHAR	$DRA
$LINE_SIDEQUEST_7_GET_170_TEXT	……
$SCENE_SIDEQUEST_7_INTRO_TITLE	火焰之月
$LINE_SIDEQUEST_7_INTRO_00_CHAR	$KNI
$LINE_SIDEQUEST_7_INTRO_00_TEXT	女士，我希望你让我先下去。
$LINE_SIDEQUEST_7_INTRO_10_CHAR	$MCG
$LINE_SIDEQUEST_7_INTRO_10_TEXT	哦，请。
$LINE_SIDEQUEST_7_INTRO_20_CHAR	$KNI
$LINE_SIDEQUEST_7_INTRO_20_TEXT	在我开始演讲我如何需要接受你可以自己处理好这个事实之前，我必须先承认我的动机完全是自私的。
$LINE_SIDEQUEST_7_INTRO_30_CHAR	$MCG
$LINE_SIDEQUEST_7_INTRO_30_TEXT	我不知自己这一辈子是否都有资格享受这样<LQ>自私<RQ>的生命荣誉债务。
$LINE_SIDEQUEST_7_INTRO_40_CHAR	$KNI
$LINE_SIDEQUEST_7_INTRO_40_TEXT	是的，如果我让你死了，你觉得会怎么样呢？
$LINE_SIDEQUEST_7_INTRO_50_CHAR	$MCG
$LINE_SIDEQUEST_7_INTRO_50_TEXT	其他骑士都嘲笑你工作很烂？
$LINE_SIDEQUEST_7_INTRO_60_CHAR	$KNI
$LINE_SIDEQUEST_7_INTRO_60_TEXT	好吧，那么我必须自杀。
$LINE_SIDEQUEST_7_INTRO_70_CHAR	$MCG
$LINE_SIDEQUEST_7_INTRO_70_TEXT	真的吗？哇，那可……我想你应该没我想象中的那么女孩子气。
$LINE_SIDEQUEST_7_INTRO_80_CHAR	$KNI
$LINE_SIDEQUEST_7_INTRO_80_TEXT	什么？
$LINE_SIDEQUEST_7_INTRO_90_CHAR	$MCG
$LINE_SIDEQUEST_7_INTRO_90_TEXT	那是铠甲。不管怎样，我都觉得我们不必担心什么。那只是个古老的宝库。
$LINE_SIDEQUEST_7_INTRO_100_CHAR	$MCG
$LINE_SIDEQUEST_7_INTRO_100_TEXT	但那有很多……死尸。但似乎它们这次真正地、认真地死掉了，这对我们来说真是一件不常有的事……
$LINE_SIDEQUEST_7_INTRO_101_CHAR	神秘女子
$LINE_SIDEQUEST_7_INTRO_101_TEXT	*$MCG·莱博尔。我以为你会来。
$LINE_SIDEQUEST_7_INTRO_102_CHAR	$MCG
$LINE_SIDEQUEST_7_INTRO_102_TEXT	什么？
$LINE_SIDEQUEST_7_INTRO_110_CHAR	神秘女子
$LINE_SIDEQUEST_7_INTRO_110_TEXT	*$MCG·莱博。我知道你会来。
$LINE_SIDEQUEST_7_INTRO_120_CHAR	$MCG
$LINE_SIDEQUEST_7_INTRO_120_TEXT	什么？
$LINE_SIDEQUEST_7_INTRO_130_CHAR	$KNI
$LINE_SIDEQUEST_7_INTRO_130_TEXT	是那个女法师！
$LINE_SIDEQUEST_7_INTRO_140_CHAR	$KNI
$LINE_SIDEQUEST_7_INTRO_140_TEXT	我们得离开这儿。
$LINE_SIDEQUEST_7_INTRO_150_CHAR	神秘女子
$LINE_SIDEQUEST_7_INTRO_150_TEXT	门关上了。我需要你在这。
$LINE_SIDEQUEST_7_INTRO_160_CHAR	$MCG
$LINE_SIDEQUEST_7_INTRO_160_TEXT	你要怎么处理这些尸体？
$LINE_SIDEQUEST_7_INTRO_170_CHAR	神秘女子
$LINE_SIDEQUEST_7_INTRO_170_TEXT	我得找个人谈谈。
$LINE_SIDEQUEST_7_INTRO_180_CHAR	神秘女子
$LINE_SIDEQUEST_7_INTRO_180_TEXT	我说出艾斯里-特诺奇的名字。就一次，你被召唤了！
$LINE_SIDEQUEST_7_INTRO_190_CHAR	艾斯里-特诺奇
$LINE_SIDEQUEST_7_INTRO_190_TEXT	谁？我的……泰都-米期理……
$LINE_SIDEQUEST_7_INTRO_200_CHAR	艾斯里-特诺奇
$LINE_SIDEQUEST_7_INTRO_200_TEXT	火焰之月，渴望一切。你终于和你的仆从们来放解放我了吗？
$LINE_SIDEQUEST_7_INTRO_210_CHAR	泰都-米期理
$LINE_SIDEQUEST_7_INTRO_210_TEXT	不……是解放我们。
$LINE_SIDEQUEST_7_INTRO_211_CHAR	艾斯里-特诺奇
$LINE_SIDEQUEST_7_INTRO_211_TEXT	我已经渴望——
$LINE_SIDEQUEST_7_INTRO_220_CHAR	艾斯里-特诺奇
$LINE_SIDEQUEST_7_INTRO_220_TEXT	不——你说的不可能是真的。
$LINE_SIDEQUEST_7_INTRO_230_CHAR	泰都-米期理
$LINE_SIDEQUEST_7_INTRO_230_TEXT	所以我告诉自己很多年了……但是看看：
$LINE_SIDEQUEST_7_INTRO_240_CHAR	泰都-米期理
$LINE_SIDEQUEST_7_INTRO_240_TEXT	我就站在钥匙旁……但是……我抵抗住了。
$LINE_SIDEQUEST_7_INTRO_250_CHAR	艾斯里-特诺奇
$LINE_SIDEQUEST_7_INTRO_250_TEXT	她在这？！
$LINE_SIDEQUEST_7_INTRO_260_CHAR	泰都-米期理
$LINE_SIDEQUEST_7_INTRO_260_TEXT	是的，我可以抵抗！
$LINE_SIDEQUEST_7_INTRO_270_CHAR	艾斯里-特诺奇
$LINE_SIDEQUEST_7_INTRO_270_TEXT	她在这！那你怎么能不放了我？
$LINE_SIDEQUEST_7_INTRO_280_CHAR	泰都-米期理
$LINE_SIDEQUEST_7_INTRO_280_TEXT	你可以抵抗！你可以自己选择！
$LINE_SIDEQUEST_7_INTRO_290_CHAR	艾斯里-特诺奇
$LINE_SIDEQUEST_7_INTRO_290_TEXT	你这个卑鄙的背叛者！我的孩子会完成你做不了的那些事！
$LINE_SIDEQUEST_7_INTRO_300_CHAR	泰都-米期理
$LINE_SIDEQUEST_7_INTRO_300_TEXT	*$MCG！帮帮我！我们必须控制他！
$SCENE_SIDEQUEST_7_OUTRO_TITLE	萨尔和萨莉
$LINE_SIDEQUEST_7_OUTRO_00_CHAR	泰都-米期理
$LINE_SIDEQUEST_7_OUTRO_00_TEXT	我们身体里的恶魔……使我们变得更卑微。如果我们再次结合的话，世界会在我们手中消失殆尽的。
$LINE_SIDEQUEST_7_OUTRO_10_CHAR	艾斯里-特诺奇
$LINE_SIDEQUEST_7_OUTRO_10_TEXT	不会消耗殆尽。只是净化了。缓和了。净化了软弱和污秽，以及那些渺小的思想匮乏的人类。
$LINE_SIDEQUEST_7_OUTRO_20_CHAR	泰都-米期理
$LINE_SIDEQUEST_7_OUTRO_20_TEXT	我不能……我不能任由我们。
$LINE_SIDEQUEST_7_OUTRO_30_CHAR	艾斯里-特诺奇
$LINE_SIDEQUEST_7_OUTRO_30_TEXT	这……这就是你仍然爱我的方式？
$LINE_SIDEQUEST_7_OUTRO_40_CHAR	艾斯里-特诺奇
$LINE_SIDEQUEST_7_OUTRO_40_TEXT	你忘记了我们是谁！
$LINE_SIDEQUEST_7_OUTRO_50_CHAR	泰都-米期理
$LINE_SIDEQUEST_7_OUTRO_50_TEXT	你忘了我们是谁！我多么渴望回到过去……
$LINE_SIDEQUEST_7_OUTRO_60_CHAR	泰都-米期理
$LINE_SIDEQUEST_7_OUTRO_60_TEXT	在第一次鲜血诞生之前。在鲜血果实和火焰之月之前。在只有萨尔和萨莉的时候。
$LINE_SIDEQUEST_7_OUTRO_70_CHAR	艾斯里-特诺奇
$LINE_SIDEQUEST_7_OUTRO_70_TEXT	这两个名字都已经死了。
$LINE_SIDEQUEST_7_OUTRO_80_CHAR	泰都-米期理
$LINE_SIDEQUEST_7_OUTRO_80_TEXT	如果我们那时就知道我们会成为什么——
$LINE_SIDEQUEST_7_OUTRO_90_CHAR	艾斯里-特诺奇
$LINE_SIDEQUEST_7_OUTRO_90_TEXT	一切都不会有什么改变。
$LINE_SIDEQUEST_7_OUTRO_91_CHAR	泰都-米期理
$LINE_SIDEQUEST_7_OUTRO_91_TEXT	我已经过了……这么多世没有你的生活。在世界的十字路口，我已经以泪洗面，将我的渴望丢弃在哪里。我已经试着把它倒出，来把它填满。
$LINE_SIDEQUEST_7_OUTRO_92_CHAR	泰都-米期理
$LINE_SIDEQUEST_7_OUTRO_92_TEXT	没有任何的喜悦可以治愈我的悲伤。
$LINE_SIDEQUEST_7_OUTRO_93_CHAR	泰都-米期理
$LINE_SIDEQUEST_7_OUTRO_93_TEXT	但是我们的重逢不应该是这样的。让我们抛却我们给自己下的诅咒。让我们重新成为萨尔和萨莉。
$LINE_SIDEQUEST_7_OUTRO_100_CHAR	艾斯里-特诺奇
$LINE_SIDEQUEST_7_OUTRO_100_TEXT	你想要的事情不可能的发生。
$LINE_SIDEQUEST_7_OUTRO_101_CHAR	艾斯里-特诺奇
$LINE_SIDEQUEST_7_OUTRO_101_TEXT	像我这样……这么多年……但是我们不能。
$LINE_SIDEQUEST_7_OUTRO_110_CHAR	艾斯里-特诺奇
$LINE_SIDEQUEST_7_OUTRO_110_TEXT	我们曾经拿起神性王冠！我们独自监督这些乌合之众，审判，引导，屠宰！我们没有回头的余地了。
$LINE_SIDEQUEST_7_OUTRO_120_CHAR	艾斯里-特诺奇
$LINE_SIDEQUEST_7_OUTRO_120_TEXT	我们无法逃开这可怕的责任。
$LINE_SIDEQUEST_7_OUTRO_130_CHAR	泰都-米期理
$LINE_SIDEQUEST_7_OUTRO_130_TEXT	……我在地球表面用鲜血写下了我的名字。
$LINE_SIDEQUEST_7_OUTRO_140_CHAR	泰都-米期理
$LINE_SIDEQUEST_7_OUTRO_140_TEXT	但是我可以与过去一刀两断。
$LINE_SIDEQUEST_7_OUTRO_150_CHAR	艾斯里-特诺奇
$LINE_SIDEQUEST_7_OUTRO_150_TEXT	那么你就是个傻瓜。
$LINE_SIDEQUEST_7_OUTRO_160_CHAR	泰都-米期理
$LINE_SIDEQUEST_7_OUTRO_160_TEXT	求求你——
$LINE_SIDEQUEST_7_OUTRO_170_CHAR	艾斯里-特诺奇
$LINE_SIDEQUEST_7_OUTRO_170_TEXT	你会否定我们的目的么？你会违背你的承诺么？
$LINE_SIDEQUEST_7_OUTRO_180_CHAR	艾斯里-特诺奇
$LINE_SIDEQUEST_7_OUTRO_180_TEXT	你没看见我们不在时世界成了什么样子么？
$LINE_SIDEQUEST_7_OUTRO_190_CHAR	泰都-米期理
$LINE_SIDEQUEST_7_OUTRO_190_TEXT	我们当时造成了更糟糕的局面。
$LINE_SIDEQUEST_7_OUTRO_200_CHAR	泰都-米期理
$LINE_SIDEQUEST_7_OUTRO_200_TEXT	我求求你了！
$LINE_SIDEQUEST_7_OUTRO_210_CHAR	泰都-米期理
$LINE_SIDEQUEST_7_OUTRO_210_TEXT	不……
$LINE_SIDEQUEST_7_OUTRO_220_CHAR	萨莉
$LINE_SIDEQUEST_7_OUTRO_220_TEXT	……萨莉求求你了。解放我们吧。
$LINE_SIDEQUEST_7_OUTRO_230_CHAR	萨莉
$LINE_SIDEQUEST_7_OUTRO_230_TEXT	赐予我毁灭的天赋。
$LINE_SIDEQUEST_7_OUTRO_240_CHAR	艾斯里-特诺奇
$LINE_SIDEQUEST_7_OUTRO_240_TEXT	……
$LINE_SIDEQUEST_7_OUTRO_250_CHAR	艾斯里-特诺奇
$LINE_SIDEQUEST_7_OUTRO_250_TEXT	这是我能留给你的唯一天赋。
$LINE_SIDEQUEST_7_OUTRO_260_CHAR	艾斯里-特诺奇
$LINE_SIDEQUEST_7_OUTRO_260_TEXT	……
$LINE_SIDEQUEST_7_OUTRO_270_CHAR	艾斯里-特诺奇
$LINE_SIDEQUEST_7_OUTRO_270_TEXT	所以过去的最后一件衣服被废除了
$LINE_SIDEQUEST_7_OUTRO_271_CHAR	艾斯里-特诺奇
$LINE_SIDEQUEST_7_OUTRO_271_TEXT	……然后它……不……
$LINE_SIDEQUEST_7_OUTRO_280_CHAR	艾斯里-特诺奇
$LINE_SIDEQUEST_7_OUTRO_280_TEXT	很快这个虚弱的世界就能感觉到神的鞭策之手。
$LINE_SIDEQUEST_7_OUTRO_281_CHAR	艾斯里-特诺奇
$LINE_SIDEQUEST_7_OUTRO_281_TEXT	……或者他死亡的哀悼。
$LINE_SIDEQUEST_7_OUTRO_290_CHAR	艾斯里-特诺奇
$LINE_SIDEQUEST_7_OUTRO_290_TEXT	你让我失去了……比你所知道的更多……
$LINE_SIDEQUEST_7_OUTRO_291_CHAR	艾斯里-特诺奇
$LINE_SIDEQUEST_7_OUTRO_291_TEXT	神性……
$LINE_SIDEQUEST_7_OUTRO_292_CHAR	艾斯里-特诺奇
$LINE_SIDEQUEST_7_OUTRO_292_TEXT	你给了我两个自由。但是哪一个是真正的救赎呢？
$LINE_SIDEQUEST_7_OUTRO_293_CHAR	艾斯里-特诺奇
$LINE_SIDEQUEST_7_OUTRO_293_TEXT	我已经迈出了一步……但是……不……
$LINE_SIDEQUEST_7_OUTRO_294_CHAR	艾斯里-特诺奇
$LINE_SIDEQUEST_7_OUTRO_294_TEXT	不！
$LINE_SIDEQUEST_7_OUTRO_300_CHAR	艾斯里-特诺奇
$LINE_SIDEQUEST_7_OUTRO_300_TEXT	*做好准备，$MCG。
$LINE_SIDEQUEST_7_OUTRO_310_CHAR	艾斯里-特诺奇
$LINE_SIDEQUEST_7_OUTRO_310_TEXT	你会是……全人类的……伟大的引导者。
$LINE_SIDEQUEST_7_OUTRO_320_CHAR	$MCG
$LINE_SIDEQUEST_7_OUTRO_320_TEXT	……
$LINE_SIDEQUEST_7_OUTRO_330_CHAR	$MCG
$LINE_SIDEQUEST_7_OUTRO_330_TEXT	……萨尔和萨莉。
$SCENE_HERMIT_1_INTRO_TITLE	给你的特价！
$LINE_HERMIT_1_INTRO_00_CHAR	隐士
$LINE_HERMIT_1_INTRO_00_TEXT	嘿，陌生人！
$LINE_HERMIT_1_INTRO_10_CHAR	$MCG
$LINE_HERMIT_1_INTRO_10_TEXT	你看着好眼熟。我们见过么？
$LINE_HERMIT_1_INTRO_20_CHAR	隐士
$LINE_HERMIT_1_INTRO_20_TEXT	就算见过了也不能说。虽然这么说——
$LINE_HERMIT_1_INTRO_30_CHAR	隐士
$LINE_HERMIT_1_INTRO_30_TEXT	你有头骨吗？
$LINE_HERMIT_1_INTRO_40_CHAR	隐士
$LINE_HERMIT_1_INTRO_40_TEXT	我不是说你自己的。我可以看出来……
$LINE_HERMIT_1_INTRO_50_CHAR	隐士
$LINE_HERMIT_1_INTRO_50_TEXT	因为，你知道，如果你没有头骨，你的头就会变得奇形怪状，左右摇摆。
$LINE_HERMIT_1_INTRO_60_CHAR	$MCG
$LINE_HERMIT_1_INTRO_60_TEXT	*呃……$BER似乎要收集他们……有点令人不安。
$LINE_HERMIT_1_INTRO_70_CHAR	$MCG
$LINE_HERMIT_1_INTRO_70_TEXT	其实，我很担心他。
$LINE_HERMIT_1_INTRO_80_CHAR	$MCG
$LINE_HERMIT_1_INTRO_80_TEXT	现在也有点担心你。
$LINE_HERMIT_1_INTRO_90_CHAR	隐士
$LINE_HERMIT_1_INTRO_90_TEXT	不，不是亡者头骨！你那疯狂的同伴可以自己保留那些乱七八糟的东西。
$LINE_HERMIT_1_INTRO_100_CHAR	隐士
$LINE_HERMIT_1_INTRO_100_TEXT	我是说……
$LINE_HERMIT_1_INTRO_110_CHAR	隐士
$LINE_HERMIT_1_INTRO_110_TEXT	魔法头骨！
$LINE_HERMIT_1_INTRO_120_CHAR	隐士
$LINE_HERMIT_1_INTRO_120_TEXT	它们由石头、铜或黑曜石制成。亡者有时候会背着它们到处跑。
$LINE_HERMIT_1_INTRO_130_CHAR	隐士
$LINE_HERMIT_1_INTRO_130_TEXT	不管怎样，你要是找到了，就带来给我。我不会亏待你的。
$LINE_HERMIT_1_INTRO_140_CHAR	$MCG
$LINE_HERMIT_1_INTRO_140_TEXT	你要它们做什么？
$LINE_HERMIT_1_INTRO_150_CHAR	隐士
$LINE_HERMIT_1_INTRO_150_TEXT	这是秘密。
$LINE_HERMIT_1_INTRO_160_CHAR	隐士
$LINE_HERMIT_1_INTRO_160_TEXT	如果我告诉你它们味道有多好，那你就会全部留给自己了！
$LINE_HERMIT_1_INTRO_170_CHAR	隐士
$LINE_HERMIT_1_INTRO_170_TEXT	所以我是不会告诉你它们和黑面包，面条搭配在一起是有多美味的。
$LINE_HERMIT_1_INTRO_180_CHAR	隐士
$LINE_HERMIT_1_INTRO_180_TEXT	跟大米和炖李子在一起也很不错。
$LINE_HERMIT_1_INTRO_190_CHAR	隐士
$LINE_HERMIT_1_INTRO_190_TEXT	我的嘴很严。
$SCENE_HERMIT_2_INTRO_TITLE	我们的交易真是太疯狂了！
$LINE_HERMIT_2_INTRO_00_CHAR	$MCG
$LINE_HERMIT_2_INTRO_00_TEXT	等等。我之前见过你们？
$LINE_HERMIT_2_INTRO_10_CHAR	隐士
$LINE_HERMIT_2_INTRO_10_TEXT	*当然了，在勒索斯，记得吗？你朋友$HEA送我去的。
$LINE_HERMIT_2_INTRO_20_CHAR	$MCG
$LINE_HERMIT_2_INTRO_20_TEXT	你有兄弟姐妹什么的吗？
$LINE_HERMIT_2_INTRO_30_CHAR	隐士
$LINE_HERMIT_2_INTRO_30_TEXT	确实有！他住在勒索斯的西南部。我们一共有四个人。
$LINE_HERMIT_2_INTRO_40_CHAR	$MCG
$LINE_HERMIT_2_INTRO_40_TEXT	四胞胎？你们穿的都一样吗？
$LINE_HERMIT_2_INTRO_50_CHAR	隐士
$LINE_HERMIT_2_INTRO_50_TEXT	当然！难道你以为我编故事吗？
$LINE_HERMIT_2_INTRO_60_CHAR	隐士
$LINE_HERMIT_2_INTRO_60_TEXT	什么，我是那种跟在你身后只是为了升级你的装备以交换美味魔法头骨的疯子吗？
$LINE_HERMIT_2_INTRO_70_CHAR	$MCG
$LINE_HERMIT_2_INTRO_70_TEXT	好吧……那很疯狂。
$LINE_HERMIT_2_INTRO_80_CHAR	隐士
$LINE_HERMIT_2_INTRO_80_TEXT	不管怎样，有魔法头骨吗？
$LINE_HERMIT_2_INTRO_90_CHAR	$MCG
$LINE_HERMIT_2_INTRO_90_TEXT	……
$SCENE_HERMIT_3_INTRO_TITLE	一切终将流逝！
$LINE_HERMIT_3_INTRO_00_CHAR	隐士
$LINE_HERMIT_3_INTRO_00_TEXT	你好陌生人！
$LINE_HERMIT_3_INTRO_10_CHAR	$MCG
$LINE_HERMIT_3_INTRO_10_TEXT	又是你？
$LINE_HERMIT_3_INTRO_20_CHAR	隐士
$LINE_HERMIT_3_INTRO_20_TEXT	夫人，我们见过吗？
$LINE_HERMIT_3_INTRO_30_CHAR	$MCG
$LINE_HERMIT_3_INTRO_30_TEXT	我真的不确定……
$LINE_HERMIT_3_INTRO_40_CHAR	$MCG
$LINE_HERMIT_3_INTRO_40_TEXT	也许你不收集魔法头骨，是吗？
$LINE_HERMIT_3_INTRO_50_CHAR	隐士
$LINE_HERMIT_3_INTRO_50_TEXT	你是说魔法头骨？
$LINE_HERMIT_3_INTRO_60_CHAR	隐士
$LINE_HERMIT_3_INTRO_60_TEXT	当然不是，那些东西只是给小孩子的。
$LINE_HERMIT_3_INTRO_70_CHAR	隐士
$LINE_HERMIT_3_INTRO_70_TEXT	我收集神秘头骨！
$LINE_HERMIT_3_INTRO_80_CHAR	隐士
$LINE_HERMIT_3_INTRO_80_TEXT	它们由石头、铜或黑曜石制成。亡者有时候会背着它们到处跑。
$LINE_HERMIT_3_INTRO_90_CHAR	隐士
$LINE_HERMIT_3_INTRO_90_TEXT	很多笨蛋*咳咳，像我哥哥，咳咳*把它们错认为是魔法头骨。
$LINE_HERMIT_3_INTRO_100_CHAR	隐士
$LINE_HERMIT_3_INTRO_100_TEXT	但我向你保证，它们完全是不一样的东西。
$LINE_HERMIT_3_INTRO_110_CHAR	隐士
$LINE_HERMIT_3_INTRO_110_TEXT	味道都完全不同。
$SCENE_HERMIT_4_INTRO_TITLE	城镇里最好的交易！
$LINE_HERMIT_4_INTRO_00_CHAR	隐士
$LINE_HERMIT_4_INTRO_00_TEXT	喂那边的，那个我这辈子一定从未见过的家伙！
$LINE_HERMIT_4_INTRO_10_CHAR	$MCG
$LINE_HERMIT_4_INTRO_10_TEXT	哇，哇啊，追到来这里？
$LINE_HERMIT_4_INTRO_20_CHAR	隐士
$LINE_HERMIT_4_INTRO_20_TEXT	啊，我知道了，你见过我的兄弟。他们喜欢玩智力游戏。
$LINE_HERMIT_4_INTRO_30_CHAR	隐士
$LINE_HERMIT_4_INTRO_30_TEXT	当然，我从未梦到会做出这样的事。
$LINE_HERMIT_4_INTRO_40_CHAR	隐士
$LINE_HERMIT_4_INTRO_40_TEXT	随便干扰顾客的脑袋可不是什么好生意。
$LINE_HERMIT_4_INTRO_50_CHAR	$MCG
$LINE_HERMIT_4_INTRO_50_TEXT	……那当然了。
$LINE_HERMIT_4_INTRO_60_CHAR	$MCG
$LINE_HERMIT_4_INTRO_60_TEXT	你收集魔法，神秘和其他古怪的头库吗？
$LINE_HERMIT_4_INTRO_70_CHAR	隐士
$LINE_HERMIT_4_INTRO_70_TEXT	都收集！你有吗？
$LINE_HERMIT_4_INTRO_80_CHAR	$MCG
$LINE_HERMIT_4_INTRO_80_TEXT	我会去查一下的，谢谢你“没有随便干扰我的脑袋”。
$LINE_HERMIT_4_INTRO_90_CHAR	隐士
$LINE_HERMIT_4_INTRO_90_TEXT	*拜托，我怎么会对待像你这样的老朋友呢，$MCG。
$LINE_HERMIT_4_INTRO_100_CHAR	$MCG
$LINE_HERMIT_4_INTRO_100_TEXT	……
$LINE_HERMIT_4_INTRO_110_CHAR	隐士
$LINE_HERMIT_4_INTRO_110_TEXT	我是指，我兄弟的老朋友！他们向我提起过你！
$LINE_HERMIT_4_INTRO_120_CHAR	隐士
$LINE_HERMIT_4_INTRO_120_TEXT	这很明显嘛，我是说，否则我怎么知道你的名字呢？
$LINE_HERMIT_4_INTRO_130_CHAR	隐士
$LINE_HERMIT_4_INTRO_130_TEXT	我才没有每晚偷偷摸摸的潜入你的营地，偷看你的日记，偷取你的补给品，好让我能继续隐士生活呢！
$LINE_HERMIT_4_INTRO_140_CHAR	隐士
$LINE_HERMIT_4_INTRO_140_TEXT	对了我想起来了，“雅琪”到底是什么样的中间名啊？我要说，你一定非常恨你父母取了这么一个名字。
$LINE_HERMIT_4_INTRO_150_CHAR	$MCG
$LINE_HERMIT_4_INTRO_150_TEXT	……
$LINE_HERMIT_4_INTRO_160_CHAR	隐士
$LINE_HERMIT_4_INTRO_160_TEXT	对了，升级！