flag	content	comment
$BASE_ATTACK	Grundangriff
$BATTLE_STARTING_FORMATION_TEXT	Gleiche Aufstellung wie beim letzten Mal benutzen?
$BONUS_DEFENSE	Bonus-Verteidigung
$BOOK_COOL_MULT	Zauber Abklingzeit x<X>
$BOOK_COST_MULT	Zauberkosten x
$BOOK_PSI_TAX	PSI-Steuern: <X>
$CANT_AFFORD_NUMS	font:16,x_off:1,y_off:-4
$CONFIRM_QUIT_TEXT	<RE>$CONFIRM_RESTART_TEXT
$CONFIRM_QUIT_TITLE	Die Schlacht verlassen?
$CONFIRM_RES_CHANGE	Auflösung geändert.<N> Gefällt sie dir?<N><N> RÜCKGÄNGIG IN <SECONDS> SEKUNDEN.
$CONFIRM_RESTART_TEXT	Du wirst alles bis hier hin an Erfahrungspunkten und Geld verlieren.
$CONFIRM_RESTART_TITLE	Schlacht neu starten?
$DATA_DUMP_AUDIO	Exportiere Audio …
$DATA_DUMP_BACKGROUNDS	<RE>$DATA_DUMP_BKG
$DATA_DUMP_BKG	Exportiere Hintergrundbilder ...
$DATA_DUMP_CUTSCENE	Exportiere Zwischensequenz-Bilder ...
$DATA_DUMP_CUTSCENES	<RE>$DATA_DUMP_CUTSCENE
$DATA_DUMP_DATA	Exportiere Datendateien ...
$DATA_DUMP_EMBED	Exportiere eingebundene Grafiken
$DATA_DUMP_IMAGES	Exportiere Datenbilder …
$DATA_DUMP_LOCALES	Exportiere Sprachdateien ...
$DATA_DUMP_MAP_FILES	Exportiere Karten-Dateien …
$DATA_DUMP_MAP_IMAGES	Exportiere Karten-Bilder …
$DATA_DUMP_MOD_INFO	Exportiere Mod-Info …
$DATA_DUMP_MUSIC	Exportiere Musik...
$DATA_DUMP_SFX	Exportiere SFX...
$DATA_DUMP_SPRITES	Exportiere Sprites...
$DATA_DUMP_TABLES	Exportiere Datentabellen …
$DECIMATE_BY	Dezimiere um <PERCENT>%
$DEMO_OVER_ACTS	Akte<N>III & IV
$DEMO_OVER_DONT_FORGET	Vergiss deinen Spielstand nicht!
$DEMO_OVER_ENORMOUS	Klicke auf den enormen Knopf, um deine Aufgabe fortzusetzen!
$DEMO_OVER_ENORMOUS_2	Klicke auf einen enormen Knopf, um deine Aufgabe fortzusetzen!
$DEMO_OVER_EXPORT_HOW	Exportiere deinen Spielstand mit diesem Knopf.
$DEMO_OVER_FULL_GAME	Hol dir die VOLLVERSION!
$DEMO_OVER_FULL_GAME_NUMS	y_off:-15,x_off:0
$DEMO_OVER_FULL_GAME_SHORT	VOLL<N>VERSION!
$DEMO_OVER_PLAY	Bleib ein Spieler!
$DEMO_OVER_PLEASE_WAIT	<RE>$MISC_PLEASE_WAIT
$DEMO_OVER_THANKS	Vielen Dank fürs Spielen!
$DEMO_OVER_USE_IT	Benutze ihn, um dort weiterzumachen, wo du aufgehört hast!
$EN_SPELL_DRAGON_FIRE_1_DESC	<DMG> Schaden
$EN_SPELL_DRAGON_FIRE_2_DESC	<LOW>-<HIGH> Schaden
$EN_SPELL_FRENZY_DESC	<PLUS><PERCENT> Schnelle für <SEC> Sek
$EN_SPELL_HEAL_DESC	Heile: <PERCENT> TP
$END	Ende
$ERROR_CONTEXT	Kontext
$ERROR_MESSAGE	Nachricht
$ERROR_NUMBER	Fehler #
$ERROR_STACK	Stack Trace
$ERROR_TITLE	Ein Fehler ist aufgetreten.
$FB_HARD_SELL_NO	Ich sagte niemals!
$FB_HARD_SELL_TEXT	Bist du dir da sicher?<N> Schau, wie es glänzt!
$FB_HARD_SELL_YES	Na gut ... okay.
$FB_LIKE_US_NO	Hahaha. Nein.
$FB_LIKE_US_TEXT	Folge uns auf Facebook und<N>erhalte diesen Preis GRATIS!
$FB_LIKE_US_YES	Okay!
$FB_PERSISTENT_OK	Der Sieg ist mein!
$FB_PERSISTENT_TEXT	Okay, du gewinnst!<N>Du kannst es trotzdem haben :)
$FB_REBEL_TEXT	Richtig so, gib's ihnen! <N> Nimm stattdessen dies.
$FB_SECOND_PITCH	Du kannst dies immer noch kriegen, <N> indem du uns auf Facebook folgst!
$FB_SECOND_PITCH_NO	Niemals!
$FB_SECOND_PITCH_YES	Okay!
$FB_THANKS_OK	Okay
$FB_THANKS_SUCKS	Facebook stinkt
$FB_THANKS_TEXT	Danke für's Folgen auf Facebook! <N> Du hast den Preis bereits!
$FB_THIS_ITEM_WILL_NOW	Dieser Gegenstand wird nun immer in jedem Spieler-Inventar auftauchen.
$FLAV_DESC_ARMOR_BREAK_AMT_GRTR_1	Zerstört <AMT_2DIG><EXTRA> Rüstungspunkte für jeden Punkt bei „Angriff“
$FLAV_DESC_ARMOR_BREAK_AMT_LESS_1	Zerstört 1 Rüstungspunkt für jeden <INV_AMOUNT><EXTRA>. Punkt bei „Angriff“.
$FLAV_DESC_ARMOR_BREAK_DIRECT	Angriff zerstört <AMTDMG><EXTRA> Rüstungspunkte.
$FLAV_DESC_ARMOR_BREAK_SHORT	Angriff zerstört mehrere Rüstungspunkte.
$FLAV_DESC_ARMOR_PIERCE_AMT_GRTR_1	Ignoriert <AMT_1DIG><EXTRA> Rüstungspunkte für jeden Punkt bei „Angriff“.
$FLAV_DESC_ARMOR_PIERCE_AMT_LESS_1	Ignoriert 1 Rüstungspunkt für jeden <INV_AMOUNT><EXTRA>. Punkt bei „Angriff“.
$FLAV_DESC_ARMOR_PIERCE_DIRECT	Angriff ignoriert <AMTDMG><EXTRA> Rüstungspunkte.
$FLAV_DESC_ARMOR_PIERCE_SHORT	Angriff ignoriert einige Rüstungspunkte.
$FLAV_DESC_AUTO_KILL	Feinde mit weniger als <PERCENT>%<EXTRA> TP sterben automatisch.
$FLAV_DESC_AUTO_KILL_SHORT	Feinde, die schwach genug sind, sterben automatisch.
$FLAV_DESC_BLEED	Feind erleidet <PERCENT>%<EXTRA> mehr Schaden durch künftige Treffer für <TIME><EXTRA_TIME> s.
$FLAV_DESC_BLEED_SHORT	Feind erleidet zeitweise mehr Schaden durch künftige Treffer.
$FLAV_DESC_BLINDED	Feindliche Angriffe verfehlen zu <PERCENT>% <EXTRA> für <TIME> s.
$FLAV_DESC_BLINDED_SHORT	Feindliche Angriffe sind für ein paar Sekunden ungenauer.
$FLAV_DESC_BURN	Feind erleidet <AMTDMG><EXTRA> Schaden/s für <TIME><EXTRA_TIME> s. Durch Eis aufgehoben.
$FLAV_DESC_BURN_SHORT	Feind erleidet für eine kurze Zeit Schaden. Durch Eis aufgehoben.
$FLAV_DESC_CHILL	Feind ist um <PERCENT>%<EXTRA> für <TIME><EXTRA_TIME> s verlangsamt. Durch Brennen aufgehoben.
$FLAV_DESC_CHILL_SHORT	Feind ist für einige Sekunden verlangsamt. Durch Brennen aufgehoben.
$FLAV_DESC_CONFUSED	Feinde laufen für <TIME><EXTRA_TIME> s rückwärts.
$FLAV_DESC_CONFUSED_SHORT	Feinde laufen für ein paar Momente rückwärts.
$FLAV_DESC_CRITICAL	Schaden = <AMT_1DIG>x<EXTRA> normal.
$FLAV_DESC_CRITICAL_SHORT	Schaden ist größer als normal.
$FLAV_DESC_DISEASE	Regeneration des Feinds ist um <PERCENT>%<EXTRA> reduziert.
$FLAV_DESC_DISEASE_SHORT	Regeneration des Feinds ist reduziert.
$FLAV_DESC_FREEZE	Feind kann sich für <TIME><EXTRA_TIME> s nicht bewegen. Durch Brennen aufgehoben.
$FLAV_DESC_FREEZE_SHORT	Feind kann sich zeitweise nicht bewegen. Durch Brennen aufgehoben.
$FLAV_DESC_INSPIRE	Freunde fügen <M_MULT_PERCENT>%<EXTRA> mehr Schaden für <TIME><EXTRA_TIME> s zu.
$FLAV_DESC_INSPIRE_SHORT	Feinde fügen für eine kurze Zeit mehr Schaden zu.
$FLAV_DESC_KNOCK_BACK	Feind wird <AMT_1DIG><EXTRA> Felder zurück geworfen.
$FLAV_DESC_KNOCK_BACK_SHORT	Feind wird einige Felder zurück geworfen.
$FLAV_DESC_LIGHT	FINSTERE Feinde erleiden +<AMT_2DIG>x<EXTRA> Schaden & sind für <TIME> s leichter zu treffen.
$FLAV_DESC_LIGHT_SHORT	FINSTERE Feinde erleiden zusätzlichen Schaden & sind leichter zu treffen.
$FLAV_DESC_POISON	Feind erleidet <PERCENT>%<EXTRA> des Angriffsschadens für <TIME><EXTRA_TIME> s.
$FLAV_DESC_POISON_DIRECT	Feind erleidet <AMTDMG>%<EXTRA> des Angriffsschadens für <TIME><EXTRA_TIME> s.
$FLAV_DESC_POISON_SHORT	Feind erleidet für eine kurze Zeit Schaden.
$FLAV_DESC_SINGLE_STUN	Feind kann sich für <TIME><EXTRA_TIME> s nicht bewegen. Kann nur ein Mal gewirkt werden.
$FLAV_DESC_SINGLE_STUN_SHORT	Feind kann sich für einige Sekunden nicht bewegen. Kann nur ein Mal gewirkt werden.
$FLAV_DESC_SLOW	Feind ist für <TIME><EXTRA_TIME> s um <PERCENT>%<EXTRA> verlangsamt.
$FLAV_DESC_SLOW_SHORT	Feind ist permanent verlangsamt.
$FLAV_DESC_STRIKE_THROUGH	Angriff kann bis zu <INTI><EXTRA> zusätzliche Feinde treffen.
$FLAV_DESC_STRIKE_THROUGH_SHORT	Angriff kann mehrere Feinde treffen.
$FLAV_DESC_STUN	Feind kann sich für <TIME><EXTRA_TIME> s nicht bewegen.
$FLAV_DESC_STUN_SHORT	Feind kann sich zeitweise nicht bewegen.
$GETSCRAP1	Ein Haufen aus Müll, Fetzen, kaputtem Werkzeug, und scharfen Stücken schartigen, verrosteten Metalls.<N><N>Wer könnte auch nur ansatzweise etwas davon wollen?
$GETSCRAP2	Anscheinend nutzen die Bewohner der Grube diesen Müll als Währung.
$HERO_BLURB_BAKAL	Ein leise sprechender alter Mönch, nach Vergebung für seine Sünden suchend...
$HERO_BLURB_KETTA	Eine Nomaden-Jägerin, zynisch und lebensüberdrüssig...
$HERO_BLURB_MARKOS	Ein schlachterprobter Ritter, müde vom ewigen Kampf...
$HERO_BLURB_NIRU	Gewalttätig und mysteriös. Dieser Drache teilt keine Geheimnisse...
$HERO_BLURB_SLAK	Ein seltsamer junger Mann, sowohl tapfer als auch labil...
$HERO_BLURB_WRENNA	Die letzte Prinzession Quaids, begierig, ihr gefallenes Königreich zu rächen...
$HIRE_NUMS	font:18,x_off:4,y_off:-6
$LQ	“
$MAP_TEXT_HERMIT	Eremit
$MAP_TEXT_LAIR	Bau
$MAP_TEXT_PRISON	Gefängnis
$MAP_TEXT_SHRINE	Schrein
$MAP_TEXT_TREASURE	Höhle
$MAP_TEXT_UNKNOWN	???
$MCGUFFIN_LEARN_SPELL	<MCG> hat einen neuen Zauber gelernt!
$MISC_1_FOE	1 Feind
$MISC_1_FRIEND	1 Freund
$MISC_ABSORB_X	absorbiere <X>
$MISC_ABSORB_X_RESIST_Y	absorbiere <X>, widerstehe <Y>%
$MISC_ACCEPT	OK
$MISC_ACCEPT_AND_CLOSE	Akzeptieren & schließen
$MISC_ACHIEVEMENT!	Errungenschaft!
$MISC_ADJUST_REWARDS	100% ist die normale Menge. Justiere nach oben oder unten, um die Belohnungen zu ändern.
$MISC_ADVANCED	fortgeschritten
$MISC_ADVANCED_SHORT	Schwer
$MISC_ALL_FOES	Alle Feinde in Reichweite
$MISC_ALL_FOES_IN	Alle Feinde innerhalb von <TILES> Feldern.
$MISC_ALL_FRIENDS	Alle Freunde in Reichweite
$MISC_ALL_FRIENDS_IN	Alle Freunde innerhalb von <TILES> Feldern.
$MISC_ALL_TARGETS	Ziele in Reichweite
$MISC_ALL_TARGETS_IN	Ziele innerhalb von <TILES> Feldern.
$MISC_AMOUNT	Anzahl
$MISC_AMOUNT_SHORT	anz
$MISC_ANONYMOUS	Anonym
$MISC_ARE_YOU_SURE	Bist du sicher?
$MISC_ARMOR	Rüstung
$MISC_ARMOR	Rüstung
$MISC_ARMOR_SHORT	RÜS
$MISC_ASSIGN_POINTS	Punkte<N>zuweisen ???
$MISC_ATTACK	Angriff
$MISC_ATTACK_SHORT	ANG
$MISC_BACK	zurück
$MISC_BASE_ATTACK	Grundangriff
$MISC_BATTLE	Kampf
$MISC_BEGIN	Starten
$MISC_BONUS	Bonus
$MISC_BONUS_DEFENSE	Grundverteidigung
$MISC_BOOST	Verstärken
$MISC_BOOST_X	stärke <X>
$MISC_BREAK_HERO_MODE_TEXT	Du spielst im <LQ>Heldenmodus<RQ>, in dem du keine generischen Charaktere rekrutieren kannst<N>Diesen Modus verlassen und einen Charakter rekrutieren?
$MISC_BREAK_HERO_MODE_TITLE	Heldenmodus verlassen?
$MISC_BUY	kaufen
$MISC_CANCEL	abbrechen
$MISC_IGNORE	Ignorieren
$MISC_CANT_AFFORD	Zu<N>teuer
$MISC_CANT_EQUIP_NUMS	font:12,x_off:0,y_off:-4
$MISC_CANT_EQUIP!	Kann nicht ausrüsten
$MISC_CASUAL	locker
$MISC_CASUAL_SHORT	Locker
$MISC_CHANCE	Wahrscheinlichkeit
$MISC_CHANGE	Wechseln
$MISC_CLICK_HERE	Hier klicken
$MISC_CLOSE	schließen
$MISC_COMPLETE	abgeschlossen
$MISC_COMPLETE!	Vollst-<N>ändig!
$MISC_CONFIG_DIR	Konfig-Ordner
$MISC_CONFIRM	bestätigen
$MISC_CONFIRM_CHANGE	Bestätige Änderung
$MISC_CONFIRM_RECRUIT	Bestätige Rekrutierung
$MISC_CONTINUE	Fortfahren
$MISC_COST	Kosten
$MISC_COST:	Kosten:
$MISC_COUNTER	Konter
$MISC_COUNTER	Konter
$MISC_CREDITS	Abspann
$MISC_CURRENT_SAVE	Derzeitiger Spielstand:
$MISC_CUSTOM_SETTINGS	Ändern...
$MISC_DAMAGE	Schaden
$MISC_DAMAGE_RESIST	Widerstand
$MISC_DAMAGE_SHORT	SCH
$MISC_DARK	finster
$MISC_DARK_DESC	(weicht 75% der Angriffe aus)
$MISC_DEATH_SPLASH	Todesschwall
$MISC_DEF_SHORT	VER
$MISC_DEFAULT	Standard
$MISC_DEFAULT_SETTINGS	Standard (empfohlen für neue Spieler)
$MISC_DEFEAT	Niederlage
$MISC_DEFEND	verteidigen
$MISC_DEFENDER	Verteidiger
$MISC_DEFENDERS	Verteidiger
$MISC_DEFENSE	Verteidigung
$MISC_DEFENSE_ABS	Verteidigung
$MISC_DEFENSE_SHORT	VER
$MISC_DELETE_ACHIEVEMENT	Achievement löschen?
$MISC_DELETE_BOTH_GOG_ACHIEVEMENT	Lokale & GOG-Achievements löschen
$MISC_DELETE_BOTH_STEAM_ACHIEVEMENT	Lokale & Steam-Achievements löschen
$MISC_DELETE_LOCAL_ACHIEVEMENT	Nur lokale Achievements löschen
$MISC_DEMO_VERSION	Demo-Version
$MISC_DEMO_VERSION_DESC	Dies ist die Demoversion von Defender's Quest: Valley of the Forgotten, Deluxe Edition.<N><N>Sie enthält etwa 20% des ganzen Spiels und erlaubt dir, deinen Spielstand in die Vollversion zu importieren, damit du deinen Fortschritt nicht verlierst.
$MISC_DESCRIPTION	Beschreibung
$MISC_DISABLED	deaktiviert
$MISC_DOWNLOAD	Download
$MISC_DQ_NEWS	Hol dir NEUIGKEITEN!
$MISC_DQ_SITE	DefendersQuest.com
$MISC_EASIER	einfacher
$MISC_EASY	einfach
$MISC_EASY_SHORT	Einfach
$MISC_EMPTY	Leer
$MISC_ENABLED	aktiviert
$MISC_ENEMY_LEVELS	Feind-Level:
$MISC_ENTER	betreten
$MISC_ENTER_TEXT	Text eingeben:
$MISC_EQUIP	ausrüsten
$MISC_ERROR	Fehler
$MISC_ERROR_INVALID_MOD_NAME	Ungültiger Mod-Name!
$MISC_ERROR_MOD_BAD	Diese Mod ist nicht kompatibel mit der aktuellen Spielversion. Sorry!
$MISC_ERROR_MOD_EXISTS	Eine Mod mit diesem Namen existiert bereits!
$MISC_ERROR_UNKNOWN	Unbekannter Fehler. Sorry!
$MISC_ERROR_UNZIP	Konnte die Mod nicht entpacken. Ändere den Mod-Pfad in den Optionen oder überprüfe deinen freien Speicher.
$MISC_ERROR!	Fehler!
$MISC_ERROR!	Fehler!
$MISC_EVADE	Ausweichen
$MISC_EVADE_SHORT	AUS
$MISC_EVASION	Ausweichen
$MISC_EXIT	Raus
$MISC_EXPERIENCE	Erfahrung
$MISC_EXTREME	extrem
$MISC_EXTREME_SHORT	Extr.
$MISC_FAIL_TT_TEXT	Wieviel Erfahrung und Kram nach einem verlorenen Kampf abgezogen werden.<N>-50% ist die normale Menge. Justiere nach oben oder unten, um die Strafe zu ändern.
$MISC_FAIL_TT_TITLE	<RE>$UI_ACCESS_FAILURE_PENALTY
$MISC_FAST	schnell
$MISC_FOE_PLURAL	Feinde
$MISC_FOE_SINGULAR	Feind
$MISC_FRIEND_PLURAL	Freunde
$MISC_FRIEND_SINGULAR	Freund
$MISC_GAIN	Zuwachs
$MISC_GAME_DATA	Spieldaten
$MISC_GOLD	Kram
$MISC_GOLD_TT_TEXT	Kram (Geld), den du nach einem Kampf bekommst.<N><RE>[$MISC_ADJUST_REWARDS]
$MISC_GOLD_TT_TITLE	Kram
$MISC_GOLD:	Kram:
$MISC_HARD	<RE>$MISC_EXTREME
$MISC_HARD_SHORT	<RE>$MISC_EXTREME_SHORT
$MISC_HARDER	schwerer
$MISC_HEAL	heilen
$MISC_HERO_MODE	Heldenmodus
$MISC_HERO_MODE_TEXT	Generische Charaktere zu rekrutieren ist verboten.<N>Überhaupt NICHT empfohlen, wenn du das Spiel zum ersten Mal durchspielst!<N><N>ANMERKUNGEN:<N>Du kannst dich später noch umentscheiden, indem du einen generischen Charakter rekrutierst und die Warnung ignorierst.<N><N>Wir empfehlen dir, Erfahrungs- und Kramgewinn auf 300% zu stellen, wenn du im Heldenmodus spielst.<N><N>Diese Einstellung wird nicht für die "Heldenmodus" Achievements benötigt. Die Abwesenheit generischer Charaktere ist genug.
$MISC_HERO_MODE_TITLE	<RE>$MISC_HERO_MODE
$MISC_HIRE	ANHE-<N>UERN!
$MISC_HIRE_Q	Heuere <NAME> aus der Klasse <CLASS> für <SCRAP> Kram an?
$MISC_HP	Trefferpunkte
$MISC_HP_SHORT	TP
$MISC_IMMUNE_TO	<SOMETHING> gegenüber immun
$MISC_INFO	Info
$MISC_JOURNAL	Tagebuch
$MISC_LANGUAGES	Sprachen
$MISC_LEADER	Anführer
$MISC_LEAVE	verlassen
$MISC_LEVEL	Level
$MISC_LEVEL_SHORT	LVL
$MISC_LEVEL_SHORT_X	LVL <X>
$MISC_LEVEL_PARTY_GEM	Level	Appears on character blocks in the party screen
$MISC_LEVEL_WAVE_BLOCK	Level	Appears on enemy wave blocks in battle
$MISC_LEVEL_SUPER_SHORT	L
$MISC_LEVEL_UP!	LEVEL UP!
$MISC_LEVEL_UPX	LEVEL Upx
$MISC_LEVEL_X	Level <X>
$MISC_LOADING	Laden …
$MISC_LOADING_PERCENT	Laden … <PERCENT>%
$MISC_LOCKED	Versch-<N>lossen
$MISC_LVLUP	LVLUP
$MISC_MAKE_CHANGE	Diese Änderungen durchführen?
$MISC_MAX	MAX
$MISC_MEDIUM	<RE>$MISC_ADVANCED
$MISC_MEDIUM_SHORT	<RE>$MISC_ADVANCED_SHORT
$MISC_MENU	Menü
$MISC_MISS	Verfehlt
$MISC_MODS	Mods
$MISC_MORE	Mehr …
$MISC_MOVIES	Szenen
$MISC_NEED_PSI	KEIN<N>PSI
$MISC_NEW_GAME_SETTINGS	Neues Spiel Einstellungen
$MISC_NEXT	weiter
$MISC_NO	nein
$MISC_NO_AFFORD	ZU TEUER
$MISC_NO_CHANGE	keine Änderung
$MISC_NO_HARDWARE	Dein System unterstützt keine Hardwarebeschleunigung. Das Spiel ist trotzdem spielbar, aber wenn es dir zu langsam erscheint, solltest du die Grafikeinstellungen herabsetzen.
$MISC_NOBODY	Niemand
$MISC_NOM!	HAPPS!
$MISC_NONE	kein
$MISC_NONE_DEFAULT	Kein *
$MISC_NORMAL	normal
$MISC_NORMAL_SHORT	Normal
$MISC_NOTHING	nichts
$MISC_NOTHING_TO_EQUIP	Nichts auszurüsten!
$MISC_NOTHING!	nichts!
$MISC_OF_DAMAGE	des Schadens
$MISC_OK	ok
$MISC_OKAY	okay
$MISC_OPTIONS	Optionen
$MISC_OTHER	Andere
$MISC_PARTY	Gruppe
$MISC_PASS	überstanden
$MISC_PERFECT	perfekt
$MISC_PERFECT_BONUS	Perfekt-Bonus:
$MISC_PERFECT!	perfekt!
$MISC_PHASES	instabil
$MISC_PLEASE_ENTER_A_NAME!	Bitte gib einen Namen ein!
$MISC_PLEASE_WAIT	Bitte warten …
$MISC_PLUS_X_STAT	<PLUS><X> <STAT>
$MISC_PLUS_X_TO_ARMOR_ABS	<PLUS_OR_MINUS><X> zu RÜSTUNG
$MISC_PLUS_X_TO_ATTACK	<PLUS_OR_MINUS><X> zu ANGRIFF
$MISC_PLUS_X_TO_ATTACK_SPEED	<PLUS_OR_MINUS><X> zu SCHNELLE
$MISC_PLUS_X_TO_DEFENSE_ABS	<PLUS_OR_MINUS><X> zu VERTEIDIGUNG
$MISC_PLUS_X_TO_HP	<PLUS_OR_MINUS><X> zu TP
$MISC_PLUS_X_TO_RANGE	<PLUS_OR_MINUS><X> zu REICHWEITE
$MISC_PLUS_X_TO_REGEN_ABS	<PLUS_OR_MINUS><X> zu REGENERATION
$MISC_PLUS_X%_TO_ARMOR_MULT	<PLUS_OR_MINUS><X> zu RÜSTUNGS_MULT
$MISC_PLUS_X%_TO_DEFENSE_MULT	<PLUS_OR_MINUS><X>% zu VERTEIDIGUNG
$MISC_PLUS_X%_TO_DODGE	<PLUS_OR_MINUS><X> zu AUSWEICHEN
$MISC_PLUS_X%_TO_EVADE	<RE>$MISC_PLUS_X%_TO_DODGE
$MISC_PLUS_X%_TO_REGEN_MULT	<PLUS_OR_MINUS><X>% zu REGENERATION
$MISC_PORCUPINE	Dornen
$MISC_PREV	letzt.
$MISC_PREVIOUS	zurück
$MISC_PROBLEM?	Problem?
$MISC_PROBLEM?	Problem?
$MISC_PSI	Psi
$MISC_PSI_SHORT	Psi
$MISC_CHANGE_USER	Benutzer ändern
$MISC_WRONG_USER	Mit dem angemeldeten Benutzer ist ein Problem aufgetreten.
$MISC_SIGN_IN	Anmelden
$MISC_QUIT	beenden
$MISC_QUIT	beenden
$MISC_QUIT_BATTLE	Schlacht beenden
$MISC_RANDOM	zufällig
$MISC_RANGE	Reichweite
$MISC_RANGE_SHORT	REW
$MISC_RECRUIT	Rekrutieren
$MISC_REFUSE	ablehnen
$MISC_REGEN	Regenerat.
$MISC_REGEN_LONG	Regeneration
$MISC_REGEN_SHORT	REG
$MISC_RESET	Zurücksetzen
$MISC_RESIST	<SOMETHING> widerstehen
$MISC_RESIST_X	widerstehe <X>%
$MISC_RESTART	neu starten
$MISC_RESTART?	Neustart?
$MISC_RESTORE_DEFAULTS	Standardeinstellungen wiederherstellen
$MISC_REWARD	Belohnung:
$MISC_SAVE_DATA	Spielstände
$MISC_SAVE_ERROR_TEXT	Automatisches Speichern fehlgeschlagen, prüf deine Dateizugriffserlaubnisse?<N>Wir versuchen es später nochmal.
$MISC_SAVE_ERROR_TITLE	Fehler beim Autospeichern!
$MISC_SAVE_FIXED_TEXT	Autospeichern erfolgreich. Sieht so aus, als hättest du das Problem gelöst.<N>Wir halten auch jetzt den Mund.
$MISC_SAVE_FIXED_TITLE	Autospeichern funktioniert!
$MISC_SAVED	gespeichert
$MISC_SAVED!	Gerettet!
$MISC_SCRAP	Kram
$MISC_SECOND	Sekunde
$MISC_SECOND_SHORT	Sek.
$MISC_SECONDS	Sekunden
$MISC_SECONDS_SHORT	Sek.
$MISC_SELECT	Auswählen
$MISC_SELECT_CHALLENGE	Wähle Herausforderung:
$MISC_SELL	verkaufen
$MISC_SEND_NEXT	NÄCHSTE
$MISC_SKILL	Talent
$MISC_SKILLS	Talente
$MISC_SKILLTREE_SKILL_NUMS	font:13,x_off:-2,y_off:0
$MISC_SKIP	über-<N>springen
$MISC_SLOW	langsam
$MISC_SPAWNS	brütet
$MISC_SPECIAL	spezial
$MISC_SPEED	Schnelle
$MISC_SPEED_SHORT	SCH
$MISC_SPELL	Zauber
$MISC_SPLASH_DAMAGE	Umgebungseffekt
$MISC_SPLASH_LINE	<AMT> Schaden, <TILES> Felder
$MISC_SPLASH_TILES	Felder
$MISC_STATS	Statistiken
$MISC_STATUS	Status
$MISC_STRANGER	Fremder
$MISC_STRENGTHS	Stärken
$MISC_SWIMS	schwimmt
$MISC_TALK	Sprechen
$MISC_THORNS	Dornen
$MISC_THRESHOLD	Grenzwert
$MISC_TIPS	Tipps
$MISC_TO	zu
$MISC_TOWN	Stadt
$MISC_TRY_AGAIN	Erneut versuchen
$MISC_TYPES	Typen
$MISC_UNDO	Rückgängig
$MISC_UNDO_ALL	Alles rückgängig
$MISC_UNDO_NUMS	y_off:-6,leading:-4
$MISC_UNEQUIP	Ablegen
$MISC_UNIQUE	einzigartig
$MISC_UNKNOWN	unbekannt
$MISC_UNSAVED	ungespeichert
$MISC_UP_TO_X_FOES	Bis zu <NUM> <FOE>
$MISC_UP_TO_X_FRIENDS	Bis zu <NUM> <FRIEND>
$MISC_UPGRADE	verbessern
$MISC_VERSUS	gegen
$MISC_VICTORY	Sieg
$MISC_VS	vs
$MISC_WAIT	WARTE
$MISC_WALKS_ON	läuft über
$MISC_WARNING	Warnung!
$MISC_WAVE_X	Welle <X>
$MISC_WAVES	Wellen
$MISC_WEAKNESSES	Schwächen
$MISC_WEAPON	<RE>$MISC_WEAPONS
$MISC_WEAPONS	Waffen
$MISC_X_FOES	<NUM> Feinde
$MISC_X_FRIENDS	<NUM> Freunde
$MISC_X_HITS_FOE	<NUM> pro Feind
$MISC_X_HITS_FRIEND	<NUM> pro Freund
$MISC_X_HITS_TARGET	<NUM> pro Ziel
$MISC_X_HITS_TOTAL	<NUM> total
$MISC_X_MORE	<X> mehr …
$MISC_X_PSI	<X> PSI
$MISC_XP	EP
$MISC_YES	ja
$MISC_YOU_SURE	Bist du sicher?
$OVERWORLD_BTN_FONT_NUMS	options:14
$PARTY_1_NEW_ACHIEVE	1 neuer Erfolg!
$PARTY_ACHIEVE_PLURAL	Erfolge
$PARTY_ACHIEVE_SINGULAR	Erfolg
$PARTY_ATTACK	Angriff:<T>
$PARTY_CANT_ARMOR	Kann<N>keine<N>RÜSTUNG<N>nutzen
$PARTY_CANT_WEAPON	Kann<N>keine<N>WAFFEN<N>nutzen
$PARTY_CHANGE_NAME	Namen<N?>ändern
$PARTY_CHANGE_NAME_NUMS	font:12,off_x:0,off_y:-6,leading:-4
$PARTY_CHARACTER	Charakter
$PARTY_CHARACTERS	Charaktere
$PARTY_CONFIRM_CHANGES	Änderungen bestätigen
$PARTY_CONFIRM_POINTS_1_1	Permanent 1 Talentpunkt an 1 Charakter verteilen?
$PARTY_CONFIRM_POINTS_1_X	Permanent 1 Talentpunkt an <CHARS> Charaktere verteilen?
$PARTY_CONFIRM_POINTS_TITLE	Talentpunkte bestätigen
$PARTY_CONFIRM_POINTS_X_1	Permanent <POINTS> Talentpunkte an 1 Charakter verteilen?
$PARTY_CONFIRM_POINTS_X_X	Permanent <POINTS> Talentpunkte an <CHARS> verteilen?
$PARTY_CONTINUE_NUMS	fontmap:20,fonttown:16,fontcontinue:20
$PARTY_DEFEATED_WAVE_X	Welle <X> besiegt
$PARTY_DEFEND	Verteidigen:<T>
$PARTY_EVADE	Ausweichen:<T>
$PARTY_FAIL_PENALTY	Strafe
$PARTY_FAILED	Level nicht geschafft!
$PARTY_FAILED_DESC	<MCG> wurde getötet.
$PARTY_FROM_BATTLE	Vom Kampf
$PARTY_GO_TO_MAP	Zur Karte
$PARTY_HP	TP
$PARTY_NO_AFFORD	Das kannst du dir nicht leisten!<N>Kosten: <COST><N>Kram: <SCRAP>
$PARTY_NO_NEW_ACHIEVE	Keine neuen Erfolge.
$PARTY_NO_POINTS	Es gibt keine neu zuweisbaren Punkte!
$PARTY_PASSED	Level geschafft!
$PARTY_PASSED_ALLY_DEAD_DESC	<ALLY> wurde getötet,<N>aber <MCG> hat überlebt.
$PARTY_PASSED_DESC	<MCG> hat den Kampf<N>mit Verletzungen überlebt.
$PARTY_PASSED_WORD	Geschafft
$PARTY_PASSED+	Level geschafft!+
$PARTY_PASSED+_DESC	<MCG> wurde verletzt!<N><ALLY> hat überlebt!
$PARTY_PASSED++	Level geschafft!++
$PARTY_PASSED++_DESC	<MCG> wurde verletzt!<N><ALLY> hat unverletzt überlebt!
$PARTY_PERFECT	PERFEKT!
$PARTY_PERFECT_ALLY_DEAD_DESC	<MCG> ist unverletzt, aber <ALLY> ist gestorben.
$PARTY_PERFECT_DESC	<MCG> hat unverletzt überlebt!
$PARTY_PERFECT_WORD	Perfekt
$PARTY_PERFECT+	PERFEKT!+
$PARTY_PERFECT+_DESC	<MCG> ist unverletzt!<N><ALLY> wurde verletzt!
$PARTY_PERFECT++	PERFEKT!++
$PARTY_PERFECT++_DESC	<MCG> und <ALLY><N>wurden nicht verletzt!
$PARTY_POINT	Punkt
$PARTY_POINTS	Punkte
$PARTY_PSI	Psi
$PARTY_RANGE	Rechweite:<T>
$PARTY_RE_ASSIGN	Alle Talente von <NAME> neu zuweisen?<N>Kosten: <COST><N>Kram: <SCRAP>
$PARTY_REACHED_WAVE_X	Welle <X> erreicht
$PARTY_REDESIGN	Neu zuweisen
$PARTY_REDESIGN	Neu<N?>zuweisen
$PARTY_REDESIGN_NUMS	font:12,off_x:0,off_y:-6,leading:-4
$PARTY_REGEN	Regeneration:<T>
$PARTY_RENAME	Umbenennen
$PARTY_RESET_POINTS	Zurück-<N>setzen
$PARTY_RESET_POINTS_NUMS	font:12,off_x:0,off_y:-4,leading:-4
$PARTY_RETURN_TOWN	Kehre zur Stadt zurück
$PARTY_SPEED	Schnelle:<T>
$PARTY_TOTAL	Total
$PARTY_WELL_DONE	GUT GEMACHT!
$PARTY_X_NEW_ACHIEVE	<NUM> neue Erfolge!
$PARTY_X_PTS	<X> pts
$PARTY_XP	EP
$REWARD_FINISH	Beendet das Spiel
$REWARD_GOLD	<PLUS> <GOLD> KRAM
$REWARD_NEXT_LEVEL	Schaltet nächstes Level frei
$REWARD_NO_GOLD	Nichts!
$REWARD_NO_XP	Nichts!
$REWARD_QUEST	Quest abgeschlossen
$REWARD_XP	<PLUS> <XP> EP
$RQ	”
$SAVE_SLOT_DELETE	Löschen
$SAVE_SLOT_DELETE_TEXT	Löscht diesen Spielstand permanent von deinem Computer. Du weißt, was du da tust, ja?
$SAVE_SLOT_DELETE_TITLE	Lösche Spielstand
$SAVE_SLOT_EXPORT	Export
$SAVE_SLOT_EXPORT_TEXT	Speichere deinen Spielstand in einer einfachen Textdatei.
$SAVE_SLOT_EXPORT_TITLE	Spielstand in Datei exportieren
$SAVE_SLOT_IMPORT	Import
$SAVE_SLOT_IMPORT_TEXT	Durchsuche deinen Computer nach einem Defender's Quest Spielstand.
$SAVE_SLOT_IMPORT_TITLE	Spielstand aus Datei importieren
$SAVE_SLOT_NEW_GAME	Neues Spiel
$SAVE_SLOT_NEW_GAME_NUMS	font:13,x_off:0,y_off:-9
$SAVE_SLOT_NEW_GAME_PLUS	Neues Spiel+
$SAVE_SLOT_NEW_GAME_PLUS_TEXT	Beginnt ein neues, schwierigeres Abenteuer mit der kompletten bislang gesammelten Erfahrung, Talenten und Ausrüstung. Neues Spiel+ beinhaltet neue Gegnertypen, neue Nebenmissionen, stärkere Ausrüstung und ein erweitertes Tagebuch. <N><N>ANMERKUNG: Der Fortschritt deiner Charaktere wird zwischen dem Originalspiel und dem Neuem Spiel+ GETEILT. Du kannst jederzeit zwischen beiden hin- und herschalten, ohne irgendwas zu verlieren.
$SAVE_SLOT_NEW_GAME_PLUS_TITLE	Neues Spiel+ starten
$SAVE_SLOT_PLAY	Spiel
$SAVE_SLOT_PLAY_PLUS	Spiel+
$SAVE_SLOT_PLAY_PLUS_TEXT	Der Fortschritt deiner Charaktere wird zwischen dem Originalspiel und dem Neuem Spiel+ GETEILT. Du kannst jederzeit zwischen beiden hin- und herschalten, ohne irgendwas zu verlieren.
$SAVE_SLOT_PLAY_PLUS_TITLE	Neues Spiel+ fortsetzen
$SKILL_DESC_ADDS_CHANCE_TO_ALL	Fügt <PERCENT>%<EXTRA> Wahrscheinlichkeit für<FLAV>* allen Angriffen hinzu.
$SKILL_DESC_ADDS_CHANCE_TO_ONE	Fügt <PERCENT>%<EXTRA> Wahrscheinlichkeit für <FLAV>* <LQ><ATTACK><RQ> hinzu.
$SKILL_DESC_ADDS_TO_ALL	Fügt <FLAV>* allen Angriffen hinzu.
$SKILL_DESC_ADDS_TO_ONE	Fügt <FLAV>* <LQ><ATTACK><RQ> hinzu.
$SKILL_DESC_COOLDOWN	abklingen
$SKILL_DESC_DMG	Schaden
$SKILL_DESC_EFFECT	Effekt
$SKILL_DESC_HEAL	Heilen
$SKILL_DESC_HITS	Treffer
$SKILL_DESC_HITS_NUM	# Treffer
$SKILL_DESC_PSI_COST	Psi-Kosten
$SKILL_DESC_SPECIAL	Speziell
$SKILL_DESC_SPLASH	Umgebung
$SKILL_DESC_TARGET	Ziel
$SKILL_DESC_TOTAL_BONUS	Gesamtbonus für <STAT>*<N> wird zu +<AMOUNT><EXTRA>.
$SPECIAL_IMPROVES	Verbessert <FLAVOR>:
$SPECIAL_PLUS_FLAV	Fügt <FLAVOR> hinzu:
$SPECIAL_SAVE_VS	Schutz vor <FLAVOR>, wenn TP >= <PERCENT>%
$STAT_DESC_ARMOR	RÜSTUNG<N>Menge absorbierten Schadens.
$STAT_DESC_ARMOR_ENEMY	RÜSTUNG<N>Menge absorbierten Schadens.
$STAT_DESC_ATTACK	ANGRIFF<N> Techniken fügen mehr Schaden zu.
$STAT_DESC_ATTACK_ENEMY	ANGRIFF<N> Max. durch Angriffe zugefügter Schaden.
$STAT_DESC_BARRIER	BARRIERE<N> Ebenen aus Schutz vor Schaden. Nur extrem mächtige Magie kann dies mindern.
$STAT_DESC_DEFENSE	VERTEIDIGUNG<N> Absorbierter Schaden.
$STAT_DESC_DEFENSE_ENEMY	RÜSTUNG<N> Absorbierter Schaden.
$STAT_DESC_EVADE	AUSWEICHEN<N> Wahrscheinlichkeit, gegnerischen Angriffen auszuweichen.
$STAT_DESC_EVADE_ENEMY	AUSWEICHEN<N> Wahrscheinlichkeit, Angriffen auszuweichen.
$STAT_DESC_FINAL_HIT	FINALER SCHADEN<N> Wie viel Schaden <FINAL_HIT_TARGET> erhält, wenn Feinde das Ende erreichen.
$STAT_DESC_HP	TREFFERPUNKTE<N> Wenn sie 0 erreichen, wirst du aus dem Kampf geworfen.
$STAT_DESC_PHASING	INSTABILITÄT<N> De- und restabilisiert regelmäßig, kann nicht angepeilt und auch nicht getroffen werden, wenn destabilisiert.
$STAT_DESC_RANGE	REICHWEITE<N> Größe des Angriffsradius.
$STAT_DESC_RANGE_ENEMY	<RE>$STAT_DESC_RANGE
$STAT_DESC_REGEN	REGENERATION<N> Wie schnell du deine TP pro s wiederherstellst.
$STAT_DESC_REGEN_ENEMY	REGENERATION<N> Wie schnell TP pro s wiederhergestellt werden.
$STAT_DESC_SPAWN	SPAWNS:<N>
$STAT_DESC_SPEED	SCHNELLE<N> Abklingzeit für Attacken: <N> Alle <SPEED_SHOW_MULT> Punkte wird die Abkling-Geschwindigkeit 1x erhöht.
$STAT_DESC_SPEED_ENEMY	SCHNELLE<N> Wie schnell ein Feind sich bewegt und angreift. 1 Punkt = 1 Feld pro Sekunde.
$STAT_DESC_SPELLS	ZAUBERSPRÜCHE
$STAT_DESC_STRONGS	STÄRKEN
$STAT_DESC_THORNS	DORNEN<N>Wirft so viel Schaden bei Nahkampfangriffen zurück.
$STAT_DESC_WEAKS	SCHWÄCHEN
$STAT_DESC_XP	ERFAHRUNG<N>
$STATE_CRASH_DETAILS	Details:
$STATE_CRASH_PROMPT	Was willst du machen?
$STATE_CRASH_SEND	Report an<N>Entwickler schicken
$STATE_CRASH_SHOW_DUMP	Crash-Dump-<N>Dateien zeigen
$STATE_CRASH_TITLE	Kritischer Fehler!
$STATUS_DESC_ANONYMOUS	<PLUS><PERCENT>% Chance, auszuweichen.
$STATUS_DESC_BLEED	Erleidet +<PERCENT>% Schaden.
$STATUS_DESC_BLINDED	Angriffe verfehlen zu <PERCENT>%.
$STATUS_DESC_BURN	<AMT_1DIG> Schaden/s<N> Durch Eis aufgehoben.
$STATUS_DESC_CHILL	-<PERCENT>% Schnelle.<N> Durch Feuer aufgehoben.
$STATUS_DESC_DARK	Weicht allen Angriffen ohne Umgebungseffekt zu <PERCENT>% aus.
$STATUS_DESC_DARK_FRENZY	<RE>$STATUS_DESC_FRENZY
$STATUS_DESC_DISEASE	Regeneration um <PERCENT>% reduziert.
$STATUS_DESC_EVER_BLEED	<RE>$STATUS_DESC_BLEED
$STATUS_DESC_EVER_POISON	<INTI> Schaden/s.
$STATUS_DESC_FB_BORED	Hält es nicht für nötig, sich zu bewegen.
$STATUS_DESC_FB_EXISTENTIAL	-<PERCENT>% Schnelle, +<PERCENT>% Schadenswiderstand
$STATUS_DESC_FB_HAPPY	<PLUS><PERCENT>% Schnelle.
$STATUS_DESC_FB_LOL	<PLUS><PERCENT>% Schnelle.
$STATUS_DESC_FB_OMG	<PLUS><PERCENT>% Schnelle, -<PERCENT>% Schadenabwehr.
$STATUS_DESC_FB_SAD	-<PERCENT>% Schnelle.
$STATUS_DESC_FIRE	<RE>$STATUS_DESC_BURN
$STATUS_DESC_FREEZE	Kann sich nicht bewegen.<N> Durch Feuer aufgehoben.
$STATUS_DESC_FRENZY	Um <PERCENT>% beschleunigen.
$STATUS_DESC_INSPIRE	<RE>$STATUS_DESC_INSPIRED
$STATUS_DESC_INSPIRED	Attacken fügen +<M_MULT_PERCENT>% Schaden zu.
$STATUS_DESC_INSPIRED_HIT	<RE>$STATUS_DESC_INSPIRED
$STATUS_DESC_LIGHT	Entfernt Finsternis.
$STATUS_DESC_POISON	<INTI> Schaden/s für <TIME> s.
$STATUS_DESC_SINGLE_STUN	Kann sich nicht bewegen. Dies kann nur ein Mal gewirkt werden.
$STATUS_DESC_SLOW	-<PERCENT>% Schnelle.
$STATUS_DESC_STUN	Kann sich nicht bewegen.
$STATUS_DESC_TROLL	Weicht Attacken zu <PERCENT> % aus.
$STATUS_TIME_FOREVER	Hält für immer vor.
$STATUS_TIME_LEFT	<TIME_LEFT>/<TIME> Sekunden übrig.
$STRONG_DMG_MULT	<PERCENT>% Widerstand vs. <FLAVOR>
$STRONG_EVADE	<PERCENT>%, um <FLAVOR> auszuweichen
$TALK_ASH	ASH-FLÜCHTLING
$TALK_CULTIST	KULTISTEN-PRIESTER
$TALK_NOMAD	NOMADEN-FLÜCHTLING
$TALK_QUAID	QUAID-FLÜCHTLING
$TARGET_BOSS_TEXT	Wenn nicht aktiviert, ignoriere Bossgegner.
$TARGET_BOSS_TITLE	Auf BOSS zielen
$TARGET_BOTH_TEXT	Benutze Techniken passend zum Stärkungs-Level.
$TARGET_BOTH_TITLE	Normale Priorität
$TARGET_BULLDOG_TEXT	Niemals das Ziel ändern, bis der Gegner die Reichweite verlässt oder stirbt. <N><N> Ziemlich knifflig, nur erfahrenen Spielern empfohlen!
$TARGET_BULLDOG_TITLE	BULLDOGGEN-Modus
$TARGET_CHANCE_TEXT	Ziele auf den Gegner, für den ein Ausweichen oder Widerstehen des Angriffs am unwahrscheinlichsten ist.
$TARGET_CHANCE_TITLE	Größte CHANCE
$TARGET_CHEAP_TEXT	Spare hochwertige Techniken für Ziele ein, die nicht durch schwächere getötet werden können.
$TARGET_CHEAP_TITLE	GÜNSTIGSTE Technik
$TARGET_EFFECT_TEXT	Benutze Statuseffekte gegen die am wenigsten beeinträchtigten Gegner. Vermeide Ziele, die nicht beeinträchtigt werden.
$TARGET_EFFECT_TITLE	EFFEKTE optimieren
$TARGET_FAST_TEXT	Ziele auf den schnellsten Gegner.
$TARGET_FAST_TITLE	Auf SCHNELLSTEN zielen
$TARGET_FIGHT_TEXT	Greife wann immer möglich an, selbst wenn eine bessere Heiltechnik bereit ist.
$TARGET_FIGHT_TITLE	KÄMPFEN bevorzugen
$TARGET_FIRST_TEXT	Ziele auf den dem Ende nächsten Feind.
$TARGET_FIRST_TITLE	Auf ERSTEN zielen
$TARGET_HEAL_TEXT	Heile wann immer möglich, selbst wenn eine bessere Angriffstechnik bereit ist.
$TARGET_HEAL_TITLE	HEILEN bevorzugen
$TARGET_LAST_TEXT	Ziele auf den dem Ende am weitesten entfernten Feind.
$TARGET_LAST_TITLE	Auf LETZTEN zielen
$TARGET_SAVE_TEXT	Setzt die aktuellen Zieleinstellungen als Standard für diesen Charakter.
$TARGET_SAVE_TITLE	Einstellungen SPEICHERN
$TARGET_SPECIFIC_TEXT	Wähle einen bestimmten Feind aus, ignoriert die anderen.
$TARGET_SPECIFIC_TITLE	BESTIMMTES Ziel
$TARGET_STRONG_TEXT	Ziele auf den Feind, der am meisten TP und Rüstung hat.
$TARGET_STRONG_TITLE	Auf STÄRKSTEN zielen
$TARGET_WEAK_TEXT	Ziele auf den Gegner, der am wenigsten TP und Rüstung hat.
$TARGET_WEAK_TITLE	Auf SCHWÄCHSTEN zielen
$TIP_00_TEXT	<N><N>Manchmal ist es hilfreich, zurück zu gehen und eine frühere Schlacht zu spielen, um im Level aufzusteigen, mehr Gold zu kriegen und bessere Ausrüstung zu kaufen. Du kannst auch die „lockere“ Schwierigkeitsstufe für eine leichtere Herausforderung ausprobieren.
$TIP_00_TITLE	Kommst du nicht weiter?
$TIP_10_TEXT	Du kannst das Spiel mit der Tastatur kontrollieren!<N><N>- Zauber auswählen<N>- Zu beschwörende Charaktere auswählen<N>- Verteidiger stärken/zurückrufen<N>- Das Spiel (de)pausieren<N>- Durch beschworene Verteidiger wechseln<N>- Ziel/Geschwindigkeitsoptionen ändern<N>- Per Tab durch jedes Menü navigieren<N>- Mit der Tastatur die Maus bewegen/klicken<N><N>(Passe die Tasten im Optionsmenü an)
$TIP_10_TITLE	Hotkeys
$TIP_100_TEXT	Beschworene Verteidiger zurückzurufen gibt einen Teil des ausgegebenen Psis wieder.<N><N>Die Menge an Psi ist geringer, wenn der Verteidiger verletzt ist.
$TIP_100_TITLE	Zurückrufen
$TIP_110_TEXT	Falls du physische Behinderungen hast, schau dir die folgenden Optionen an:<N><N>1) Video – spiele im Vollbildmodus, vergrößere das Bild<N>2) Steuerung – Ändere die Steuerung<N>3) Schwierigkeit – ändere Effekte, Spielgeschwindigkeit und den Erfahrungs-Multiplikator
$TIP_110_TITLE	Barrierefreiheit
$TIP_120_TEXT	Dieser Hinweis ist lediglich eingebaut, damit niemand versucht, Code zu analysieren oder Enigmas zu dechiffieren.
$TIP_120_TITLE	Öffentliche Bekanntmachung
$TIP_130_TEXT	Wenn du auf einen Verteidiger klickst, kannst du dessen Zieloptionen so einstellen, dass dieser Gegner, die vorne, hinten, stark, schwach oder schnell sind zu bevorzugen – benutze dies, um deine Attacken zu optimieren. Zum Beispiel kann dir „stark“ helfen, dich auf größere Einheiten zu konzentrieren oder um eine ganze Menge zu schwächen.
$TIP_130_TITLE	Zieloptionen
$TIP_140_TEXT	Zusätzlich zu normalen Zieloptionen gibt es vier optionale Einstellungen:<N><N>1) Günstigste Technik <N>2) Effekte optimieren <N>3) Größte Chance <N>4) Bulldoggen-Modus<N><N>Diese sind nicht notwendig, können aber fortgeschrittenen Spielern helfen, ihre Kampfstrategien zu verbessern. Du kannst auch Standard-Zieloptionen für einen Charakter speichern!
$TIP_140_TITLE	Erweitertes Zielen
$TIP_150_TEXT	Feuer und Eis kommen nicht gut miteinander aus. Frost und Eis werden Feuer aufheben, Feuer wird Eis schmelzen und Frost aufheben.
$TIP_150_TITLE	Feuer und Eis
$TIP_160_TEXT	Die „Fortgeschritten“- und „Extrem“-Schwierigkeiten sind üblicherweise zu schwer, um sofort ausprobiert zu werden.<N><N>Probiere sie aus, nachdem du die nächsten paar Level auf Normal geschafft hast.
$TIP_160_TITLE	Höhere Schwierigkeiten
$TIP_170_TEXT	Wenn du neue Ausrüstung für deine Helden kaufst, kannst du dein altes Zeug sehr gut an die anderen Gruppen-Mitglieder geben.
$TIP_170_TITLE	Ausrüstung
$TIP_180_TEXT	Verteidiger nah beieinander zu gruppieren führt dazu, dass Feinde ihre Attacken aufspalten, sodass es leichter für die Verteidiger ist, zu überleben.<N><N>Der Nachteil dieser Strategie ist, dass du weniger Fläche abdeckst.
$TIP_180_TITLE	Stärke durch Menge
$TIP_190_TEXT	Wenn du die Aufstiegsgeschwindigkeit des Spiels anpassen möchtest, kannst du den globalen Erfahrungs-Multiplikator in den Optionen ändern.<N><N>Die Standard-Einstellung ist 100%.<N><N>Du kannst auch den Multiplikator für Kram ändern.
$TIP_190_TITLE	Belohnungs-Multiplikator
$TIP_20_TEXT	Jeder Verteidiger erhält mit jedem erlangten Level 1 Talentpunkt.<N><N>Weise diese Punkte im Gruppen-Menü zu, um neue Fähigkeiten im Kampf freizuschalten.<N><N>1) TECHNIKEN (rund) – Attacken, die im Kampf eingesetzt werden<N>2) MERKMALE (quadratisch) – passive, „immer-aktive“ Fähigkeiten.<N><N>Fortgeschrittenere Fähigkeiten benötigen eine Verstärkung im Kampf.
$TIP_20_TITLE	Talente
$TIP_200_TEXT	Manchmal kann dir eine spezielle Technik Probleme bereiten (vielleicht schmelzen deine Drachen-Feuerbälle all dein Eis) oder du möchtest einfach eine starke Attacke für später aufsparen. Dann kannst du auf einen Verteidiger klicken und im Menü unten rechts auf die Technik klicken, um sie zu temporär zu deaktivieren.
$TIP_200_TITLE	Techniken ausschalten
$TIP_210_TEXT	Im Speichermenü gibt es einen Knopf mit Bild eines Ordners und einer Diskette.<N><N>Dieser wird dich zu dem Ordner bringen, in dem deine gespeicherten Spiele und Einstellungen gespeichert sind.
$TIP_210_TITLE	Wo sind meine Spielstände?
$TIP_220_TEXT	Nachdem du das reguläre Spiel beendet hast, kannst du ein neues Abenteuer mit deiner alten Gruppe starten, eines mit schwierigeren Kämpfen und verrückten Belohnungen!<N><N><RE>[$NEW_GAME_PLUS_NOTE]
$TIP_220_TITLE	Neues Spiel+
$TIP_230_TEXT	Im NS+-Modus kannst du besondere Artefakte verdienen, die du nutzen kannst, um einzigartige Ausrüstung aus dem normalen Spiel zu verbessern. Diese verbesserten Gegenstände haben besondere Kräfte!
$TIP_230_TITLE	Verbesserungen
$TIP_240_TEXT	Sobald du genügend Sterne verdient hast, wirst du anfangen, Bonuskämpfe freizuschalten. Diese besonderen Missionen haben extra Herausforderungen und extra Belohnungen.
$TIP_240_TITLE	Bonus-Missionen
$TIP_250_TEXT	Der Blitzzauber hat „Psibrand“, was jedes Mal einen Teil des feindlichen Psis verbrennt. Falls der Zauber dem Feind 40% Schaden zufügt, wird 40% der ursprünglichen Psi-Belohnung entfernt.
$TIP_250_TITLE	Psi-Brand?
$TIP_260_TEXT	Wusstest du, dass du deine eigenen Mods (Modifikationen) für Defender's Quest erstellen kannst?<N><N>Clicke auf den Schraubenschlüssel im Speichermenü. Du kannst fast alles ändern – Eigenschaften, Level, Klassen, Charaktere, Zwischensequenzen, Grafiken, Gegenstände, usw.
$TIP_260_TITLE	Mod-Unterstützung
$TIP_270_TEXT	<N><N>Ruf deine Mutter an, sie vermisst dich.
$TIP_270_TITLE	Denk an deine Mutter
$TIP_30_TEXT	<N><N>Nach einem Kampf kriegen alle dieselbe Menge Erfahrung, die am Ende lebendig und beschworen waren.<N><N>Alle anderen erhalten die Hälfte an Erfahrung. EP pro Charakter ist gleich, unabhängig von der Anzahl an Charakteren.<N><N>Diesen Malus kannst du im Schwierigkeits-Menü ändern.
$TIP_30_TITLE	Wer erhält Erfahrung?
$TIP_40_TEXT	Du kannst Klicken und Ziehen, um die Weltkarte zu verschieben, oder mit der Tastatur navigieren.<N><N>Standardmäßig werden die Pfeiltasten zum Scrollen genutzt.
$TIP_40_TITLE	Oberwelt
$TIP_50_TEXT	Verteidiger zurückzurufen bringt normalerweise nur einen Teil des ausgegebenen Psis.<N><N>Rufst du sie aber vor der ersten Gegnerwelle zurück, bekommst du das Psi vollständig zurück.
$TIP_50_TITLE	Für 100% Psi rückrufen
$TIP_60_TEXT	Wenn du eine Frage hast, werde Teil der Defender's-Quest-Community auf www.defendersquest.com!<N><N>Wir haben ein Forum, in dem du Fragen stellen kannst, ein gemeinschaftliches Wiki und ein Entwicklerblog.
$TIP_60_TITLE	Webseite und Forum
$TIP_70_TEXT	Du kannst die Tastatur benutzen, um Verteidiger im Kampf zu platzieren.<N><N>Standardmäßig werden dafür die Pfeiltasten benutzt.
$TIP_70_TITLE	Verteidiger platzieren
$TIP_80_TEXT	Die Farben der hüpfenden Zahlen kennzeichnen den Schadenstyp. Weiß ist normal, grau ist durch Rüstung reduziert, rot ist blutend, orange Feuer, lila Gift und groß bedeutet einen kritischen Treffer.<N><N>Du kannst sie in den Optionen unter „Sonstiges“ an- und ausschalten.
$TIP_80_TITLE	Kampfeffekte
$TIP_90_TEXT	Wenn du Level auf höheren Schwierigkeiten spielst, wirst du hin und wieder einzigartige Gegenstände finden. Diese sind mächtige Sammelgegenstände und können nicht in Geschäften verkauft werden.
$TIP_90_TITLE	Einzigartige Gegenstände
$TIP_NUMS	font:13
$TITLE_BONUS_GOODIES	Bonusinhalt
$TITLE_BONUS_GOODIES_2	Geheimnisse?
$TITLE_CONNECTING_KONG	Verbinde zu KONG …
$TITLE_EULA_1	Durch Spielen akzeptierst du unseren
$TITLE_EULA_2	Endnutzer-Lizenzvertrag („EULA“)
$TITLE_FULL_GAME	VOLLVERSION
$TITLE_OPTIONS	Optionen
$TITLE_PLEASE_WAIT	<RE>$MISC_PLEASE_WAIT
$TITLE_QUIT	Beenden
$TITLE_RELOAD_MOD	Mod wieder aktivieren
$TITLE_START	Start
$TITLE_START_DEMO	DEMO starten
$TITLE_START_GAME	SPIEL starten
$TITLE_UNLOAD_MOD	Mod deaktivieren
$TOOLTIP_ADVANCED	Schwere Herausforderung, mit besseren Belohnungen.<N><N> Komm zurück, wenn du stark genug bist.
$TOOLTIP_CASUAL	Im lockeren Modus haben Gegner weniger Trefferpunkte und Angriffsschaden.
$TOOLTIP_CHANGE_PATH_1	NOTIZ:
$TOOLTIP_CHANGE_PATH_2	Deine alten Dateien werden nicht automatisch zum neuen Ort transferiert.<N><N>Sie bleiben im ursprünglichen Verzeichnis.
$TOOLTIP_EXTREME	Extreme Herausforderung, mit den besten Belohnungen <N><N> Sei vorbereitet!
$TOOLTIP_NORMAL	Normale Herausforderung.<N><N> Die meisten Spieler sollten hier anfangen.
$TYPE_ARMOR	Gepanzert
$TYPE_ATTACKER	Angreifer
$TYPE_BOSS	Boss
$TYPE_CULTIST	Kultist
$TYPE_DARK	Finster
$TYPE_EXALTED	Erhaben
$TYPE_FAST	Schnell
$TYPE_NO_END_DAMAGE	KeinEndSchaden
$TYPE_NORMAL	Normal
$TYPE_NUKE_ON_KILL	BombeBeiTod
$TYPE_REVENANT	Wiedergänger
$TYPE_SHEEP	Schaf
$TYPE_SNAIL	Schnecke
$TYPE_SPITTER	Spucker
$TYPE_SPLITTER	Spalter
$TYPE_STATIONARY	Stationär
$TYPE_TELEPORTER	Teleporter
$TYPE_WATER	Wasser
$TYPE_WORM	Wurm
$UI_ACCEPT_NUMS	font:18,off_y:1,off_x:-3
$UI_ACCESS_ABSENCE	NICHT-<N>NUTZEN
$UI_ACCESS_DEFAULT	*Standardeinstellungen
$UI_ACCESS_FAIL	SCHEITERN
$UI_ACCESS_FAILURE_PENALTY	Niederlagen-Strafe
$UI_ACCESS_FLASHING	Blink-Effekte
$UI_ACCESS_NUMS	speed_off_x:-65,radio_space_y:7,font:18,off_y:1,off_x:-2,show_boxes:1,absence_off_x:0
$UI_ACCESS_PENALTIES	NEGATIV-EFFEKTE
$UI_ACCESS_REWARDS	ERLEICHTERUNGEN
$UI_ACCESS_SEE_ALSO	Siehe auch:
$UI_ACCESS_SPEED	Spielgeschwindigkeit
$UI_ACCESS_TITLE	Schwierigkeit
$UI_ACHIEVE_CATEGORIES	Kategorien
$UI_ACHIEVE_COMPLETION	Fertigstellung
$UI_ACHIEVE_EASY	Einfach
$UI_ACHIEVE_HARD	Schwer
$UI_ACHIEVE_IMPOSSIBLE	Unmöglich
$UI_ACHIEVE_MEDIUM	Mittel
$UI_ACHIEVE_POP_UP	Meldungen
$UI_ACHIEVE_TRAINER	Trainer
$UI_ACHIEVEMENTS_BUTTON_NUMBERS	font:18,offy:-2
$UI_ACHIEVEMENTS_NUMS	font:18,off_y:0,pop_up_off_y:0,desc_font:11,title_font:11,popup_font:16
$UI_ACHIEVEMENTS_TITLE	Erfolge
$UI_ALL_FILES	Alle Dateien
$UI_AUDIO_NUMS	font:18,off_y:1,off_x:-2
$UI_AUDIO_TITLE	Audio
$UI_BACK_NUMS	font:18,off_y:1,off_x:-3
$UI_BATTLE_CASH_OUT	Ausbe-<N>zahlen
$UI_BATTLE_CASH_OUT_NUMS	y_off:-6,leading:-3
$UI_BATTLE_CASH_OUT_TEXT	Die Schlacht jetzt beenden und alle Belohnungen, die du verdient hast, einsammeln?
$UI_BATTLE_CASH_OUT?	Ausbezahlen?
$UI_BATTLE_MORE	MEHR
$UI_BATTLE_NEXT	NÄCHSTE
$UI_BATTLE_SEND_NEXT	Schicke<N>NÄCHSTE
$UI_BATTLE_WAVE	Welle
$UI_BATTLE_WAVES	Wellen
$UI_BONUS_BLUE_STARS_LINE	<STAR_NUM> blaue<N>Sternen
$UI_BONUS_BONUS_LEVELS	Bonuslevel
$UI_BONUS_GOLD_STARS_LINE	<STAR_NUM> goldenen<N>Sternen
$UI_BONUS_NUMS	select_font:14,locked_font:11
$UI_BONUS_STARS_LINE	<STAR_NUM> <STAR_COLOR> Sterne
$UI_CLOUD_UNKNOWN	Cloud-Spielstände
$UI_CLOUD_UNKNOWN_TEXT	Aktiviere Steam-Cloud-Spielstände?
$UI_CLOUD_UNKNOWN_TEXT_2	Ändere diese Einstellung jederzeit unter:<N>Optionen:Sonstiges
$UI_CONFLICT_BACKUP	Sichere die Datei, die ich nicht auswähle, unter:<N><LOC>
$UI_CONFLICT_BETTER	Wir denken, dass dies besser ist
$UI_CONFLICT_BUTTON	Benutze dies
$UI_CONFLICT_CLOUD	CLOUD
$UI_CONFLICT_LOCAL	COMPUTER
$UI_CONFLICT_CONSOLE	Spielkonsole
$UI_CONFLICT_MSG	Wir wissen nicht, was hiervon in Position <SLOT> soll.<N>Bitte wähle das aus, was du behalten möchtest.
$UI_CONFLICT_NGP	Neues Spiel+
$UI_CONFLICT_TITLE	Cloud-Konflikt!
$UI_CONTROLS_ACCEL	Beschleu-<N>nigung
$UI_CONTROLS_ACCEL_NUMS	font:13,off_x:0,off_y:0,text_off_x:0,text_off_y:-8
$UI_CONTROLS_ACCEPT	OK
$UI_CONTROLS_ACCEPT_SELECT	OK/Wählen
$UI_CONTROLS_AUTO	Auto-Finden
$UI_CONTROLS_BACK	Zurück
$UI_CONTROLS_BACK_CANCEL	Zurück/Abbruch
$UI_CONTROLS_BOOST	Stärken
$UI_CONTROLS_CANCEL	Abbruch
$UI_CONTROLS_CHARACTER	Charakter
$UI_CONTROLS_CLASS	Klasse
$UI_CONTROLS_CLICK	Klicken
$UI_CONTROLS_CURSOR	Cursor
$UI_CONTROLS_CYCLE	Verteidiger<N>durch-<N>wechseln
$UI_CONTROLS_CYCLE_NUMS	off_x:-5,text_off_y:-8
$UI_CONTROLS_DEVICE	Gerät
$UI_CONTROLS_FAST	Schnell
$UI_CONTROLS_GAMEPAD	Gamepad
$UI_CONTROLS_GAMEPAD_MODEL	Model
$UI_CONTROLS_KEYBOARD	Maus & Tastatur
$UI_CONTROLS_LOGITECH	Logitech
$UI_CONTROLS_MENU	Menü
$UI_CONTROLS_MENU_ALT	Menü 2
$UI_CONTROLS_MINUS_PLUS_SPEED	-/+<N>Tempo
$UI_CONTROLS_MINUS_SPEED	langsamer
$UI_CONTROLS_MOVE_CURSOR	Mauszeiger bewegen:
$UI_CONTROLS_NAVIGATE_MENU	Menü steuern
$UI_CONTROLS_NONE	Keine
$UI_CONTROLS_NORMAL	Normal
$UI_CONTROLS_NUMS	font:18,off_y:1,off_x:-2
$UI_CONTROLS_OUYA	Ouya
$UI_CONTROLS_PAUSE	Pause
$UI_CONTROLS_PLUS_SPEED	<PLUS> Schnelle
$UI_CONTROLS_POINTER	Pointer
$UI_CONTROLS_PRESET_AZERTY	Azerty
$UI_CONTROLS_PRESET_COLEMAK	Colemak
$UI_CONTROLS_PRESET_CUSTOM	Eigene
$UI_CONTROLS_PRESET_DEFAULT	Standard
$UI_CONTROLS_PRESET_DVORAK	Dvorak
$UI_CONTROLS_PRESET_LEFTY	Linkshänder
$UI_CONTROLS_PRESET_PS	PlayStation
$UI_CONTROLS_PRESET_PSJ	Japanisch
$UI_CONTROLS_PRESET_QWERTY	Qwerty
$UI_CONTROLS_PRESET_QWERTZ	Qwertz
$UI_CONTROLS_PRESET_WIIU	WiiU Standard
$UI_CONTROLS_PRESET_XBOX	XBox Standard
$UI_CONTROLS_PRESETS	Voreinstellungen
$UI_CONTROLS_PS3	Playstation 3
$UI_CONTROLS_PS4	Playstation 4
$UI_CONTROLS_RECALL	Rückruf
$UI_CONTROLS_SCROLL	Karte bewegen,<N>Verteidiger platzieren
$UI_CONTROLS_SEE_ALSO	Siehe auch:
$UI_CONTROLS_SELECT	Wählen
$UI_CONTROLS_SLOW	Langsam
$UI_CONTROLS_SLOWEST	Langsamste
$UI_CONTROLS_SPEED	Geschwin-<N>digkeit
$UI_CONTROLS_SPEED_NUMS	font:13,off_x:0,off_y:0,text_off_x:0,text_off_y:-8
$UI_CONTROLS_SPELL	Zauber
$UI_CONTROLS_TAB_NAV	Tab-<N>Navigation
$UI_CONTROLS_TARGET	Ziel
$UI_CONTROLS_TITLE	Steuerung
$UI_CONTROLS_VIRTUAL_MOUSE	Virtuelle Maus
$UI_CONTROLS_XBOX1	Xbox One
$UI_CONTROLS_XBOX360	Xbox 360
$UI_CONTROLS_XINPUT	Xinput
$UI_CUTSCENE_SKIP_NUMS	font:15,y_off:-3,leading:-4
$UI_DEFENDER_BOOST	STÄRKEN: <PSI> Psi
$UI_DEFENDER_BOOST_MAX	MAXIMALE STÄRKE
$UI_DEFENDER_BOOST_NEED	STÄRKEN: Brauche <PSI> Psi
$UI_DEFENDER_BOOST_NEED_NUMS	font:11,x_off:0,y_off:2
$UI_DEFENDER_BOOST_UNLOCK	Wird auf STÄRKUNGSLEVEL <LVL> freigeschaltet.
$UI_DEFENDER_CLICK_TO	(Zum Aktivieren/Deaktivieren klicken)
$UI_DEFENDER_RECALL	Zurückrüfen
$UI_DEFENDER_RECALL_LINE	RÜCKRUF:<N>+<PSI> Psi
$UI_DEFENDER_TECHNIQUE	Technik
$UI_DEFENDER_TECHNIQUES	TECHNIKEN
$UI_DEFENDER_TRAIT	Merkmal
$UI_DEFENDER_TRAITS	MERKMALE
$UI_DEFQ_MODS	Mod
$UI_DEMO_IMPORT_OPTIONS	Einstellungen aus der Demo importieren?
$UI_DEMO_IMPORT_SAVES	Spielstände aus der Demo importieren?
$UI_DEMO_OPTIONS_DETECTED	Demo-Einstellungen gefunden!
$UI_DEMO_SAVES_DETECTED	Demo-Spielstände entdeckt!
$UI_DOWNLOAD_BODY	Klicke auf die Schaltfläche, um die <N> Desktop-Version des Spiels herunterzuladen. <N><N> Es wird in einem neuen Fenster/Tab geladen. <N> Es könnte eine kurze Verzögerung geben, <N> also warte eine Minute und klicke nicht wild auf den Knöpfen rum.
$UI_DOWNLOAD_LINUX	Linux
$UI_DOWNLOAD_MACINTOSH	Macintosh
$UI_DOWNLOAD_SOUNDTRACK	Soundtrack
$UI_DOWNLOAD_WARNING	DEAKTIVIERE DEINEN POPUP-BLOCKER!
$UI_DOWNLOAD_WINDOWS	Windows
$UI_DQ_SAVE_FILES	DQ<X> Spielstände
$UI_EQUIP_ALL_A_HEAVY	Gesamte schwere Rüstung angelegt!
$UI_EQUIP_ALL_A_HEAVY_EQUIPPED	Gesamte schwere Rüstung ausgerüstet!
$UI_EQUIP_ALL_A_LIGHT	Gesamte leichte Rüstung angelegt!
$UI_EQUIP_ALL_A_LIGHT_EQUIPPED	Gesamte leichte Rüstung ausgerüstet!
$UI_EQUIP_ALL_ACC_BOOK	Alle Bücher ausgerüstet!
$UI_EQUIP_ALL_W_BOW	Alle Bogen ausgerüstet!
$UI_EQUIP_ALL_W_BOW_EQUIPPED	Alle Bogen ausgerüstet!
$UI_EQUIP_ALL_W_STAFF	Alle Stäbe ausgerüstet!
$UI_EQUIP_ALL_W_STAFF_EQUIPPED	Alle Stäbe ausgerüstet!
$UI_EQUIP_ALL_W_SWORD	Alle Schwerter ausgerüstet!
$UI_EQUIP_ALL_W_SWORD_EQUIPPED	Alle Schwerter ausgerüstet!
$UI_EQUIP_CANT_SELL_UNIQUE	Kann einzigartige Gegenstände nicht verkaufen!
$UI_EQUIP_CANT_UPGRADE_A_HEAVY	Du hast keine schwere Rüstung, die ich verbessern könnte!
$UI_EQUIP_CANT_UPGRADE_A_LIGHT	Du hast keine leichte Rüstung, die ich verbessern könnte!
$UI_EQUIP_CANT_UPGRADE_W_BOW	Du hast keine Bogen, die ich verbessern könnte!
$UI_EQUIP_CANT_UPGRADE_W_STAFF	Du hast keine Stäbe, die ich verbessern könnte!
$UI_EQUIP_CANT_UPGRADE_W_SWORD	Du hast keine Schwerter, die ich verbessern könnte!
$UI_EQUIP_CLASS_CANT_A	Diese Klasse kann keine Rüstung anlegen!
$UI_EQUIP_CLASS_CANT_W	Diese Klasse kann keine Waffen ausrüsten!
$UI_EQUIP_COMPARE	vergleichen
$UI_EQUIP_EQUIP_AFTER	Nach Kauf ausrüsten
$UI_EQUIP_EQUIP_WHO	Wer soll damit ausgerüstet werden?
$UI_EQUIP_EQUIPPED	Ausgerüstet
$UI_EQUIP_MAX_OWNED	MAXIMALE ANZAHL IN BESITZ
$UI_EQUIP_NAME	Name
$UI_EQUIP_NO_A_HEAVY	Keine schwere Rüstung in Besitz!
$UI_EQUIP_NO_A_HEAVY	Keine schwere Rüstung in Besitz!
$UI_EQUIP_NO_A_LIGHT	Keine leichte Rüstung in Besitz!
$UI_EQUIP_NO_A_LIGHT	Keine leichte Rüstung in Besitz!
$UI_EQUIP_NO_ACC_BOOK	Keine Bücher in Besitz!
$UI_EQUIP_NO_W_BOW	Keine Bogen in Besitz!
$UI_EQUIP_NO_W_BOW	Keine Bogen in Besitz!
$UI_EQUIP_NO_W_STAFF	Keine Stäbe in Besitz!
$UI_EQUIP_NO_W_STAFF	Keine Stäbe in Besitz!
$UI_EQUIP_NO_W_SWORD	Keine Schwerter in Besitz!
$UI_EQUIP_NO_W_SWORD	Keine Schwerter in Besitz!
$UI_EQUIP_OWNED	in Besitz
$UI_EQUIP_OWNER	Besitzer
$UI_EQUIP_PRICE	Preis
$UI_EQUIP_SELL_OLD_ARMOR_FOR	Verkaufe alte Rüstung für <SELL_PRICE> Kram?
$UI_EQUIP_SELL_OLD_WEAPON_FOR	Verkaufe alte Waffe für <SELL_PRICE> Kram?
$UI_EQUIP_SHOW_EQUIPPED	Zeige Ausrüstung
$UI_EQUIP_SHOW_EQUIPPED	Zeige Ausrüstung
$UI_EQUIP_STAT	Stat
$UI_EQUIP_WHO_WILL	Wer wird ausrüsten:
$UI_EULA_TITLE	Endnutzer-Lizenzvertrag
$UI_GAMEPLAY_ALWAYS	Immer
$UI_GAMEPLAY_AUTO_UPDATE	Auto-Aktualisierungen
$UI_GAMEPLAY_BATTLE_NUMBERS	Schadenszahlen
$UI_GAMEPLAY_CLOUD_SAVE	Cloud-Spielstände
$UI_GAMEPLAY_DEFAULT	Nur neue Schlachten
$UI_GAMEPLAY_DIALOGUE	Dialog
$UI_GAMEPLAY_DISABLE_UPDATER	Auto-Aktualisierungen ausschalten
$UI_GAMEPLAY_ENABLE_UPDATER	Auf Updates prüfen, wenn das Spiel startet
$UI_GAMEPLAY_HIDE	Verstecken
$UI_GAMEPLAY_MISCELLANEOUS	Verschiedenes
$UI_GAMEPLAY_NEVER	Nie
$UI_GAMEPLAY_OFF	Aus
$UI_GAMEPLAY_ON	An
$UI_GAMEPLAY_SHOW	Zeigen
$UI_GAMEPLAY_SLOW_FOOTNOTE	Könnte das Spiel verlangsamen
$UI_GAMEPLAY_TRACK_NO	Werte mich nicht aus!
$UI_GAMEPLAY_TRACK_YES	Lass uns anonyme Spielstatistiken aufzeichnen
$UI_GAMEPLAY_TRACKING	Datenaufzeichnung
$UI_GAMEPLAY_TUTORIALS	Tutorials
$UI_GRAPHICS_HD	HD
$UI_GRAPHICS_ORIGINAL	Original
$UI_HIGH	Hoch
$UI_HIGH()	Hoch(<X>)
$UI_LEGACY_IMPORT_SAVES	Spielstände aus einer älteren Version von Defender's Quest importieren?
$UI_LEGACY_SAVES_DETECTED	Veraltete Spielstände gefunden!
$UI_LOGGING_ALWAYS	Immer
$UI_LOGGING_ASK	Immer fragen
$UI_LOGGING_CRASH	Crash-Logs aufzeichnen
$UI_LOGGING_CRASH_CONTENT	Crash-Log hinzufügen:
$UI_LOGGING_CRASH_OPTIONS	Einstellungen
$UI_LOGGING_CRASH_REPLAY	Benutzereingabe-Aufzeichnungen
$UI_LOGGING_CRASH_SAVES	Spielstände
$UI_LOGGING_CRASH_SCREENSHOT	Screenshot
$UI_LOGGING_CRASH_SYSTEM	Systemdetails
$UI_LOGGING_NEVER	Nie
$UI_LOGGING_SEND	Crash-Logs an Entwickler schicken
$UI_LOGGING_TITLE	Logs
$UI_LOW	Niedrig
$UI_LOW()	Niedrig(<X>)
$UI_MISC_NUMS	font:18,off_y:1,off_x:-2
$UI_MISC_TITLE	Sonstiges
$UI_MOD_ALL_FILES	Alle Dateien (*.*)
$UI_MOD_AUTHOR	Autor
$UI_MOD_BKGS	<PLUS>42M Hintergrund-Zeichnungen
$UI_MOD_BROWSE_QUEUE	Lokale Schlange durchsuchen ??
$UI_MOD_BROWSE_WORKSHOP	Steam-Workshop durchsuchen
$UI_MOD_CREATE_NEW	Neue Mod erstellen
$UI_MOD_DATA_ONLY	Nur Daten (1M)
$UI_MOD_DEFQ_SAVE	Defender's Quest Spielstände (*.dfq)
$UI_MOD_DOWNLOAD	Lade Mod herunter
$UI_MOD_DOWNLOAD_TEXT	
$UI_MOD_EDIT	Ändern
$UI_MOD_EXISTS	Mod existiert.<N>Laden?
$UI_MOD_EXPORT_CANCEL	Export abgebrochen!
$UI_MOD_EXPORT_CANCEL_TEXT	Dateien befinden sich unter:
$UI_MOD_EXPORT_CHURN	Schrit <TASK_PROGRESS><N><N><TASK><N><PROGRESS>
$UI_MOD_EXPORT_FAIL	Export fehlgeschlagen!
$UI_MOD_EXPORT_FAIL_TEXT	Es gab einen Fehler!
$UI_MOD_EXPORT_FINISH	Export vollständig!
$UI_MOD_EXPORT_FINISH_TEXT	Deine Mod befindet sich unter:
$UI_MOD_EXPORTING	Exportiere Dateien
$UI_MOD_INSTALL_ERROR	Der Name für das Modverzeichnis existiert bereits.<N>Versuchen, mit einem Suffix zu installieren?
$UI_MOD_INSTALL_ERROR2	Sorry, wir konnten die Mod nicht installieren.
$UI_MOD_INSTALL_STANDALONE	Von ZIP aus installieren
$UI_MOD_LATER	Später
$UI_MOD_LOAD_EXISTING	Bestehende Mod laden
$UI_MOD_LOAD_FAIL	Laden fehlgeschlagen
$UI_MOD_LOAD_FAIL_TEXT	Fehler beim Laden der Mod:
$UI_MOD_LOAD_FINISH	Laden erfolgreich
$UI_MOD_LOAD_FINISH_TEXT	Mod erfolgreich geladen.<N>Das Spiel wird jetzt neu starten.
$UI_MOD_LOAD_MOD	Mod laden
$UI_MOD_LOAD_MOD_TEXT	Lade Mod <LQ><MOD><RQ>?<N>Spiel wird neu gestartet.
$UI_MOD_LOADING	Lade Mod …
$UI_MOD_MISSING	Konnte keine settings.xml finden.<N>Entweder ist dort keine Mod,<N>oder sie ist kaputt.
$UI_MOD_MISSING_SUBSCRIBE	Abonnierte Dateien
$UI_MOD_MISSING_SUBSCRIBE_TEXT	Möchtest du die<N><NUM> abonnierten Workshop-Datei(en) herunterladen?
$UI_MOD_MOD_INCOMPAT_TEXT	<N>Datei ist aus einer anderen Mod,<N>sie könnte inkompatibel sein.<N><N>Import dennoch versuchen?
$UI_MOD_MOVIES	<PLUS>13M Zwischensequenzen
$UI_MOD_NAME	Gebe einen Namen für die Mod ein
$UI_MOD_NORM_INCOMPAT_TEXT	<N>Eine Mod ist aktiv, aber diese<N>Datei ist aus dem normalen Spiel,<N>sie könnte inkompatibel sein.<N><N>Import dennoch versuchen?
$UI_MOD_NOT_DIR	Hey!<N>Das ist noch nicht einmal ein Verzeichnis!<N>Versuch es nochmal.
$UI_MOD_PATH	Pfad zu Mod-Dateien …
$UI_MOD_PLAY	Spielen
$UI_MOD_PLEASE_WAIT	Bitte warte, während<N>wir deine Mod laden
$UI_MOD_PROGRESS	Schritt <TASK><N>Datei <FILE><N>
$UI_MOD_SELECT_DIR	Mod-Verzeichnis auswählen
$UI_MOD_SHARE	Teilen
$UI_MOD_SHARE_TEXT_LOCAL	Dies wird deine Mod in eine einzige Datei für eine einfache Verteilung packen.
$UI_MOD_SHARE_TEXT_STEAM	Dies wird deine Mod packen und in den Steam Workshop hochladen.
$UI_MOD_SHARE_TITLE	Mod teilen
$UI_MOD_SHARED	Geteilt
$UI_MOD_SPRITES	<PLUS>4M Sprites
$UI_MOD_STEAM_SEND	An Steam senden
$UI_MOD_STEAM_UPLOAD	Zu Steam hochladen …
$UI_MOD_STEAM_WAIT	Warten auf Antwort von Steam …<N>(Könnte etwas dauen)
$UI_MOD_SUBSCRIBED	Abonniert
$UI_MOD_TEMPLATE_SETTINGS	Mod-Template-Einstellungen
$UI_MOD_TITLE	Modifikationen
$UI_MOD_TITLE	Modifikationen
$UI_MOD_UPDATE	Aktualisieren
$UI_MOD_UPDATE_STEAM_FINISH	Vollständig aktualisiert
$UI_MOD_UPDATE_STEAM_FINISH_TEXT	Mod erfolgreich im<N>Steam Workshop aktualisiert.
$UI_MOD_UPDATE_TEXT_STEAM	Dies wird deine Mod im Steam Workshop aktualisieren.
$UI_MOD_WEB_BROWSER	Webbrowser
$UI_MOD_WORKSHOP	Workshop
$UI_MOD_ZIP_FAIL	Packen ist fehlgeschlagen.
$UI_MOD_ZIP_FAIL_TEXT	Ein Fehler trat während des Zippens der Dateien auf.
$UI_MOD_ZIP_FILES	Zip-Dateien (*.*)
$UI_MOD_ZIP_FINISH	Vollständig gepackt
$UI_MOD_ZIP_FINISH_TEXT	Mod erfolgreich gezippt.
$UI_MOD_ZIP_PROGRESS	Aufgabe <TASK><N>Datei <FILE><N>
$UI_MOD_ZIP_STEAM_FAIL	Upload fehlgeschlagen!
$UI_MOD_ZIP_STEAM_FAIL_TEXT	Konnte die Mod nicht zum<N>Steam Workshop hochladen.
$UI_MOD_ZIP_STEAM_FINISH	Upload vollständig
$UI_MOD_ZIP_STEAM_FINISH_TEXT	Mod vollständig in den<N>Steam Workshop hochgeladen.
$UI_MOD_ZIPPING	Packe Mod-Dateien
$UI_MOVIE_END	Ende
$UI_MOVIE_END	Ende
$UI_MOVIE_QUEST	Aufgabe
$UI_MOVIE_SCENE	Szene
$UI_MOVIE_SELECT_A_MOVIE	Filmsequenz auswählen
$UI_MUSIC	Musik
$UI_NORM_MOD_INCOMPAT_TEXT	<N>Datei ist aus einer Mod,<N>sie könnte inkompatibel sein.<N><N>Import dennoch versuchen?
$UI_OPTIONS_MENU	Optionsmenü
$UI_OPTIONS_NUMS	font:18,off_y:1,off_x:-2
$UI_OPTIONS_SPEED	Spielgeschwindigkeit
$UI_OPTIONS_TITLE	Optionen
$UI_QUIT_NUMS	font:16,off_y:3,off_x:0
$UI_RECRUIT_BERSERKER_NUMS	font:14,x_off:0,y_off:0
$UI_RECRUIT_CANCEL_NUMS	font:13,off_y:2
$UI_RECRUIT_CLASS_FULL	KLASSE IST VOLL
$UI_RECRUIT_DRAGON_NUMS	font:14,x_off:0,y_off:0
$UI_RECRUIT_HEALER_NUMS	font:14,x_off:0,y_off:0
$UI_RECRUIT_KNIGHT_NUMS	font:14,x_off:0,y_off:0
$UI_RECRUIT_MAGE_NUMS	font:12,x_off:0,y_off:2
$UI_RECRUIT_RANGER_NUMS	font:12,x_off:0,y_off:2
$UI_RESOLUTION_CHOICES	Verfügbar:
$UI_RESOLUTION_CURRENT	Derzeit:
$UI_RESOLUTION_CURRENT_PARENTHESES	(Derzeit)
$UI_RESOLUTION_TITLE	Monitor-Auflösung
$UI_RESTART_NUMS	font:18,off_y:1,off_x:-2
$UI_SAVE_CONFIRM_DELETE	Löschen bestätigen?
$UI_SAVE_CONFIRM_DELETE_TEXT	PERMANENT diesen<N>Spielstand löschen?
$UI_SAVE_DEMO_ATTENTION	Achtung!
$UI_SAVE_DEMO_IMPORT	Demo-Import
$UI_SAVE_DEMO_IMPORT_TEXT	Die Datei ist aus der DEMO. Einige Anpassungen könnten vorgenommen werden.<N>Ist das ok?
$UI_SAVE_DEMO_NEWER	<N>Die Datei ist aus einer NEUEREN Version des Spiels,<N>sie könnte inkompatibel sein.<N>Den Import dennoch versuchen?
$UI_SAVE_DEMO_OLDER	<N>Die Datei ist aus einer ÄLTEREN Version des Spiels,<N>einige Anpassungen könnten vorgenommen werden.<N>Ist das ok?
$UI_SAVE_ERROR_INCOMPAT	Inkompatibel
$UI_SAVE_ERROR_INCOMPAT_TEXT	Fehler! Du spielst die DEMO<N>und die Datei ist aus der VOLLversion.
$UI_SAVE_MENU_CHECK_GOG	Überprüfe GOG auf kostenlose Aktualisierungen!
$UI_SAVE_MENU_DOWNLOAD	Hole die herunterladbare Version
$UI_SAVE_MENU_FULL_VERSION	Vollversion
$UI_SAVE_MENU_KONG_DEMO	<RE>$MISC_DEMO_VERSION
$UI_SAVE_MENU_KONG_DEMO_LOGIN_FULL	Demo – Logge dich bei Kongregate ein, um Zugriff zur Vollversion zu erlangen!
$UI_SAVE_MENU_KONG_DEMO_LOGIN_XDEMO	Demo – Logge dich bei Kongregate ein, um Zugriff zu weiterem Inhalt zu haben!
$UI_SAVE_MENU_KONG_XDEMO	Erweiterte Demo
$UI_SAVE_MENU_KONG_XDEMO_LOGIN	Erweiterte Demo – Logge dich bei Kongregate ein, um Zugriff zur Vollversion zu erlangen!
$UI_SAVE_MENU_LOADED	Vollständig geladen!
$UI_SAVE_PATH	Pfad zum Abspeichern …
$UI_SAVE_SELECT_DIR	Speicherverzeichnis auswählen
$UI_SELECT_A_FILE_TEXT	Bitte wähle einen Spielstand zum Importieren
$UI_SELECT_A_FILE_TITLE	Bitte wähle eine Datei!
$UI_SFX	SFX:
$UI_SHOP_BUY_NOW_NUMS	font:13
$UI_SHOP_BUY_TAB_NUMS	font:16
$UI_SHOP_EQUIP_NUMS	font:12,y_off:4
$UI_SHOP_SELL_NOW_NUMS	font:12
$UI_SHOP_SELL_TAB_NUMS	font:13,y_off:2
$UI_SHOP_SWORD_NUMS	font:13,y_off:-2
$UI_SKILLS_CLICK_TO_UPGRADE	Zum Verbessern klicken.
$UI_SKILLS_MAX	MAXIMUM
$UI_SKILLS_MOUSE_OVER	Zum Ansehen mit Maus überfahren.
$UI_SKILLS_NO_LEARN_SPELL	Du hast diesen Zauber noch nicht gelernt.
$UI_SKILLS_NO_POINTS	Keine Punkte verfügbar.
$UI_SKILLS_REQ_1PT	BENÖTIGT: Char. Level <LVL>,<N><PT> Punkt bei <SKILL>
$UI_SKILLS_REQ_XPT	BENÖTIGT: Char. Level <LVL>,<N><PT> Punkte in <SKILL>
$UI_TIPS_TITLE	Tipps & Tricks
$UI_TOWN_LEAVE_NUMS	font:11,y_off:4
$UI_TOWN_RECRUIT_NUMS	font:11,y_off:4
$UI_UPDATER_ASK_DOWNLOAD	Das Update herunterladen?
$UI_UPDATER_CANCEL	<RE>$MISC_CANCEL
$UI_UPDATER_CHECKING	Überprüfe auf Updates …
$UI_UPDATER_CHECKSUM	Berechne Prüfsumme …
$UI_UPDATER_CHECKSUM_MISMATCH	Die Prüfsumme der Datei entsprach nicht unserer Erwartung. <N><N> Mögliche Ursachen sind ein unvollständiger Download (wahrscheinlich), ein Sicherheitsproblem (unwahrscheinlich) oder aber Kosmische Strahlung (man kann nie wissen!). <N><N> Jedenfalls ging das Update schief.
$UI_UPDATER_CLOSE_WINDOW	Du musst vor Installation des Updates dieses Fenster schließen.
$UI_UPDATER_CONNECT_AGAIN	Verbinde wieder
$UI_UPDATER_CONNECTING	Verbinde zum Server …
$UI_UPDATER_CURRENT_VERSION	Aktuelle Version:<T>
$UI_UPDATER_DEB	DEB-Paket
$UI_UPDATER_DETAILS	Details:
$UI_UPDATER_DOWNLOADED	Update heruntergeladen!
$UI_UPDATER_DOWNLOADING_FILE	Lade Update-Datei herunter …
$UI_UPDATER_DOWNLOADING_SIG	Lade Update-Signatur herunter …
$UI_UPDATER_ERROR!	FEHLER!
$UI_UPDATER_EXITING	Schließe Programm …
$UI_UPDATER_FILE_IS_AT	Dein Update befindet sich bei:
$UI_UPDATER_GIVE_UP	Aufgeben
$UI_UPDATER_IF_NO_WINDOW	Sollte sich kein Weiterleitungs-Ordner öffnen, versuche manuell dorthin zu gehen.
$UI_UPDATER_INSTALLING	Installiere Update …
$UI_UPDATER_NAVIGATE_NOW	Zur Datei weiterleiten?
$UI_UPDATER_NAVIGATING	Leite zur Datei …
$UI_UPDATER_NEWEST_VERSION	Neueste Version:<T>
$UI_UPDATER_NO_BIG_DEAL	Das ist keine große Sache, du kannst immer noch das Spiel spielen, du kannst schlichtweg den Update-Server momentan nicht erreichen.
$UI_UPDATER_NO_DOWNLOAD	Konnte Update-Datei nicht herunterladen.
$UI_UPDATER_NO_INFO	Konnte Update-Informationen auf dem Server nicht finden.
$UI_UPDATER_NO_UPDATES	Keine Updates verfügbar.
$UI_UPDATER_NO_VERIFY	Konnte Update-Datei nicht verifizieren.
$UI_UPDATER_NOTE	Hinweis:
$UI_UPDATER_PLEASE_WAIT	<RE>$MISC_PLEASE_WAIT
$UI_UPDATER_RPM	RPM-Paket
$UI_UPDATER_SECURED_WITH	Dieses Update ist über HTTPS <N> und „Public Key Fingerprint“-Autorisierung abgesichert.
$UI_UPDATER_SECURITY	Aus Sicherheitsgründen musst du das geladene Installationsprogramm manuell ausführen. <N><N> Dieses Programm wird dich zur Position der Datei leiten.
$UI_UPDATER_SERVER_TIMEOUT	Server-Zeitüberschreitung!
$UI_UPDATER_TARGZ	TAR.GZ-Archiv
$UI_UPDATER_TRY_AGAIN	Neu versuchen
$UI_UPDATER_TRYING_30	Versuche für 30 Sekunden
$UI_UPDATER_UPDATE_EXISTS	Aktualisierte Version verfügbar!
$UI_VIDEO_AOE	Umgebungs-Angriffe hervorheben
$UI_VIDEO_BIT_DEPTH	Tiefe
$UI_VIDEO_CAN_SLOW_GAME	(Kann das Spiel verlangsamen)
$UI_VIDEO_CHANGE_RES	Auflösung ändern
$UI_VIDEO_CHANGE_RES_BUTTON	Ändere es!
$UI_VIDEO_CHANGE_RES_TO	Auflösung ändern zu <X>
$UI_VIDEO_CUTSCENES	Zwischensequenzen
$UI_VIDEO_FULLSCREEN	Vollbild
$UI_VIDEO_GRAPHICS	Grafik
$UI_VIDEO_HD	Wide (16:9)
$UI_VIDEO_IF_DOESNT_WORK	Wenn die neue Auflösung nicht funktioniert,<N>wird sie nach wenigen Sekunden zurückgesetzt.
$UI_VIDEO_MATCH_MONITOR	Vollbildaflösung übernehmen
$UI_VIDEO_MODE	Modus
$UI_VIDEO_MOUSE	Mauszeiger
$UI_VIDEO_MOUSE_DEFAULT	Standard
$UI_VIDEO_MOUSE_FANCY	Schick
$UI_VIDEO_NUMS	font:18,off_y:1,off_x:-2
$UI_VIDEO_PARTICLES	Teilchen
$UI_VIDEO_PIXELS	Pixel
$UI_VIDEO_RECOMMENDED	Empfohlen:
$UI_VIDEO_REFRESH	Aktualisieren
$UI_VIDEO_RES_CHANGED	Die Auflösung hat sich geändert.<N>Gefällt es dir?<N><N>Zurücksetzen in <TIME> Sekunden.
$UI_VIDEO_RESOLUTION	Vollbildauflösung
$UI_VIDEO_SCALE	Strecken
$UI_VIDEO_SCREEN_POS	Bildschirmposition
$UI_VIDEO_SCREEN_SIZE	Fenstergröße
$UI_VIDEO_SD	Standard (4:3)
$UI_VIDEO_SELECT_NEW	Neu wählen...
$UI_VIDEO_SETTINGS	Video-Optionen
$UI_VIDEO_SHOW_ALL_RES	Zeige alle Auflösungen
$UI_VIDEO_SPRITES	Sprites
$UI_VIDEO_STANDARD_RATIO	(Standard-Verhältnis)
$UI_VIDEO_SWIRL	Kampfanimation
$UI_VIDEO_TITLE	Video
$UI_VIDEO_WARNING	Video-Optionen sind im Browser-Modus deaktiviert.
$UI_VIDEO_WARNING2	Dein System unterstützt das Ändern der Auflösung im Spiel leider nicht :(
$UI_VIDEO_WARNING3	Im KOMPATIBILITÄTSMODUS ist das Ändern der Auflösung deaktiviert.<N><N>Tut uns leid!
$UI_VIDEO_WIDESCREEN	(Breitbild)
$UI_VIDEO_WINDOWED	Im Fenster
$WEAK_DMG_MULT	<PLUS><PERCENT>% Extraschaden von <FLAVOR>
$YOU_GOT	Du erhältst
$YOU_GOT_JOIN	<NAME> der Klasse <CLASS><N>ist der Gruppe beigetreten!
$YOU_GOT_MONEY	Du bekommst <MONEY> Kram!
$YOU_GOT_NEW_GAME_PLUS_TEXT	Gratuliere! Du kannst jetzt ein neues Abenteuer mit deiner alten Gruppe starten!<N><N>Stelle dich mutierten Feinden mit neuen Talenten, verstärke deine Ausrüstung mit tollen neuen Zaubern und füge deiner Bibliothek viele neue Bücher hinzu. Löse zahlreiche neue Nebenaufgaben mit weiteren Zwischensequenzen, schalte Entwicklerkommentare frei, übersetze Eztli-Tenochs Sprache, triff neue Charaktere und noch viel, viel mehr!<N><N><RE>[$NEW_GAME_PLUS_NOTE]<N><N>Du kannst jederzeit zum <LQ>normalen<RQ> Spiel wechseln.
$YOU_GOT_NEW_GAME_PLUS_TITLE	Neues Spiel+ freigeschaltet!
$YOU_GOT_NO_EQUIP	Dieser Gegenstand kann nicht ausgerüstet werden.
$YOU_GOT_NO_EQUIP_YET	Niemand in deiner Gruppe kann momentan <THING> ausrüsten.<N>Keine Sorge, spiel einfach weiter und neue Charaktere tauchen auf, die es können.
$YOU_GOT_X	<NUM>x <THING>!
$MISC_PLEASE_RECONNECT_CONTROLLER	Bitte schließen Sie den Controller wieder an.
$PRESS_A	Drücken Sie <A>, um fortzufahren.
$MISC_REQUIRES_RESTART	(Neustart erforderlich)
$MISC_PICTURE_SIZE	Bildgröße
$MISC_SIGNED_OUT	<USER> hat sich abgemeldet.
$MISC_SIGNED_IN	Angemeldet als <USER>.
$MISC_RESTART_XBOX Deine Xbox neu starten?
$MISC_SWITCH_USER	Benutzer wechseln
$ACTIONS_BATTLECONTROLS	Kampf
$ACTIONS_BATTLE_BACK	<RE>$BATTLE_BACK
$ACTIONS_BATTLE_CYCLE_NEXT	Nächster<N>Verteidiger
$ACTIONS_BATTLE_CYCLE_PREVIOUS	Vorheriger<N>Verteidiger
$ACTIONS_BATTLE_DEFENDERS	<RE>$BATTLE_DEFENDERS
$ACTIONS_BATTLE_FINE_MOVE	<RE>$BATTLE_FINE_MOVE
$ACTIONS_BATTLE_FREE_MOVE	<RE>$BATTLE_FREE_MOVE
$ACTIONS_BATTLE_MENU	<RE>$BATTLE_MENU
$ACTIONS_BATTLE_MENU_MOVE	<RE>$BATTLE_MOVE
$ACTIONS_BATTLE_PAUSE	<RE>$MISC_PAUSE
$ACTIONS_BATTLE_SELECT	<RE>$BATTLE_SELECT_UNIT
$ACTIONS_BATTLE_SPEED_MINUS	Langsamer
$ACTIONS_BATTLE_SPEED_PLUS	Schneller
$ACTIONS_BATTLE_SPELLS	Zauber
$ACTIONS_BATTLE_SPELL_SPAM	Zauber<N>wiederholen
$ACTIONS_BATTLE_TILE_MOVE	<RE>$BATTLE_TILE_MOVE
$ACTIONS_CUTSCENECONTROLS	Cutscene
$ACTIONS_CUTSCENE_NEXT	<RE>$MISC_NEXT
$ACTIONS_CUTSCENE_PREVIOUS	<RE>$MISC_PREVIOUS
$ACTIONS_CUTSCENE_SKIP	<RE>$MISC_SKIP
$ACTIONS_MAPCONTROLS	Weltkarte
$ACTIONS_MAP_EXIT	<RE>$MISC_EXIT
$ACTIONS_MAP_JOURNAL	<RE>$MISC_JOURNAL
$ACTIONS_MAP_MENU	<RE>$MISC_MENU
$ACTIONS_MAP_MOVE	Zeiger bewegen
$ACTIONS_MAP_MOVE_MAP	Auf Karte bewegen
$ACTIONS_MAP_SCROLL_MAP	Karte scrollen
$ACTIONS_MAP_SELECT	<RE>$MISC_SELECT
$ACTIONS_MENUCONTROLS	Menü
$ACTIONS_MENUCONTROLSWITHANALOG	Menü
$ACTIONS_MENU_CANCEL	Abbruch
$ACTIONS_MENU_MENU	Menü
$ACTIONS_MENU_MOVE	Zeiger bewegen
$ACTIONS_MENU_SELECT	Wählen
$ACTIONS_MENU_THING_1	Option 1
$ACTIONS_MENU_THING_2	Option 2
$ACTIONS_MENU_THING_3	Option 3
$BATTLE_BACK	<RE>$MISC_BACK
$BATTLE_DEFENDERS	<RE>$MISC_DEFENDERS
$BATTLE_FINE_MOVE	Langsam bewegen
$BATTLE_FREE_MOVE	Fingerzeiger
$BATTLE_MAP	Karte
$BATTLE_MENU	<RE>$MISC_MENU
$BATTLE_MOVE	Bewegen
$BATTLE_MOVE_MOUSE	Maus bewegen
$BATTLE_SELECT_UNIT	Einheit<N>wählen
$BATTLE_SPELLS	<RE>$STAT_DESC_SPELLS
$BATTLE_TILE_MOVE	Kachel bewegen
$BOOK_COOLDOWN_OP	Zauber-Abklingzeit <X>
$BOOK_COST_OP	Zauberkosten <X>
$CONTROL_SWITCH_WARNING	Du kannst wichtige Eingabemethoden nicht mitten in der Schlacht wechseln. Tut uns leid!
$DATA_DUMP_MAPS	<RE>$DATA_DUMP_MAP_FILES
$EQUIP_THE_THING	<RE>$MISC_EQUIP	The word 'equip' that appears on the button in the equip menu in the party screen, to actually put the item on your character
$GAMEPAD_A	A-Taste
$GAMEPAD_B	B-Taste
$GAMEPAD_BACK	Zurück-Taste
$GAMEPAD_BUTTON_SPACER
$GAMEPAD_DPAD	Steuerkreuz
$GAMEPAD_DPAD_DOWN	Unten-Taste
$GAMEPAD_DPAD_LEFT	Links-Taste
$GAMEPAD_DPAD_RIGHT	Rechts-Taste
$GAMEPAD_DPAD_UP	Oben-Taste
$GAMEPAD_EMPTY	Leer
$GAMEPAD_LEFT_ANALOG_STICK	Linker Stick
$GAMEPAD_LEFT_ANALOG_STICK_X_MINUS	Linker Stick, zeigt nach LINKS
$GAMEPAD_LEFT_ANALOG_STICK_X_PLUS	Linker Stick, zeigt nach RECHTS
$GAMEPAD_LEFT_ANALOG_STICK_Y_MINUS	Linker Stick, zeigt nach OBEN
$GAMEPAD_LEFT_ANALOG_STICK_Y_PLUS	Linker Stick, zeigt nach UNTEN
$GAMEPAD_LEFT_SHOULDER	Linke Schultertaste
$GAMEPAD_LEFT_STICK_CLICK	Linker Stick, GEDRÜCKT
$GAMEPAD_LEFT_TRIGGER	Linker Analog-Trigger
$GAMEPAD_NOTE	Zum Verändern auswählen
$GAMEPAD_RIGHT_ANALOG_STICK	Rechte Rechter Stick
$GAMEPAD_RIGHT_ANALOG_STICK_X_MINUS	Rechter Stick, zeigt nach LINKS
$GAMEPAD_RIGHT_ANALOG_STICK_X_PLUS	Rechter Stick, zeigt nach RECHTS
$GAMEPAD_RIGHT_ANALOG_STICK_Y_MINUS	Rechter Stick, zeigt nach OBEN
$GAMEPAD_RIGHT_ANALOG_STICK_Y_PLUS	Rechter Stick, zeigt nach UNTEN
$GAMEPAD_RIGHT_SHOULDER	Rechte Schultertaste
$GAMEPAD_RIGHT_STICK_CLICK	Rechter Stick, GEDRÜCKT
$GAMEPAD_RIGHT_TRIGGER	Rechter Analog-Trigger
$GAMEPAD_START	Start-Taste
$GAMEPAD_TEMP_SPACER	,,,,,,
$GAMEPAD_X	X-Taste
$GAMEPAD_Y	Y-Taste
$GO_TO_EQUIP_MENU	<RE>$MISC_EQUIP	The word 'equip' that appears on the button in the skills menu in the party screen, to switch to the equip menu
$LOGITECH_A	2 (vordere) Taste
$LOGITECH_B	3 (vordere) Taste
$LOGITECH_BACK	9 (hintere) Taste
$LOGITECH_DPAD	<RE>$GAMEPAD_DPAD
$LOGITECH_DPAD_DOWN	<RE>$GAMEPAD_DPAD_DOWN
$LOGITECH_DPAD_LEFT	<RE>$GAMEPAD_DPAD_LEFT
$LOGITECH_DPAD_RIGHT	<RE>$GAMEPAD_DPAD_RIGHT
$LOGITECH_DPAD_UP	<RE>$GAMEPAD_DPAD_UP
$LOGITECH_EMPTY	<RE>$GAMEPAD_EMPTY
$LOGITECH_LEFT_ANALOG_STICK	<RE>$GAMEPAD_LEFT_ANALOG_STICK
$LOGITECH_LEFT_ANALOG_STICK_X_MINUS	<RE>$GAMEPAD_LEFT_ANALOG_STICK_X_MINUS
$LOGITECH_LEFT_ANALOG_STICK_X_PLUS	<RE>$GAMEPAD_LEFT_ANALOG_STICK_X_PLUS
$LOGITECH_LEFT_ANALOG_STICK_Y_MINUS	<RE>$GAMEPAD_LEFT_ANALOG_STICK_Y_MINUS
$LOGITECH_LEFT_ANALOG_STICK_Y_PLUS	<RE>$GAMEPAD_LEFT_ANALOG_STICK_Y_PLUS
$LOGITECH_LEFT_SHOULDER	5 (linke Schulter) Taste
$LOGITECH_LEFT_STICK_CLICK	<RE>$GAMEPAD_LEFT_STICK_CLICK
$LOGITECH_LEFT_TRIGGER	7 (linker) Analog-Trigger
$LOGITECH_RIGHT_ANALOG_STICK	<RE>$GAMEPAD_RIGHT_ANALOG_STICK
$LOGITECH_RIGHT_ANALOG_STICK_X_MINUS	<RE>$GAMEPAD_RIGHT_ANALOG_STICK_X_MINUS
$LOGITECH_RIGHT_ANALOG_STICK_X_PLUS	<RE>$GAMEPAD_RIGHT_ANALOG_STICK_X_PLUS
$LOGITECH_RIGHT_ANALOG_STICK_Y_MINUS	<RE>$GAMEPAD_RIGHT_ANALOG_STICK_Y_MINUS
$LOGITECH_RIGHT_ANALOG_STICK_Y_PLUS	<RE>$GAMEPAD_RIGHT_ANALOG_STICK_Y_PLUS
$LOGITECH_RIGHT_SHOULDER	6 (rechte Schulter) Taste
$LOGITECH_RIGHT_STICK_CLICK	<RE>$GAMEPAD_RIGHT_STICK_CLICK
$LOGITECH_RIGHT_TRIGGER	8 (rechter) Analog-Trigger
$LOGITECH_START	10 (Start) Taste
$LOGITECH_X	1 (vordere) Taste
$LOGITECH_Y	4 (vordere) Taste
$MISC_ACCESSORIES	Hilfsmittel
$MISC_ACCESSORY	Hilfsmittel
$MISC_ACCESSORY_PLURAL	<RE>$MISC_ACCESSORIES
$MISC_ACCESSORY_SINGULAR	<RE>$MISC_ACCESSORY
$MISC_ADJUST_REWARDS	100% ist der normale Wert. Ändere ihn, um die Menge deiner Belohnungen anzupassen.
$MISC_ARMOR_PLURAL	<RE>$MISC_ARMOR
$MISC_ARMOR_SINGULAR	<RE>$MISC_ARMOR
$MISC_BREAK_HERO_MODE_TEXT	Du hast dich für den <LQ>Heldenmodus<RQ> entschieden. Dieser lässt dich keine generischen Charaktere rekrutieren.<N>Den Modus verlassen und doch einen Charakter rekrutieren?
$MISC_BREAK_HERO_MODE_TITLE	Heldenmodus verlassen?
$MISC_CURRENT_SAVE	Derzeitiger Spielstand:
$MISC_CUSTOM_SETTINGS	Ändern...
$MISC_DEFAULT_SETTINGS	Standard (empfohlen für neue Spieler)
$MISC_DELETE_ACHIEVEMENT	Achievements löschen?
$MISC_DELETE_BOTH_GOG_ACHIEVEMENT	Lokale & GOG-Achievements löschen
$MISC_DELETE_BOTH_STEAM_ACHIEVEMENT	Lokale & Steam-Achievements löschen
$MISC_DELETE_LOCAL_ACHIEVEMENT	Nur lokale Achievements löschen
$MISC_DEVICE_DISCONNECTED_TEXT	Verbindung mit "<NAME>" in Steckplatz <SLOT> wurde getrennt!
$MISC_DEVICE_DISCONNECTED_TITLE	Gerät entfernt!
$MISC_EDIT	Bearbeiten
$MISC_FAIL_TT_TEXT	So viel Erfahrung und Kram geht verloren, wenn du eine Schlacht verlierst.<N>-50% ist der normale Wert. Ändere ihn, um die Höhe der Strafe anzupassen.
$MISC_FAIL_TT_TITLE	<RE>$UI_ACCESS_FAILURE_PENALTY
$MISC_GOLD_TT_TEXT	Kram (Geld), den du nach einer Schlacht bekommst.<N><RE>[$MISC_ADJUST_REWARDS]
$MISC_GOLD_TT_TITLE	Kram
$MISC_HERO_MODE	Heldenmodus
$MISC_HERO_MODE_TEXT	Generische Charaktere können nicht rekrutiert werden.<N>Überhaupt NICHT empfohlen, wenn du das Spiel zum ersten Mal spielst!<N><N>ANMERKUNG:<N>Du kannst deine Meinung später noch ändern, indem du einen Charakter rekrutierst und die Warnung ignorierst.<N><N>Wir empfehlen dir, erhaltene Erfahrung und Kram auf 300% anzuheben, wenn du im Heldenmodus spielst.<N><N>Zu guter Letzt: diese Einstellung wird für Heldenmodus-Achievements nicht benötigt. Du kannst auch ganz normal ohne generische Charaktere spielen.
$MISC_HERO_MODE_TITLE	<RE>$MISC_HERO_MODE
$MISC_INPUT_0	Eingabe:
$MISC_INPUT_1	Eingabe 1:
$MISC_INPUT_2	Eingabe 2:
$MISC_INPUT_3	Eingabe 3:
$MISC_INSPECT	ansehen
$MISC_LEVEL_PARTY_GEM	Level	Erscheint auf Charakterblöcken im Gruppen-Bildschirm
$MISC_LEVEL_WAVE_BLOCK	Level	Erscheint auf feindlichen Blöcken in der Schlacht
$MISC_LOAD_ORDER	Ladereihenfolge
$MISC_NEW_GAME_SETTINGS	Einstellungen Neues Spiel
$MISC_OVERWRITE	Überschreiben bestätigen
$MISC_OVERWRITE2	"<MODNAME>" überschreiben?
$MISC_OVERWRITE_TEXT	Einige abonnierte Mods entsprechen nicht den lokalen Versionen. Mit dem Überschreiben fortfahren?
$MISC_OVERWRITE_TEXT2	<SOURCE><N><N>--><N><N><DEST>
$MISC_PAUSE	anhalten
$MISC_RESTORE_DEFAULTS	Standard wiederherstellen
$MISC_SAVE_ERROR_TEXT	Autospeichern hat nicht funktioniert, Zugriffserlaubnisse prüfen?<N>Wir versuchen es später nochmal.
$MISC_SAVE_ERROR_TITLE	Autospeichern Fehler!
$MISC_SAVE_FIXED_TEXT	Autospeichern erfolgreich. Sieht so aus, als würde jetzt alles funktionieren.<N>Wir halten jetzt auch die Klappe.
$MISC_SAVE_FIXED_TITLE	Autospeichern erfolreich!
$MISC_SELECTED	Gewählt
$MISC_SLOT	Platz
$MISC_SPLASH_TILES	Kacheln
$MISC_TITLE_SAFE_TEXT	Bewege die Analogsticks, bis alle Kästen sichtbar sind.
$MISC_UNIVERSAL	Universal
$MISC_WAVE_X	Welle <X>
$MISC_WEAPON_PLURAL	<RE>$MISC_WEAPONS
$MISC_WEAPON_SINGULAR	Waffe
$MISC_XP_TT_TEXT	Erfahrung, die du nach einer Schlacht bekommst.<N><RE>[$MISC_ADJUST_REWARDS]
$MISC_XP_TT_TITLE	Erfahrung
$NEW_GAME_PLUS_NOTE	Geh zum Speicherbildschirm und wähle NEUES SPIEL+ an deinem alten Spielstand.
$OUYA_A	O-Taste
$OUYA_B	A-Taste
$OUYA_BACK	<RE>$GAMEPAD_BACK
$OUYA_DPAD	<RE>$GAMEPAD_DPAD
$OUYA_DPAD_DOWN	<RE>$GAMEPAD_DPAD_DOWN
$OUYA_DPAD_LEFT	<RE>$GAMEPAD_DPAD_LEFT
$OUYA_DPAD_RIGHT	<RE>$GAMEPAD_DPAD_RIGHT
$OUYA_DPAD_UP	<RE>$GAMEPAD_DPAD_UP
$OUYA_EMPTY	<RE>$GAMEPAD_EMPTY
$OUYA_LEFT_ANALOG_STICK	<RE>$GAMEPAD_LEFT_ANALOG_STICK
$OUYA_LEFT_ANALOG_STICK_X_MINUS	<RE>$GAMEPAD_LEFT_ANALOG_STICK_X_MINUS
$OUYA_LEFT_ANALOG_STICK_X_PLUS	<RE>$GAMEPAD_LEFT_ANALOG_STICK_X_PLUS
$OUYA_LEFT_ANALOG_STICK_Y_MINUS	<RE>$GAMEPAD_LEFT_ANALOG_STICK_Y_MINUS
$OUYA_LEFT_ANALOG_STICK_Y_PLUS	<RE>$GAMEPAD_LEFT_ANALOG_STICK_Y_PLUS
$OUYA_LEFT_SHOULDER	<RE>$PS4_LEFT_SHOULDER
$OUYA_LEFT_STICK_CLICK	<RE>$GAMEPAD_LEFT_STICK_CLICK
$OUYA_LEFT_TRIGGER	<RE>$PS4_LEFT_TRIGGER
$OUYA_RIGHT_ANALOG_STICK	<RE>$GAMEPAD_RIGHT_ANALOG_STICK
$OUYA_RIGHT_ANALOG_STICK_X_MINUS	<RE>$GAMEPAD_RIGHT_ANALOG_STICK_X_MINUS
$OUYA_RIGHT_ANALOG_STICK_X_PLUS	<RE>$GAMEPAD_RIGHT_ANALOG_STICK_X_PLUS
$OUYA_RIGHT_ANALOG_STICK_Y_MINUS	<RE>$GAMEPAD_RIGHT_ANALOG_STICK_Y_MINUS
$OUYA_RIGHT_ANALOG_STICK_Y_PLUS	<RE>$GAMEPAD_RIGHT_ANALOG_STICK_Y_PLUS
$OUYA_RIGHT_SHOULDER	<RE>$PS4_RIGHT_SHOULDER
$OUYA_RIGHT_STICK_CLICK	<RE>$GAMEPAD_RIGHT_STICK_CLICK
$OUYA_RIGHT_TRIGGER	<RE>$PS4_RIGHT_TRIGGER
$OUYA_START	<RE>$GAMEPAD_START
$OUYA_X	U-Taste
$OUYA_Y	Y-Taste
$PS3_A	<RE>$PS4_A
$PS3_B	<RE>$PS4_B
$PS3_BACK	Select-Taste
$PS3_DPAD	<RE>$PS4_DPAD
$PS3_DPAD_DOWN	<RE>$PS4_DPAD_DOWN
$PS3_DPAD_LEFT	<RE>$PS4_DPAD_LEFT
$PS3_DPAD_RIGHT	<RE>$PS4_DPAD_RIGHT
$PS3_DPAD_UP	<RE>$PS4_DPAD_UP
$PS3_EMPTY	<RE>$PS4_EMPTY
$PS3_LEFT_ANALOG_STICK	<RE>$PS4_LEFT_ANALOG_STICK
$PS3_LEFT_ANALOG_STICK_X_MINUS	<RE>$PS4_LEFT_ANALOG_STICK_X_MINUS
$PS3_LEFT_ANALOG_STICK_X_PLUS	<RE>$PS4_LEFT_ANALOG_STICK_X_PLUS
$PS3_LEFT_ANALOG_STICK_Y_MINUS	<RE>$PS4_LEFT_ANALOG_STICK_Y_MINUS
$PS3_LEFT_ANALOG_STICK_Y_PLUS	<RE>$PS4_LEFT_ANALOG_STICK_Y_PLUS
$PS3_LEFT_SHOULDER	<RE>$PS4_LEFT_SHOULDER
$PS3_LEFT_STICK_CLICK	<RE>$GAMEPAD_LEFT_STICK_CLICK
$PS3_LEFT_TRIGGER	<RE>$PS4_LEFT_TRIGGER
$PS3_RIGHT_ANALOG_STICK	<RE>$PS4_RIGHT_ANALOG_STICK
$PS3_RIGHT_ANALOG_STICK_X_MINUS	<RE>$PS4_RIGHT_ANALOG_STICK_X_MINUS
$PS3_RIGHT_ANALOG_STICK_X_PLUS	<RE>$PS4_RIGHT_ANALOG_STICK_X_PLUS
$PS3_RIGHT_ANALOG_STICK_Y_MINUS	<RE>$PS4_RIGHT_ANALOG_STICK_Y_MINUS
$PS3_RIGHT_ANALOG_STICK_Y_PLUS	<RE>$PS4_RIGHT_ANALOG_STICK_Y_PLUS
$PS3_RIGHT_SHOULDER	<RE>$PS4_RIGHT_SHOULDER
$PS3_RIGHT_STICK_CLICK	<RE>$GAMEPAD_RIGHT_STICK_CLICK
$PS3_RIGHT_TRIGGER	<RE>$PS4_RIGHT_TRIGGER
$PS3_START	<RE>$GAMEPAD_START
$PS3_X	<RE>$PS4_X
$PS3_Y	<RE>$PS4_Y
$PS4_A	X-Taste
$PS4_B	Kreis-Taste
$PS4_BACK	Share-Taste
$PS4_BACK_PS4	Touchpad
$PS4_DPAD	<RE>$GAMEPAD_DPAD
$PS4_DPAD_DOWN	<RE>$GAMEPAD_DPAD_DOWN
$PS4_DPAD_LEFT	<RE>$GAMEPAD_DPAD_LEFT
$PS4_DPAD_RIGHT	<RE>$GAMEPAD_DPAD_RIGHT
$PS4_DPAD_UP	<RE>$GAMEPAD_DPAD_UP
$PS4_EMPTY	<RE>$GAMEPAD_EMPTY
$PS4_LEFT_ANALOG_STICK	<RE>$GAMEPAD_LEFT_ANALOG_STICK
$PS4_LEFT_ANALOG_STICK_X_MINUS	<RE>$GAMEPAD_LEFT_ANALOG_STICK_X_MINUS
$PS4_LEFT_ANALOG_STICK_X_PLUS	<RE>$GAMEPAD_LEFT_ANALOG_STICK_X_PLUS
$PS4_LEFT_ANALOG_STICK_Y_MINUS	<RE>$GAMEPAD_LEFT_ANALOG_STICK_Y_MINUS
$PS4_LEFT_ANALOG_STICK_Y_PLUS	<RE>$GAMEPAD_LEFT_ANALOG_STICK_Y_PLUS
$PS4_LEFT_SHOULDER	L1-Schultertaste
$PS4_LEFT_STICK_CLICK	<RE>$GAMEPAD_LEFT_STICK_CLICK
$PS4_LEFT_TRIGGER	L2-Analogtrigger
$PS4_RIGHT_ANALOG_STICK	<RE>$GAMEPAD_RIGHT_ANALOG_STICK
$PS4_RIGHT_ANALOG_STICK_X_MINUS	<RE>$GAMEPAD_RIGHT_ANALOG_STICK_X_MINUS
$PS4_RIGHT_ANALOG_STICK_X_PLUS	<RE>$GAMEPAD_RIGHT_ANALOG_STICK_X_PLUS
$PS4_RIGHT_ANALOG_STICK_Y_MINUS	<RE>$GAMEPAD_RIGHT_ANALOG_STICK_Y_MINUS
$PS4_RIGHT_ANALOG_STICK_Y_PLUS	<RE>$GAMEPAD_RIGHT_ANALOG_STICK_Y_PLUS
$PS4_RIGHT_SHOULDER	R1-Schultertaste
$PS4_RIGHT_STICK_CLICK	<RE>$GAMEPAD_RIGHT_STICK_CLICK
$PS4_RIGHT_TRIGGER	R2-Analogtrigger
$PS4_START	Options-Taste
$PS4_X	Quadrat-Taste
$PS4_Y	Dreieck-Taste
$PSVITA_A	<RE>$PS4_A
$PSVITA_B	<RE>$PS4_B
$PSVITA_BACK	Select-Taste
$PSVITA_DPAD	<RE>$PS4_DPAD
$PSVITA_DPAD_DOWN	<RE>$PS4_DPAD_DOWN
$PSVITA_DPAD_LEFT	<RE>$PS4_DPAD_LEFT
$PSVITA_DPAD_RIGHT	<RE>$PS4_DPAD_RIGHT
$PSVITA_DPAD_UP	<RE>$PS4_DPAD_UP
$PSVITA_EMPTY	<RE>$PS4_EMPTY
$PSVITA_LEFT_ANALOG_STICK	<RE>$PS4_LEFT_ANALOG_STICK
$PSVITA_LEFT_ANALOG_STICK_X_MINUS	<RE>$PS4_LEFT_ANALOG_STICK_X_MINUS
$PSVITA_LEFT_ANALOG_STICK_X_PLUS	<RE>$PS4_LEFT_ANALOG_STICK_X_PLUS
$PSVITA_LEFT_ANALOG_STICK_Y_MINUS	<RE>$PS4_LEFT_ANALOG_STICK_Y_MINUS
$PSVITA_LEFT_ANALOG_STICK_Y_PLUS	<RE>$PS4_LEFT_ANALOG_STICK_Y_PLUS
$PSVITA_LEFT_SHOULDER	<RE>$PS4_LEFT_SHOULDER
$PSVITA_LEFT_STICK_CLICK	<RE>$GAMEPAD_LEFT_STICK_CLICK
$PSVITA_LEFT_TRIGGER	<RE>$PS4_LEFT_TRIGGER
$PSVITA_RIGHT_ANALOG_STICK	<RE>$PS4_RIGHT_ANALOG_STICK
$PSVITA_RIGHT_ANALOG_STICK_X_MINUS	<RE>$PS4_RIGHT_ANALOG_STICK_X_MINUS
$PSVITA_RIGHT_ANALOG_STICK_X_PLUS	<RE>$PS4_RIGHT_ANALOG_STICK_X_PLUS
$PSVITA_RIGHT_ANALOG_STICK_Y_MINUS	<RE>$PS4_RIGHT_ANALOG_STICK_Y_MINUS
$PSVITA_RIGHT_ANALOG_STICK_Y_PLUS	<RE>$PS4_RIGHT_ANALOG_STICK_Y_PLUS
$PSVITA_RIGHT_SHOULDER	<RE>$PS4_RIGHT_SHOULDER
$PSVITA_RIGHT_STICK_CLICK	<RE>$GAMEPAD_RIGHT_STICK_CLICK
$PSVITA_RIGHT_TRIGGER	<RE>$PS4_RIGHT_TRIGGER
$PSVITA_START	<RE>$GAMEPAD_START
$PSVITA_X	<RE>$PS4_X
$PSVITA_Y	<RE>$PS4_Y
$SAVE_SLOT_DELETE_TEXT	Löscht diesen Spielstand permanent von deinem Computer. Du weißt schon, was du da tust, oder?
$SAVE_SLOT_DELETE_TITLE	Spielstand löschen
$SAVE_SLOT_EXPORT_TEXT	Sichere deinen Spielstand in einer einfachen Textdatei.
$SAVE_SLOT_EXPORT_TITLE	Exportiere Spielstand in Datei
$SAVE_SLOT_IMPORT_TEXT	Durchsuche deinen Computer nach einem Defender's Quest Spielstand.
$SAVE_SLOT_IMPORT_TITLE	Importiere Spielstand von Datei
$SAVE_SLOT_NEW_GAME_PLUS_TEXT	Beginnt ein neues, schwierigeres Abenteuer. Deine Erfahrung, Talente und Ausrüstung bleiben erhalten. Neues Spiel+ enthält neue Gegner, neue Nebenaufgaben, stärkere Ausrüstung und ein ausführlicheres Tagebuch. <N><N>ANMERKUNG: der Charakterfortschritt zwischen deinem Originalspielstand und Neues Spiel+ ist GETEILT. Du kannst jederzeit zwischen ihnen wechseln, ohne irgendetwas zu verlieren.
$SAVE_SLOT_NEW_GAME_PLUS_TITLE	Starte ein Neues Spiel+
$SAVE_SLOT_PLAY_PLUS_TEXT	Charakterfortschritt zwischen deinem Originalspielstand und Neues Spiel+ ist GETEILT. Du kannst jederzeit zwischen ihnen wechseln, ohne irgendetwas zu verlieren.
$SAVE_SLOT_PLAY_PLUS_TITLE	Neues Spiel+ fortsetzen
$SHOP_EQUIP	<RE>$MISC_EQUIP	The word 'equip' that appears on the button in the shopping screen in towns
$SOFT_KEYBOARD_BACKSPACE	Rücktaste
$SOFT_KEYBOARD_CLEAR	Entf
$SOFT_KEYBOARD_SPACE	Leertaste
$UI_ACCESS_FAILURE_PENALTY	Strafe bei Versagen
$UI_CONTROLS_GAMEPAD_ACTION_SET	Handlung übernommen
$UI_CONTROLS_GAMEPAD_ICONS	Icons
$UI_CONTROLS_INERTIA	Trägheit
$UI_CONTROLS_PSVITA	PlayStation Vita
$UI_CONTROLS_STEAM_CONTROLLER	Steam Controller
$UI_CONTROLS_STEAM_CONTROLLER_CONFIG	Einstellen
$UI_CONTROLS_STEAM_CONTROLLER_CONFIG_FAIL_TEXT	Konnte Optionsmenü nicht öffnen: ist Steam im Big Picture Modus und funktioniert das Steam-Overlay?
$UI_CONTROLS_STEAM_CONTROLLER_CONFIG_FAIL_TITLE	Steam-Fehler!
$UI_DEMO_IMPORT_OPTIONS	Einstellungen von der Demo importieren?
$UI_DEMO_OPTIONS_DETECTED	Demo-Einstellungen gefunden!
$UI_LEGACY_IMPORT_SAVES	Spielstände aus einer alten Version von Defender's Quest importieren?
$UI_LEGACY_SAVES_DETECTED	Legacy-Spielstände gefunden!
$UI_LEGAL_TITLE	Rechtliches
$WIIU_A	B-Knopf
$WIIU_B	A-Knopf
$WIIU_BACK	-/SELECT-Knopf
$WIIU_DPAD	<RE>$GAMEPAD_DPAD
$WIIU_DPAD_DOWN	<RE>$GAMEPAD_DPAD_DOWN
$WIIU_DPAD_LEFT	<RE>$GAMEPAD_DPAD_LEFT
$WIIU_DPAD_RIGHT	<RE>$GAMEPAD_DPAD_RIGHT
$WIIU_DPAD_UP	<RE>$GAMEPAD_DPAD_UP
$WIIU_EMPTY	<RE>$GAMEPAD_EMPTY
$WIIU_LEFT_ANALOG_STICK	<RE>$GAMEPAD_LEFT_ANALOG_STICK
$WIIU_LEFT_ANALOG_STICK_X_MINUS	<RE>$GAMEPAD_LEFT_ANALOG_STICK_X_MINUS
$WIIU_LEFT_ANALOG_STICK_X_PLUS	<RE>$GAMEPAD_LEFT_ANALOG_STICK_X_PLUS
$WIIU_LEFT_ANALOG_STICK_Y_MINUS	<RE>$GAMEPAD_LEFT_ANALOG_STICK_Y_MINUS
$WIIU_LEFT_ANALOG_STICK_Y_PLUS	<RE>$GAMEPAD_LEFT_ANALOG_STICK_Y_PLUS
$WIIU_LEFT_SHOULDER	L-Taste
$WIIU_LEFT_STICK_CLICK	<RE>$GAMEPAD_LEFT_STICK_CLICK
$WIIU_LEFT_TRIGGER	ZL-Taste
$WIIU_RIGHT_ANALOG_STICK	<RE>$GAMEPAD_RIGHT_ANALOG_STICK
$WIIU_RIGHT_ANALOG_STICK_X_MINUS	<RE>$GAMEPAD_RIGHT_ANALOG_STICK_X_MINUS
$WIIU_RIGHT_ANALOG_STICK_X_PLUS	<RE>$GAMEPAD_RIGHT_ANALOG_STICK_X_PLUS
$WIIU_RIGHT_ANALOG_STICK_Y_MINUS	<RE>$GAMEPAD_RIGHT_ANALOG_STICK_Y_MINUS
$WIIU_RIGHT_ANALOG_STICK_Y_PLUS	<RE>$GAMEPAD_RIGHT_ANALOG_STICK_Y_PLUS
$WIIU_RIGHT_SHOULDER	R-Taste
$WIIU_RIGHT_STICK_CLICK	<RE>$GAMEPAD_RIGHT_STICK_CLICK
$WIIU_RIGHT_TRIGGER	ZR-Taste
$WIIU_START	<PLUS>/START-Knopf
$WIIU_X	Y-Knopf
$WIIU_Y	X-Knopf
$XBOX360_A	<RE>$GAMEPAD_A
$XBOX360_B	<RE>$GAMEPAD_B
$XBOX360_BACK	<RE>$GAMEPAD_BACK
$XBOX360_DPAD	<RE>$GAMEPAD_DPAD
$XBOX360_DPAD_DOWN	<RE>$GAMEPAD_DPAD_DOWN
$XBOX360_DPAD_LEFT	<RE>$GAMEPAD_DPAD_LEFT
$XBOX360_DPAD_RIGHT	<RE>$GAMEPAD_DPAD_RIGHT
$XBOX360_DPAD_UP	<RE>$GAMEPAD_DPAD_UP
$XBOX360_EMPTY	<RE>$GAMEPAD_EMPTY
$XBOX360_LEFT_ANALOG_STICK	<RE>$GAMEPAD_LEFT_ANALOG_STICK
$XBOX360_LEFT_ANALOG_STICK_X_MINUS	<RE>$GAMEPAD_LEFT_ANALOG_STICK_X_MINUS
$XBOX360_LEFT_ANALOG_STICK_X_PLUS	<RE>$GAMEPAD_LEFT_ANALOG_STICK_X_PLUS
$XBOX360_LEFT_ANALOG_STICK_Y_MINUS	<RE>$GAMEPAD_LEFT_ANALOG_STICK_Y_MINUS
$XBOX360_LEFT_ANALOG_STICK_Y_PLUS	<RE>$GAMEPAD_LEFT_ANALOG_STICK_Y_PLUS
$XBOX360_LEFT_SHOULDER	<RE>$GAMEPAD_LEFT_SHOULDER
$XBOX360_LEFT_STICK_CLICK	<RE>$GAMEPAD_LEFT_STICK_CLICK
$XBOX360_LEFT_TRIGGER	<RE>$GAMEPAD_LEFT_TRIGGER
$XBOX360_RIGHT_ANALOG_STICK	<RE>$GAMEPAD_RIGHT_ANALOG_STICK
$XBOX360_RIGHT_ANALOG_STICK_X_MINUS	<RE>$GAMEPAD_RIGHT_ANALOG_STICK_X_MINUS
$XBOX360_RIGHT_ANALOG_STICK_X_PLUS	<RE>$GAMEPAD_RIGHT_ANALOG_STICK_X_PLUS
$XBOX360_RIGHT_ANALOG_STICK_Y_MINUS	<RE>$GAMEPAD_RIGHT_ANALOG_STICK_Y_MINUS
$XBOX360_RIGHT_ANALOG_STICK_Y_PLUS	<RE>$GAMEPAD_RIGHT_ANALOG_STICK_Y_PLUS
$XBOX360_RIGHT_SHOULDER	<RE>$GAMEPAD_RIGHT_SHOULDER
$XBOX360_RIGHT_STICK_CLICK	<RE>$GAMEPAD_RIGHT_STICK_CLICK
$XBOX360_RIGHT_TRIGGER	<RE>$GAMEPAD_RIGHT_TRIGGER
$XBOX360_START	<RE>$GAMEPAD_START
$XBOX360_X	<RE>$GAMEPAD_X
$XBOX360_Y	<RE>$GAMEPAD_Y
$XBOXONE_A	<RE>$GAMEPAD_A
$XBOXONE_B	<RE>$GAMEPAD_B
$XBOXONE_BACK	View-Taste
$XBOXONE_DPAD	<RE>$GAMEPAD_DPAD
$XBOXONE_DPAD_DOWN	<RE>$GAMEPAD_DPAD_DOWN
$XBOXONE_DPAD_LEFT	<RE>$GAMEPAD_DPAD_LEFT
$XBOXONE_DPAD_RIGHT	<RE>$GAMEPAD_DPAD_RIGHT
$XBOXONE_DPAD_UP	<RE>$GAMEPAD_DPAD_UP
$XBOXONE_EMPTY	<RE>$GAMEPAD_EMPTY
$XBOXONE_LEFT_ANALOG_STICK	<RE>$GAMEPAD_LEFT_ANALOG_STICK
$XBOXONE_LEFT_ANALOG_STICK_X_MINUS	<RE>$GAMEPAD_LEFT_ANALOG_STICK_X_MINUS
$XBOXONE_LEFT_ANALOG_STICK_X_PLUS	<RE>$GAMEPAD_LEFT_ANALOG_STICK_X_PLUS
$XBOXONE_LEFT_ANALOG_STICK_Y_MINUS	<RE>$GAMEPAD_LEFT_ANALOG_STICK_Y_MINUS
$XBOXONE_LEFT_ANALOG_STICK_Y_PLUS	<RE>$GAMEPAD_LEFT_ANALOG_STICK_Y_PLUS
$XBOXONE_LEFT_SHOULDER	<RE>$GAMEPAD_LEFT_SHOULDER
$XBOXONE_LEFT_STICK_CLICK	<RE>$GAMEPAD_LEFT_STICK_CLICK
$XBOXONE_LEFT_TRIGGER	<RE>$GAMEPAD_LEFT_TRIGGER
$XBOXONE_RIGHT_ANALOG_STICK	<RE>$GAMEPAD_RIGHT_ANALOG_STICK
$XBOXONE_RIGHT_ANALOG_STICK_X_MINUS	<RE>$GAMEPAD_RIGHT_ANALOG_STICK_X_MINUS
$XBOXONE_RIGHT_ANALOG_STICK_X_PLUS	<RE>$GAMEPAD_RIGHT_ANALOG_STICK_X_PLUS
$XBOXONE_RIGHT_ANALOG_STICK_Y_MINUS	<RE>$GAMEPAD_RIGHT_ANALOG_STICK_Y_MINUS
$XBOXONE_RIGHT_ANALOG_STICK_Y_PLUS	<RE>$GAMEPAD_RIGHT_ANALOG_STICK_Y_PLUS
$XBOXONE_RIGHT_SHOULDER	<RE>$GAMEPAD_RIGHT_SHOULDER
$XBOXONE_RIGHT_STICK_CLICK	<RE>$GAMEPAD_RIGHT_STICK_CLICK
$XBOXONE_RIGHT_TRIGGER	<RE>$GAMEPAD_RIGHT_TRIGGER
$XBOXONE_START	Menü-Taste
$XBOXONE_X	<RE>$GAMEPAD_X
$XBOXONE_Y	<RE>$GAMEPAD_Y
$YOU_GOT_NEW_GAME_PLUS_TEXT	Herzlichen Glückwunsch! Du kannst jetzt ein neues Abenteuer mit deiner alten Gruppe beginnen!<N><N>Stelle dich Mutanten mit neuen Fähigkeiten, verzaubere deine Ausrüstung mit wundersamen neuen Kräften und hol dir neue Bücher für deine Bibliothek. Löse neue Nebenaufgaben mit zusätzlichen Zwischensequenzen und neuen Geschichten, schalte Kommentare der Entwickler frei, übersetze Eztli-Tenochs Sprache, triff neue Charaktere und noch viel mehr!<N><N><RE>[$NEW_GAME_PLUS_NOTE]<N><N>Du kannst jederzeit zu deinem <LQ>normalen<RQ> Spiel zurückkehren.
$YOU_GOT_NEW_GAME_PLUS_TITLE	Neues Spiel+ freigeschaltet!