flag	nick_name	flavor_name	flavor_text
$EN_SLUGWORM	SCHNELL	Wurm	Schnelle Wiedergängerbrut|Diese schnellen wurmartigen Kreaturen besitzen mehrere Reihen scharfer Zähne.<N><N>Laut Augenzeugenberichten platzen sie aus großen, aufgeblähten Wiedergängern, die wochenlang verfaulten.	
$EN_NORMAL_NOMONEY	<RE>$EN_NORMAL_NICK_NAME	<RE>$EN_NORMAL_FLAVOR_NAME	<RE>$EN_NORMAL_FLAVOR_TEXT	
$EN_NORMAL	NORMAL	Wiedergänger	Wiederbelebte Leiche|Leichen erheben sich oft einige Tage nach ihrem Tod in der Grube.<N><N>Diese Monstrositäten sind als <LQ>Wiedergänger<RQ> bekannt, was soviel wie <LQ>die, die zurückkehren<RQ> bedeutet.	
$EN_CULTIST	KULTIST	Kultist	Verwandelter Kultist|<RE>[$EN_CULTIST_BASIC_FLAVOR_TEXT]	
$EN_ARMORED CULTIST	KULTISTEN-PRIESTER	Kultisten-Priester	Kultisten-Priester|<RE>[$EN_CULTIST_SECT_FLAVOR_TEXT]<N><N>Priester, die oftmals ausgiebige Anzeichen von Selbstverstümmelung aufweisen, führen Akte ritueller Gewalt aus.<N><N><RE>[$EN_CULTIST_ACCOUNT_FLAVOR_TEXT]	
$EN_INSANE CULTIST	VERRÜCKTER KULTIST	Hohepriester	Kultisten-Hohepriester|<RE>[$EN_CULTIST_SECT_FLAVOR_TEXT]<N><N>Es gibt historische Aufzeichnungen der Quaid, laut denen der Kult von einer Matriarchin mit Namen <LQ>Königin der vielen Teufel<RQ> regiert wurde. Diese zentralisierte Machtstruktur ist in den vergangenen Jahrhunderten zugunsten einer loseren Ansammlung von Hohepriestern aufgegeben worden.	
$EN_NORMAL_EXP	<RE>$EN_NORMAL_NICK_NAME	<RE>$EN_NORMAL_FLAVOR_NAME	<RE>$EN_NORMAL_FLAVOR_TEXT	
$EN_NORMAL_EXP_PSI	<RE>$EN_NORMAL_NICK_NAME	<RE>$EN_NORMAL_FLAVOR_NAME	<RE>$EN_NORMAL_FLAVOR_TEXT	
$EN_NORMAL_W	<RE>$EN_NORMAL_NICK_NAME	Wasser-Unhold	Schwimmender Wiedergänger|Diese Wiedergänger sondern einen klebrigen Schleim ab, der ihren Körper vor Wasser schützt.<N><N>Giftige Gase füllen ihre Abdomen, sodass sie nicht untergehen.	
$EN_ARMORED	GEPANZERT	Gefallener Ritter	Gepanzerter Wiedergänger|Diese Wiedergänger waren einst Ritter, die im Kampf fielen.<N><N>Zwar haben sie weder ihre Intelligenz noch ihr Geschick behalten, ihre Rüstung haben sie aber noch.	
$EN_SPEEDY	SCHNELL	Wurm	Schnelle Wiedergänger Brut|Diese schnellen, wurmartigen Kreaturen haben zahlreiche Reihen scharfer Zähne.<N><N>Augenzeugenberichten nach brechen sie aus großen, aufgeblähten Wiedergängern hervor, die schon seit Wochen verfaulen.	
$EN_SPEEDY_W	<RE>$EN_SPEEDY_NICK_NAME	Schlange	Schnelle, schwimmende Brut|Manche behaupten, diese schwimmenden Wurm-Wiedergänger entstehen aus im Wasser treibenden Wiedergängern.<N><N>Andere vermuten, sie entwachsen aus Leichen von Fischen und Seeschlangen.	
$EN_ARMORED SPEEDY	<RE>$EN_SPEEDY_NICK_NAME	Schalenwurm	Schnelle, gepanzerte Brut|Diese Wurm-Wiedergänger haben einen dicken Panzer entwickelt.<N><N>Viele mutmaßen, dass die gepanzerte Schale aus den verdauten Knochen der ursprünglichen Leiche besteht.	
$EN_ARMORED_SPEEDY_W	<RE>$EN_SPEEDY_NICK_NAME	Schalenschlange	Schnelle gepanzerte schwimmende Brut|Diese schwimmenden Wurm-Wiedergänger haben sowohl einen schützenden Panzer als auch die Fähigkeit zu schwimmen entwickelt.<N><N>Der Geruch von verdauten Knochen und giftigem Gas ist überwältigend.	
$EN_ATTACKER	KÄMPFER	Wütender Ghul	Kämpfender Wiedergänger|Manche Wiedergänger sind aggressiver als andere.<N><N>Während normale Wiedergänger unbeirrt ein einziges Opfer verfolgen, sind diese dafür bekannt, alles in Sichtweite anzugreifen.	
$EN_DARK ATTACKER	SCHATTEN-BOXER	Dunkler Ghul	Dunkler, kämpfender Wiedergänger|Die im Bauchraum eines Wiedergängers angestauten Gase entweichen durch Hautporen, sodass sie die Kreatur in dichten, überwältigenden Rauch einhüllen, der sowohl die Kreatur verdeckt als auch ihre Opfer verwirrt.	
$EN_ATTACKER_W	<RE>$EN_ATTACKER_NICK_NAME	Flussghul	Kämpfender, schwimmender Wiedergänger|In der Grube gibt es zahlreiche Erzählungen von stinkenden Leichen, die sich aus dem Wasser erheben und durstige Dorfbewohner angreifen.<N><N>Niemand holt allein Wasser und nur Wahnwitzige trauen sich, zu schwimmen.	
$EN_ARMORED ATTACKER	<RE>$EN_ATTACKER_NICK_NAME	Wütender Ritter	Kämpfender, gepanzerter Wiedergänger|Diese gefallenen Ritter sind bösartig und stark.<N><N>Ihre unheimlichen Schreie hallen in den Katakomben und im gesamten Ödland wider.	
$EN_RAPID_ATTACKER	SCHNELLE ATTACKE	
$EN_APC	TEILER	Monstrosität	Brutwirt|Diese aufgeblähten Leichen können sich kaum bewegen und sehen aus, als platzten sie jeden Moment.<N><N>Mehrere Münder voller Zähne entsprießen an ihren Seiten. Sie sind außerdem zu groß, um zurückgeworfen oder verschlungen zu werden.			
$EN_APC_W	<RE>$EN_APC_NICK_NAME	Stinkende Leiche	Schwimmender Brutwirt|Diese Wiedergänger riechen wie ein Sack verfaulter Fische, eingewickelt in Abwässern und Tod.<N><N>Sie treiben problemlos und drohen, jeden Moment aufzuplatzen.	
$EN_ARMORED APC	GEPANZERTER TEILER	Schalen-Bestie	Gepanzerter Brutwirt|Ein gigantischer Panzer schützt diesen monströsen Flatschen aus verdautem Fleisch.<N><N>Man vermutet, dass er keinerlei Knochen mehr besitzt.	
$EN_DOUBLE APC	DOPPEL-TEILER	Scheußlichkeit	Teilender Brutwirt|Dieses seltsame Monster ist verfärbt und aufgebläht.<N><N>Was könnte das bedeuten?	
$EN_ARMORED RANGED ATTACKER	<RE>$EN_RANGED ATTACKER_NICK_NAME	Schlangenghul	Schießender gepanzerter Wiedergänger|<RE>[$EN_RANGED ATTACKER_BASIC_FLAVOR_TEXT]	
$EN_RANGED ATTACKER	FERNKÄMPFER	Schlangenghul	Schießender Wiedergänger|<RE>[$EN_RANGED ATTACKER_BASIC_FLAVOR_TEXT]	
$EN_RANGED ATTACKER_W	<RE>$EN_RANGED ATTACKER_NICK_NAME	Fluss-Schlangenghul	Schwimmender, schießender Wiedergänger|<RE>[$EN_RANGED ATTACKER_BASIC_FLAVOR_TEXT]	
$EN_DARK	DUNKEL	Shattenwurm	Schnelle, dunkle Brut|Diese Würmer sind ummantelt von dichtem schwarzen Nebel, der es fast unmöglich macht, sie zu treffen.
$EN_BRUTE	ZÄH	Todeswurm	Starke Wiedergängerbrut|Diese aschfahlen und wurmartigen Kreaturen bewegen sich langsam und besitzen widerstandsfähige, ledrige Haut statt einer anfälligen äußeren Membran.<N><N>Obwohl man ihnen einfach entkommt, bezwingen sie ihre Beute üblicherweise durch unerbittliche und endlose Verfolgung.	
$EN_NORMAL_LOWXP	<RE>$EN_NORMAL_NICK_NAME	<RE>$EN_NORMAL_FLAVOR_NAME	<RE>$EN_NORMAL_FLAVOR_TEXT	
$EN_CULTIST_LOWXP	<RE>$EN_CULTIST_NICK_NAME	<RE>$EN_CULTIST_FLAVOR_NAME	<RE>$EN_CULTIST_FLAVOR_TEXT	
$EN_ARMORED CULTIST_LOWXP	<RE>$EN_ARMORED CULTIST_NICK_NAME	<RE>$EN_ARMORED CULTIST_FLAVOR_NAME	<RE>$EN_ARMORED CULTIST_FLAVOR_TEXT	
$EN_NORMAL_W_LOWXP	<RE>$EN_NORMAL_NICK_NAME	<RE>$EN_NORMAL_W_FLAVOR_NAME	<RE>$EN_NORMAL_W_FLAVOR_TEXT	
$EN_ARMORED_LOWXP	<RE>$EN_ARMORED_NICK_NAME	<RE>$EN_ARMORED_FLAVOR_NAME	<RE>$EN_ARMORED_FLAVOR_TEXT	
$EN_SPEEDY_LOWXP	<RE>$EN_SPEEDY_NICK_NAME	<RE>$EN_SPEEDY_FLAVOR_NAME	<RE>$EN_SPEEDY_FLAVOR_TEXT	
$EN_SPEEDY_W_LOWXP	<RE>$EN_SPEEDY_NICK_NAME	<RE>$EN_SPEEDY_W_FLAVOR_NAME	<RE>$EN_SPEEDY_W_FLAVOR_TEXT	
$EN_ARMORED SPEEDY_LOWXP	<RE>$EN_SPEEDY_NICK_NAME	<RE>$EN_ARMORED SPEEDY_FLAVOR_NAME	<RE>$EN_ARMORED SPEEDY_FLAVOR_TEXT	
$EN_ARMORED_SPEEDY_W_LOWXP	<RE>$EN_SPEEDY_NICK_NAME	<RE>$EN_ARMORED_SPEEDY_W_FLAVOR_NAME	<RE>$EN_ARMORED_SPEEDY_W_FLAVOR_TEXT	
$EN_ATTACKER_LOWXP	<RE>$EN_ATTACKER_NICK_NAME	<RE>$EN_ATTACKER_FLAVOR_NAME	<RE>$EN_ATTACKER_FLAVOR_TEXT	
$EN_DARK ATTACKER_LOWXP	<RE>$EN_DARK ATTACKER_NICK_NAME	<RE>$EN_DARK ATTACKER_FLAVOR_NAME	<RE>$EN_DARK ATTACKER_FLAVOR_TEXT	
$EN_ATTACKER_W_LOWXP	<RE>$EN_ATTACKER_NICK_NAME	<RE>$EN_ATTACKER_W_FLAVOR_NAME	<RE>$EN_ATTACKER_W_FLAVOR_TEXT	
$EN_ARMORED ATTACKER_LOWXP	<RE>$EN_ATTACKER_NICK_NAME	<RE>$EN_ARMORED ATTACKER_FLAVOR_NAME	<RE>$EN_ARMORED ATTACKER_FLAVOR_TEXT	
$EN_RAPID_ATTACKER_LOWXP	<RE>$EN_RAPID_ATTACKER_NICK_NAME		
$EN_APC_LOWXP	<RE>$EN_APC_NICK_NAME	<RE>$EN_APC_FLAVOR_NAME	<RE>$EN_APC_FLAVOR_TEXT			
$EN_APC_W_LOWXP	<RE>$EN_APC_NICK_NAME	<RE>$EN_APC_W_FLAVOR_NAME	<RE>$EN_APC_W_FLAVOR_TEXT	
$EN_ARMORED APC_LOWXP	<RE>$EN_ARMORED APC_NICK_NAME	<RE>$EN_ARMORED APC_FLAVOR_NAME	<RE>$EN_ARMORED APC_FLAVOR_TEXT	
$EN_DOUBLE APC_LOWXP	<RE>$EN_DOUBLE APC_NICK_NAME	<RE>$EN_DOUBLE APC_FLAVOR_NAME	<RE>$EN_DOUBLE APC_FLAVOR_TEXT	
$EN_ARMORED RANGED ATTACKER_LOWXP	<RE>$EN_RANGED ATTACKER_NICK_NAME	<RE>$EN_ARMORED RANGED ATTACKER_FLAVOR_NAME	<RE>$EN_ARMORED RANGED ATTACKER_FLAVOR_TEXT	
$EN_RANGED ATTACKER_LOWXP	<RE>$EN_RANGED ATTACKER_NICK_NAME	<RE>$EN_RANGED ATTACKER_FLAVOR_NAME	<RE>$EN_RANGED ATTACKER_BASIC_FLAVOR_TEXT	
$EN_RANGED ATTACKER_W_LOWXP	<RE>$EN_RANGED ATTACKER_NICK_NAME	<RE>$EN_RANGED ATTACKER_W_FLAVOR_NAME	<RE>$EN_RANGED ATTACKER_W_FLAVOR_TEXT	
$EN_DARK_LOWXP	<RE>$EN_DARK_NICK_NAME	<RE>$EN_DARK_FLAVOR_NAME	<RE>$EN_DARK_FLAVOR_TEXT	
$EN_BRUTE_LOWXP	<RE>$EN_BRUTE_NICK_NAME	<RE>$EN_BRUTE_FLAVOR_NAME	<RE>$EN_BRUTE_FLAVOR_TEXT	
$EN_APC_NOATTACK_LOWXP	<RE>$EN_APC_NICK_NAME	<RE>$EN_APC_FLAVOR_NAME	<RE>$EN_APC_FLAVOR_TEXT			
$EN_CULTIST_NOATTACK_LOWXP	<RE>$EN_CULTIST_NICK_NAME	<RE>$EN_CULTIST_FLAVOR_NAME	<RE>$EN_CULTIST_FLAVOR_TEXT	
$EN_ERROR	FEHLER	Fehler	Ich bin ein Fehler|Wenn du dies liest bedeutet das wahrscheinlich, dass jemand sich bei den Gegner-Daten verschrieben hat. Diesen Gegner zeigen wir an, wenn der vorgesehene nicht gefunden werden konnte.
$EN_SHEEP	SCHAF	Schaf	Köstliches Säugetier|Drachen können jahrelang ohne Futter leben, aber wenn sie fressen, können sie innerhalb eines Tages ein Vielfaches ihres eigenen Körpergewichts verzehren. Diese Tatsache bereitet den nomadischen Hirten und ihren Herden großes Unbehagen.
$EN_PSI SHEEP	<RE>$EN_SHEEP_NICK_NAME	<RE>$EN_SHEEP_FLAVOR_NAME	<RE>$EN_SHEEP_FLAVOR_TEXT	
$EN_SPEEDY SHEEP	SCHNELLES SCHAF	Schnelles Schaf	Schnelles, köstliches Säugetier|Einige Schafe haben sich an die lebensfeindlichen Umstände in der Grube mit stark ausgeprägten schnellen Muskeln angepasst. Damit können sie zwar nicht vor Drachen weglaufen, aber sie können sich immerhin von den anderen Schafen absetzen.
$EN_SUPER SHEEP	SUPERSCHAF	Superschaf	Mythisches, köstliches Säugetier|Legenden der Drachen erzählen voller Erfurcht von diesem seltenen Schaf, dem Axxima Vatta Muttanaxxor. Die heiligen Drachenschriften beschreiben ein kompliziertes Ritual bei seiner Ankunft. Traditionelle Wissenschaften stufen die Drachenschriften so ein wie andere religiöse Schriften, aber moderne Forschung legt nahe, sie als Kochbuch zu klassifizieren.
$EN_OZIMAL	OZIMAL	Ozimal Kaz	Wiedergänger-Sklave|Einst war er der große Schreckensherrscher der Grube, jetzt ist er Zelemirs willenlose Kreatur.<N>Seine Robe ist aber immer noch ziemlich schick.
$EN_TWIN	ZWILLING	Zwilling	Wiedergänger-Bruder|BLARGH YAAAARGH GAR GAR HUR.
$EN_3_11_BOSS	BOSS
$EN_RIGHT_INDEX_FINGER	ZEIGEFINGER	Zeigefinger	Mönströser Finger|Obwohl er von seiner Hand abgetrennt wurde, bewegt sich dieser Finger aus eigenem Antrieb.
$EN_RIGHT_THUMB	DAUMEN	Daumen	Mönströser Daumen|Obwohl er von seiner Hand abgetrennt wurde, bewegt sich dieser Daumen aus eigenem Antrieb.
$EN_RIGHT_MIDDLE_FINGER	MITTELFINGER	Mittelfinger	Monströser Finger|Dieser abgetrennte Finger scheint eine obszöne Geste zu machen. Wie ungezogen!
$EN_RIGHT_RING_FINGER	RINGFINGER	Ringfinger	<RE>$EN_RIGHT_INDEX_FINGER_FLAVOR_TEXT	
$EN_RIGHT_PINKY_FINGER	KLEINER FINGER	Kleiner Finger	<RE>$EN_RIGHT_INDEX_FINGER_FLAVOR_TEXT	
$EN_RIGHT_EYE	EZTLIS AUGE	Eztlis Auge	Monströses Auge|Dieses böswillige Auge strahlt durch dunkle Energie und bewegt sich mit unnatürlicher Schnelligkeit.
$EN_RIGHT_HAND	EZTLIS HAND	Eztlis Hand	Monströse Hand|Der Kult-Anführer nannte dieses Monster <LQ>die Rechte Hand Eztli-Tenochs.<RQ> Da wenig über Eztli-Tenoch bekannt ist, ist nicht klar, ob dies wirklich die Hand des gefürchteten Zauberers oder vielmehr eine Kreation seiner dunklen Magie ist. Genauer betrachtet, scheint es auch eine LINKE Hand zu sein. Wie link.	
$EN_FINGER	EZTLIS FINGER
$EN_ZELEMIR-CITADEL	<RE>$EN_ZELEMIR_NICK_NAME	<RE>$EN_ZELEMIR_FLAVOR_NAME	<RE>$EN_ZELEMIR_FLAVOR_TEXT	
$EN_ZELEMIR	ZELEMIR	Zelemir	<RE>$EN_ZELEMIR-CITADEL_FLAV_TEXT
$EN_HEALIE	HEALIE	Healie	Geheimer Boss|Beschreibung
$EN_MEANIE	MEANIE	Meanie	<RE>$EN_HEALIE_FLAV_TEXT
$EN_STEALY	STEALY	Stealy	<RE>$EN_HEALIE_FLAV_TEXT
$EN_CRAZY	CRAZY	Crazy	<RE>$EN_HEALIE_FLAV_TEXT
$EN_EZTLI	EZTLI-TENOCH	Eztli-Tenoch	Uralter legendärer Zauberer|Eine uralte Macht, nach langem Schlaf wieder erwacht. Eztli-Tenoch herrschte einst über die bekannte Welt als selbsternannter Gottkönig. Seine Macht und Böswilligkeit sind nur durch seine unbeirrbare Geduld übertroffen.	
$EN_CULTIST_ACCOUNT			Diese Überlieferungen sind von Überlebenden des Massakers am Geka-Stamm. Viele berichten von Kultisten, die sich willkürlich in Wiedergänger verwandelt haben.
$EN_CULTIST_BASIC			<RE>[$EN_CULTIST_SECT_FLAVOR_TEXT]<N><N>Man weiß wenig über ihren Glauben bis auf den Namen ihrer Gottheit, <LQ>Eztli-Tenoch,<RQ> und ihre ständige Jagd nach neuen Opfern.<N><N><RE>[$EN_CULTIST_ACCOUNT_FLAVOR_TEXT]
$EN_CULTIST_SECT			Der <LQ>Kult der Blutirren<RQ> begann mit einer nomadischen Sekte, die für ihr zeremonielles Blutvergießen bekannt war.
$EN_RANGED ATTACKER_BASIC			Nach einigen Wochen beginnt ein merkwürdiger Prozess, der den Körper des Wiedergängers verdaut und verformt.<N><N>Zeugen berichteten von Angriffen durch augenlose <LQ>Schlangenmenschen<RQ>, die widerliche Galle spuckten.