flag	name	description
$ITEM_SWORD	<RE>$ITM_W_SWORD
$ITEM_BOW	<RE>$ITM_W_BOW
$ITEM_STAFF	<RE>$ITM_W_STAFF
$ITEM_LIGHT	<RE>$ITM_A_LIGHT
$ITEM_HEAVY	<RE>$ITM_A_HEAVY
$ITEM_BOOK	<RE>$ITM_ACC_BOOK	
$ITEM_WEAPON	Waffe
$ITEM_ARMOR	Rüstung
$ITM_A_LIGHT	Leichte Rüstung	<NULL>
$ITM_A_LIGHT_PLURAL	Leichte Rüstungen	<NULL>
$ITM_A_HEAVY	Schwere Rüstung	<NULL>
$ITM_A_HEAVY_PLURAL	Schwere Rüstungen	<NULL>
$ITM_W_SWORD	Schwert	<NULL>
$ITM_W_SWORD_PLURAL	Schwerter	<NULL>
$ITM_W_BOW	Bogen	<NULL>
$ITM_W_BOW_PLURAL	Bogen	<NULL>
$ITM_W_STAFF	Stab	<NULL>
$ITM_W_STAFF_PLURAL	Stäbe	<NULL>
$ITM_A_LIGHT_PLURAL_SHORT	Leichte	<NULL>
$ITM_A_HEAVY_PLURAL_SHORT	schwere	<NULL>
$ITM_W_SWORD_PLURAL_SHORT	Schwerter	<NULL>
$ITM_W_STAFF_PLURAL_SHORT	Stäbe	<NULL>
$ITM_W_BOW_PLURAL_SHORT	Bogen	<NULL>
$ITM_A_LIGHT_1	Sackleinen	Ein Leinentuch, das unter der Kleidung getragen wird. Kratzt, ist aber besser als gar nichts.
$ITM_A_LIGHT_2	Tierhäute	Getrocknete Tierhäute, die grob zu einer schützenden Weste genäht wurden. Dick und robust.
$ITM_A_LIGHT_3	Tunika des Häuptlings	Diese großartig gefärbte Nomaden-Tunika besteht aus schwerer Wolle und ist verziert mit kunstvollen Stickereien. Der Saum stellt die sich unaufhörlich windenden Wurzeln des Weltenbaums dar.
$ITM_A_LIGHT_4	Tunika aus schwerer Wolle	Eine lange, dicke Tunika aus der wertvollen Wolle nomadischer Hirten.
$ITM_A_LIGHT_5	Tigerhautweste	Quaid-Feuermotive auf dem bearbeiteten Leder sind die einzigen Hinweise auf die Herkunft dieses exotischen Kleidungsstücks.
$ITM_A_LIGHT_6	Pelz	Warme und gut gepolsterte Weste aus kostbaren Tierpelzen.
$ITM_A_LIGHT_7	Ozimals Mantel	Hat einen leichten Käse-Geruch.
$ITM_A_LIGHT_8	Leder	Ein hochwertig verarbeitetes Wams aus gehärtetem Leder.
$ITM_A_LIGHT_9	Kampfmönchskutte	Diese stark gepolsterte Mönchskutte ist mit den Symbolen der 9. Abteilung der Selini, der Hausmiliz, den Verteidigern von Wahrheit und Ordnung, verziert.
$ITM_A_LIGHT_10	Woll-Gambeson	Mehrere Lagen hochwertiger Wolle, sorgfältig gesteppt und mit Reststoffen und Tierhaaren gefüllt, um eine robuste Verteidigung gegen alle Schläge bis auf die stärksten zu leisten.
$ITM_A_LIGHT_11	Attentäter-Eselei	Auf den ersten Blick scheint es nichts weiter als das verzierte Hemd eines Adligen zu sein. Nähere Betrachtung enthüllt Reih um Reih leichter Metallplatten, die in die Innenseite des Gewands genäht sind. Ein Schnitt im Kreuz ist Hinweis darauf, dass dieses raffinierte Design mindestens einen Meuchelmörder aufgehalten hat.
$ITM_A_LIGHT_12	Seiden-Gambeson	Lage über Lage beständiger Seide zusammen gesteppt mit Pferdehaarpolsterung, um eine Rüstung zu erschaffen, die Pfeile stoppen kann, ohne dass der Träger eine Verletzung davon trägt.
$ITM_A_LIGHT_13	Herr der Bogenschützen	Dieser Gambeson ist aus der schönsten Seide gefertigt und weist komplizierte Stickereien auf, die seinen Besitzer als „Herrn der Bogenschützen“ kennzeichnen. Dutzende kleiner Ausbesserungen auf der Oberfläche deuten darauf, dass diese beispiellose Rüstung in vielen Kämpfen diente, vermutlich von einem Herrn bei seinem Abgang an den nächsten weitergegeben.
$ITM_A_LIGHT_14	Das Platin-Vlies	Viel wertvoller als ein einfaches „goldenes“. Vom Körper des Axxima Vatta Muttunaxxor selbst genommen, sucht dieses vor Glanz blendende Vlies seinesgleichen.
$ITM_A_LIGHT_15	<RE>[$ITM_A_LIGHT_3_NAME]+	<RE>[$ITM_A_LIGHT_3_DESCRIPTION]	
$ITM_A_LIGHT_16	<RE>[$ITM_A_LIGHT_5_NAME]+	<RE>[$ITM_A_LIGHT_5_DESCRIPTION]	
$ITM_A_LIGHT_17	<RE>[$ITM_A_LIGHT_7_NAME]+	<RE>[$ITM_A_LIGHT_7_DESCRIPTION]	
$ITM_A_LIGHT_18	<RE>[$ITM_A_LIGHT_9_NAME]+	<RE>[$ITM_A_LIGHT_9_DESCRIPTION]	
$ITM_A_LIGHT_19	<RE>[$ITM_A_LIGHT_11_NAME]+	<RE>[$ITM_A_LIGHT_11_DESCRIPTION]	
$ITM_A_LIGHT_20	<RE>[$ITM_A_LIGHT_13_NAME]+	<RE>[$ITM_A_LIGHT_13_DESCRIPTION]	
$ITM_A_LIGHT_21	<RE>[$ITM_A_LIGHT_14_NAME]+	<RE>[$ITM_A_LIGHT_14_DESCRIPTION]	
$ITM_A_LIGHT_22	<RE>[$ITM_A_LIGHT_1_NAME]+	<RE>[$ITM_A_LIGHT_1_DESCRIPTION] <RE>[$ITM_PLUS_DESCRIPTION]	
$ITM_A_LIGHT_23	<RE>[$ITM_A_LIGHT_2_NAME]+	<RE>[$ITM_A_LIGHT_2_DESCRIPTION] <RE>[$ITM_PLUS_DESCRIPTION]	
$ITM_A_LIGHT_24	<RE>[$ITM_A_LIGHT_4_NAME]+	<RE>[$ITM_A_LIGHT_4_DESCRIPTION] <RE>[$ITM_PLUS_DESCRIPTION]	
$ITM_A_LIGHT_25	<RE>[$ITM_A_LIGHT_6_NAME]+	<RE>[$ITM_A_LIGHT_6_DESCRIPTION] <RE>[$ITM_PLUS_DESCRIPTION]	
$ITM_A_LIGHT_26	<RE>[$ITM_A_LIGHT_8_NAME]+	<RE>[$ITM_A_LIGHT_8_DESCRIPTION] <RE>[$ITM_PLUS_DESCRIPTION]	
$ITM_A_LIGHT_27	<RE>[$ITM_A_LIGHT_10_NAME]+	<RE>[$ITM_A_LIGHT_10_DESCRIPTION] <RE>[$ITM_PLUS_DESCRIPTION]	
$ITM_A_LIGHT_28	<RE>[$ITM_A_LIGHT_12_NAME]+	<RE>[$ITM_A_LIGHT_12_DESCRIPTION] <RE>[$ITM_PLUS_DESCRIPTION]	
$ITM_A_HEAVY_1	Kettenjacke	Ein leichter Gambeson mit mehreren schlecht geschmiedeten Eisengliedern, die zusammengekettet an der Außenseite der Arme zusätzlichen Schutz bieten sollen
$ITM_A_HEAVY_2	Kettenhemd	Ein Hemd aus hunderten verbundener Metallringe, jeder einzelne davon vernietet, um ein Zerreißen zu verhindern.
$ITM_A_HEAVY_3	Pracht des Krieges	Diese herrliche Quaid-Rüstung ist feinste Mode. Jeder Metallring ist gebläut und die letzten Reihen des Hemds sind vergoldet, um einen goldenen Rand zu bilden. Die verstärkenden Platten sind mit vergoldeten Mustern verziert und tragen auffällig das Symbol der kaiserlichen Familie.  In die Metalloberfläche sind die Quaid-Worte <LQ>Wie spät es sein muss, um über diese Dinge nachzudenken<RQ> eingeritzt. Weitere Wörter sind entlang der Ecken der Platten eingeritzt, aber aufgrund der Eile, in der sie scheinbar geschrieben wurden, sind sie unleserlich.	
$ITM_A_HEAVY_4	Verstärktes Kettenhemd	Ein Kettenhemd, bei dem Metallplatten mit den Ringen verbunden sind, um den Oberkörper besser zu schützen. Standard-Ausrüstung der Quaid-Infanterie während des Krieges.
$ITM_A_HEAVY_5	Reiter-Lamellenpanzer	Dieser hochwertige Lamellen-Harnisch bietet besseren Schulter-Schutz und knielange Beintaschen, was darauf hindeutet, dass der Harnisch für schwere Kavallerie ausgelegt war. Die vergoldeten Armschienen und der Gambeson lassen erkennen, dass der Vorbesitzer ein reicher Krieger mit gutem Geschmack war. In mehrere der Platten sind kleine Schriftzeichen eingeätzt, die scheinbar zu keiner der lokalen Sprachen gehören. Die Position dieser Platten direkt über dem Herz des Träger könnten bedeuten, dass die Schrift eine Art Schutzgebet oder -zauber ist, aber das ist reine Mutmaßung.
$ITM_A_HEAVY_6	Lamellenpanzer	Dutzende kleiner Metallplatten, die mit widerstandsfähigem Seidenfaden aneinander geschnürt sind.
$ITM_A_HEAVY_7	Verräter-Harnisch	Die vergoldeten Schulterplatten dieses Plattenharnischs aus Ashen-Hand lassen vermuten, dass er wahrscheinlich einem hochrangigen Beamten gehört hat. Die Tuch-Oberfläche ist geflickt worden, aber das eingeritzte Ashen-Wort <LQ>Verräter<RQ> kann auf dem Stoff noch immer entziffert werden. Große Blutflecken verdunklen den roten Farbstoff noch weiter, aber der Rüstung wurde kein erkennbarer Schaden zugefügt.	
$ITM_A_HEAVY_8	Plattenmantel	Hervorragender Oberkörper-Schutz dank mehrerer schwerer Metall-Platten, die mit der Innenseite eines Stoff-Waffenrocks vernietet sind.
$ITM_A_HEAVY_9	Wocolans Kraft	Diese Brigantine aus grünem Samt hat lange, aufpolierte Schulterpanzer, wie sie typisch für die schwere Quaid-Infanterie sind. Das vergoldete Wappen zeigt, wie der Held Wocolan einen Bärenschädel mit seinen Fäusten zertrümmert. Darunter trinken seine Kinder Wastan und Wacelle das aus dem Maul laufende Blut, um den mörderischen Weg der Familie ins Exil zu überleben.
$ITM_A_HEAVY_10	Brigantine	Hunderte mit einem Tuch vernietete Metallplatten, sowie eine Ummantelung aus Seide und Samt, bilden diesen eng anliegenden Oberkörperschutz.
$ITM_A_HEAVY_11	Lord Wardens Harnisch	Insignien weisen Lord Warden, den Ashen, der mit der Überwachung der Grube beauftragt wurde, als Besitzer dieses exzellenten Plattenharnischs aus. Wie er sich in seinem eigenen Gefängnis verirrte, ist nicht bekannt, aber Blutflecken auf den Schulterriemen lassen vermuten, dass die Geschichte kein gutes Ende nahm.
$ITM_A_HEAVY_12	Plattenharnisch	Komplex geformte Stahlplatten, die gelenkig auf einem Lederuntergrund angebracht sind, sorgen für maximalen Schutz trotz Bewegungsfreiheit. Die von Ash-Rittern bevorzugte Kleidung.
$ITM_A_HEAVY_13	Reinheit der Flamme	Dieser blank polierte Harnisch reflektiert jegliches Licht mit beinah infernaler Intensität. Undeutliche Anätzungen scheinen Quaidanisch zu sein, der Dialekt ist allerdings so veraltet, dass sie bis auf den Ausdruck <LQ>das Verzehrende<RQ>unleserlich sind. Dieser Brustpanzer wurde vermutlich unzählige Male instand gesetzt – der Rest der Harnischs ist wesentlich moderner. Kryptische Piktogramme weisen auf eine Rolle im Imperialen Feuerritual hin.	
$ITM_A_HEAVY_14	Wächter des Brunnens	Dieser meisterhafte Harnisch wurde so stark gebläut, dass er fast schwarz ist. Goldene Muster entlang der Oberfläche der Brustplatte zeigen den Brunnen des Ash-Tempels, was darauf hinweist, dass diese faszinierende Rüstung sehr wahrscheinlich einem der Elite-Tempelwächter gehörte. Wie dieses unbezahlbare Artefakt in die Grube kam, ist ein Rätsel.
$ITM_A_HEAVY_15	<RE>[$ITM_A_HEAVY_3_NAME]+	<RE>[$ITM_A_HEAVY_3_DESCRIPTION]	
$ITM_A_HEAVY_16	<RE>[$ITM_A_HEAVY_5_NAME]+	<RE>[$ITM_A_HEAVY_5_DESCRIPTION]	
$ITM_A_HEAVY_17	<RE>[$ITM_A_HEAVY_7_NAME]+	<RE>[$ITM_A_HEAVY_7_DESCRIPTION]	
$ITM_A_HEAVY_18	<RE>[$ITM_A_HEAVY_9_NAME]+	<RE>[$ITM_A_HEAVY_9_DESCRIPTION]	
$ITM_A_HEAVY_19	<RE>[$ITM_A_HEAVY_11_NAME]+	<RE>[$ITM_A_HEAVY_11_DESCRIPTION]	
$ITM_A_HEAVY_20	<RE>[$ITM_A_HEAVY_13_NAME]+	<RE>[$ITM_A_HEAVY_13_DESCRIPTION]	
$ITM_A_HEAVY_21	<RE>[$ITM_A_HEAVY_14_NAME]+	<RE>[$ITM_A_HEAVY_14_DESCRIPTION]	
$ITM_A_HEAVY_22	<RE>[$ITM_A_HEAVY_1_NAME]+	<RE>[$ITM_A_HEAVY_1_DESCRIPTION] <RE>[$ITM_PLUS_DESCRIPTION]	
$ITM_A_HEAVY_23	<RE>[$ITM_A_HEAVY_2_NAME]+	<RE>[$ITM_A_HEAVY_2_DESCRIPTION] <RE>[$ITM_PLUS_DESCRIPTION]	
$ITM_A_HEAVY_24	<RE>[$ITM_A_HEAVY_4_NAME]+	<RE>[$ITM_A_HEAVY_4_DESCRIPTION] <RE>[$ITM_PLUS_DESCRIPTION]	
$ITM_A_HEAVY_25	<RE>[$ITM_A_HEAVY_6_NAME]+	<RE>[$ITM_A_HEAVY_6_DESCRIPTION] <RE>[$ITM_PLUS_DESCRIPTION]	
$ITM_A_HEAVY_26	<RE>[$ITM_A_HEAVY_8_NAME]+	<RE>[$ITM_A_HEAVY_8_DESCRIPTION] <RE>[$ITM_PLUS_DESCRIPTION]	
$ITM_A_HEAVY_27	<RE>[$ITM_A_HEAVY_10_NAME]+	<RE>[$ITM_A_HEAVY_10_DESCRIPTION] <RE>[$ITM_PLUS_DESCRIPTION]	
$ITM_A_HEAVY_28	<RE>[$ITM_A_HEAVY_12_NAME]+	<RE>[$ITM_A_HEAVY_12_DESCRIPTION] <RE>[$ITM_PLUS_DESCRIPTION]	
$ITM_A_SKULL_1	Steinschädel	Ein polierter Steinschädel. Manche denken, er sei ein magischer Talisman, mit dem die Wiedergänger in den Kampf ziehen.<N><N><N>Experten sind sich einig, dass du den hier vermutlich gegen irgendwas richtig Abgefahrenes eintauschen kannst.	
$ITM_A_SKULL_2	Bronze-Schädel	Aus massiver Bronze gegossen und vielleicht für bestimmte Beschwörungen oder Zeremonien verwendet<N>Sicherlich mehr wert als ein polierter Steinschädel.		
$ITM_A_SKULL_3	Obsidian-Schädel	Sorgfältig aus massivem Obsidian gemeißelt, ist der Detailgrad dieses tiefschwarzen Schädels sowohl<N>faszinierend als auch unheimlich. Da sie extrem selten sind, haben Sammler ein sehr großes Interesse an diesen Schädeln.		
$ITM_A_SKULL_4	Silber-Schädel	Dieser Schädel ist aus purem Silber. Wofür könnte er gut sein?
$ITM_A_SKULL_5	Gold-Schädel	Dieser Schädel ist aus purem Gold. Wofür könnte er gut sein?
$ITM_A_SKULL_6	Unobtanium-Schädel	Gefertigt aus reinem Unobtanium, und daher unmöglich zu erlangen. Du hast ihn tatsächlich die ganze Zeit bei dir getragen, aber seltsamerweise bis jetzt nicht bemerkt.
$ITM_W_SWORD_1	Steinmesser	Ein scharfer Stein, der an einem hölzernen Griff angebracht wurde. Besser als nichts.
$ITM_W_SWORD_2	Metallmesser	Eine Klinge aus Restmetall. Einfach, aber effektiv.
$ITM_W_SWORD_3	Verrostetes Schwert	Ein verrostetes, kaputtes Schwert. Solche abgeworfenen Relikte des Krieges gibt es in der Grube wie Sand am Meer.	
$ITM_W_SWORD_4	Blutfehden-Kopal	Auf diesem Nomaden-Kampfmesser sind die Symbole des Gasta-Stamms oberhalb einer unbekannten rivalisierenden Gruppe eingraviert - ein Hinweis auf eine Blutfehde zwischen den beiden Stämmen. In den Steingriff sind 17 Todes-Markierungen eingekerbt.	
$ITM_W_SWORD_5	Eisenschwert	Ein einfaches Eisenschwert. Schlecht ausbalanciert und einfach geschmiedet, aber ansonsten in gutem Zustand.
$ITM_W_SWORD_6	Rehabilitation der Ehre	Das verzierte Jadeheft und Einlagen im Knauf täuschen über die bösartige Funktionalität dieses Quaid-Duellschwerts hinweg.  Die Klingenbasis trägt die Inschrift<N><LQ>Rehabilitation des Ehrenvollen. Die Flamme in mir brennt.<RQ> Wahrscheinlich wurde es für ein spezielles Duell erschaffen, um eine vermeintliche Schande zwischen zwei Adligen zu klären.	
$ITM_W_SWORD_7	Soldatenschwert	Ein militärisches Schwert, während des Krieges in Massen produziert. Effektiv und stark.
$ITM_W_SWORD_8	Schneide der Ordnung	Diese Ash-Schneide trägt eine altertümliche Inschrift entlang dem Klingenrücken:<N><LQ>Ich bin die Schneide der Ordnung. Ich trenne die Rechtschaffenden von den Bösen, das Dunkel vom Licht. Ich führe die Hand, die mich nutzt zu...<RQ> Das Polieren über Generationen hinweg hat den Rest des Textes zu undeutlich gemacht, um ihn lesen zu können.	
$ITM_W_SWORD_9	Offiziersschwert	Ein weiteres Überbleibsel des Kriegs, dieses wurde für einen Offizier von Hand gefertigt.
$ITM_W_SWORD_10	Legions-Kommandant	Die elegante, aber einfache Konstruktion dieser Ashen-Waffe ist ein Hinweis, dass sie für einen bescheidenen Adligen gefertigt wurde.<N><N>Eine Seite des Hefts trägt die Inschrift 'Legions-Kommandant' , während auf der anderen Seite 'Diener der unbewegten Beweger' steht. Auf dem runden Knauf sind auf einer Seite die Kugeln der himmlischen Maschine und auf der anderen Seite ein Pilger, der aus dem Brunnen des Ash-Tempels trinkt, abgebildet.	
$ITM_W_SWORD_11	Meister-Schwert	Meisterhaft geschmiedet und ausbalanciert. Diese Waffe ist die Arbeit eines wahren Meisterschmieds.	
$ITM_W_SWORD_12	Auge der Flamme	Dieses makellose Schwert trägt entlang der Blutrinne eine sehr alte quaidanische Inschrift.  Das hohe Alter des Dialekts und die Abnutzung des Schwertes machen es kaum entzifferbar:<N><LQ>Sehet...Auge der Flamme...Ruhm...Fliehet beschämt...Eine königliche Sache...<RQ>  Zwei riesige Rubine am Knauf scheinen mit einem inneren Feuer zu brennen.  Der meisterhaft geformte Griff zeigt die Mauer des Andenkens, auf der die Namen aller ehrhaften quaidanischen Herrscher vermerkt sind. Diese bemerkenswerte Waffe gehörte sehr wahrscheinlich einem Mitglied der königlichen Familie.	
$ITM_W_SWORD_13	Evni	Das Traumschwert eines Berserkers. Auf der ganzen Welt gibt es nur eins und der Preis scheint entsprechend angesetzt zu sein.
$ITM_W_SWORD_14	<RE>[$ITM_W_SWORD_4_NAME]+	<RE>$ITM_W_SWORD_4_DESCRIPTION	
$ITM_W_SWORD_15	<RE>[$ITM_W_SWORD_6_NAME]+	<RE>$ITM_W_SWORD_6_DESCRIPTION	
$ITM_W_SWORD_16	<RE>[$ITM_W_SWORD_8_NAME]+	<RE>$ITM_W_SWORD_8_DESCRIPTION	
$ITM_W_SWORD_17	<RE>[$ITM_W_SWORD_10_NAME]+	<RE>$ITM_W_SWORD_10_DESCRIPTION	
$ITM_W_SWORD_18	<RE>[$ITM_W_SWORD_12_NAME]+	<RE>$ITM_W_SWORD_12_DESCRIPTION	
$ITM_W_SWORD_19	<RE>[$ITM_W_SWORD_13_NAME]+	<RE>$ITM_W_SWORD_13_DESCRIPTION	
$ITM_W_SWORD_20	<RE>[$ITM_W_SWORD_1_NAME]+	<RE>[$ITM_W_SWORD_1_DESCRIPTION] <RE>[$ITM_PLUS_DESCRIPTION]	
$ITM_W_SWORD_21	<RE>[$ITM_W_SWORD_2_NAME]+	<RE>[$ITM_W_SWORD_2_DESCRIPTION] <RE>[$ITM_PLUS_DESCRIPTION]	
$ITM_W_SWORD_22	<RE>[$ITM_W_SWORD_3_NAME]+	<RE>[$ITM_W_SWORD_3_DESCRIPTION] <RE>[$ITM_PLUS_DESCRIPTION]	
$ITM_W_SWORD_23	<RE>[$ITM_W_SWORD_5_NAME]+	<RE>[$ITM_W_SWORD_5_DESCRIPTION] <RE>[$ITM_PLUS_DESCRIPTION]	
$ITM_W_SWORD_24	<RE>[$ITM_W_SWORD_7_NAME]+	<RE>[$ITM_W_SWORD_7_DESCRIPTION] <RE>[$ITM_PLUS_DESCRIPTION]	
$ITM_W_SWORD_25	<RE>[$ITM_W_SWORD_9_NAME]+	<RE>[$ITM_W_SWORD_9_DESCRIPTION] <RE>[$ITM_PLUS_DESCRIPTION]	
$ITM_W_SWORD_26	<RE>[$ITM_W_SWORD_11_NAME]+	<RE>[$ITM_W_SWORD_11_DESCRIPTION] <RE>[$ITM_PLUS_DESCRIPTION]	
$ITM_W_BOW_1	Grüner Bogen	Ein einfacher Bogen aus Holz eines jungen Baums mit hölzernen Pfeilen.
$ITM_W_BOW_2	Holzbogen	Ein Bogen aus Holz und Pfeile mit Steinspitzen.
$ITM_W_BOW_3	Jagd-Kampf-Bogen	Dieser Jagdbogen der Nomaden scheint auch als Kriegswaffe genutzt worden zu sein. Das nomadische Zeichen für „erfolgreiche Jagd“ wurde mit dem für „Tod“ übermalt. Auf der Innenseite des Bogens ist eine Darstellung eines Gottes der Sdeka-Familie, der einen abgetrennten Kopf hält. Rote Siegesstreifen an den Spitzen weisen darauf hin, dass diese Waffe in einem längst vergessenen Kampf häufig genutzt wurde.
$ITM_W_BOW_4	Jägerbogen	Ein stabiler Eibenbogen und Pfeile mit Steinspitzen.	
$ITM_W_BOW_5	Relikt des Nordens	Dieser ausgezeichnete Jagdbogen besteht aus reinem weißen Birkenholz. Der blaue Griff ist mit Golddraht umwickelt und seltsame Schriftzeichen winden sich an dessen Ende – möglicherweise eine der vielen Sprachen aus den Stadtstaaten im Norden. Das nomadische Symbol der Ked-Familie ist auf eine Seite gemalt, ein Zeichen dafür, dass der Bogen mit dem Stamm nach Süden reiste.
$ITM_W_BOW_6	Geweihbogen	Ein starker Bogen, geschnitzt aus einem Hirschgeweih.
$ITM_W_BOW_7	Kriegsbogen eines Hauptmanns	Dieser Ashen-Kriegsbogen besteht aus mehreren zusammengeklebten Lagen seltenen Holzes. Auf dem Griff ist eine Darstellung einer Drehvorrichtung. Eine goldene Inschrift lautet „Hauptmann Zantimon, Verteidiger des Weges“, vermutlich ein Anführer einer der zahlreichen Patrouillen, die Pilger des Ash-Tempels gegen Banditen und Nomaden-Räuber schützten.
$ITM_W_BOW_8	Großer Hirschbogen	Ein antiker Bogen, aus dem Geweih eines großen Hirschs geschnitzt.
$ITM_W_BOW_9	Triumph des Kriegsherrn	Dieser fachmännisch hergestellte Recurvebogen ist mit Goldringeln und leuchtend bunt gefärbtem Leder verziert. Der verzierte Griff stellt einen siegreichen Kriegsherrn dar, der auf einem Berg erschlagener Feinde steht. Mehrere nicht zu erkennende Gottheiten segnen ihn von oben. Diese Waffe gehörte offensichtlich einem wohlhabenden und erfolgreichen Nomaden-Häuptling.
$ITM_W_BOW_10	Komposit-Kriegsbogen	Dieser aus mehreren unterschiedlichen Holzarten geschaffene Kompositbogen gehörte vermutlich einem Offizier.
$ITM_W_BOW_11	Vergoldeter Tod	Dieser mit Hornspitzen besetzte Kriegsbogen ist mit zahlreichen Goldringen verziert. Der Ledergriff trägt eine alte Quaid-Inschrift: <LQ>Lucawan, du, der du Ehre opfertest für billiges Gold, erblicke deinen Tod im Gold dieser Waffe. Treffen soll dich ihr Pfeil und deine Verräter-Leiche soll Hunden und Würmern als Spielzeug dienen.<RQ> Darunter, in die Oberfläche des Leders eingraviert, steht <LQ>Es ist vollbracht.<RQ>	
$ITM_W_BOW_12	Verstärkter Langbogen	Da er aus dickem Eichenholz besteht, benötigt dieser Bogen zwar unglaublich viel Stärke zum Spannen, kann aber in der Hand derer, die ihn im Griff haben, tödliche Schüsse abgeben.
$ITM_W_BOW_13	<RE>[$ITM_W_BOW_3_NAME]+	<RE>[$ITM_W_BOW_3_DESCRIPTION]	
$ITM_W_BOW_14	<RE>[$ITM_W_BOW_5_NAME]+	<RE>[$ITM_W_BOW_5_DESCRIPTION]	
$ITM_W_BOW_15	<RE>[$ITM_W_BOW_7_NAME]+	<RE>[$ITM_W_BOW_7_DESCRIPTION]	
$ITM_W_BOW_16	<RE>[$ITM_W_BOW_9_NAME]+	<RE>[$ITM_W_BOW_9_DESCRIPTION]	
$ITM_W_BOW_17	<RE>[$ITM_W_BOW_11_NAME]+	<RE>[$ITM_W_BOW_11_DESCRIPTION]	
$ITM_W_BOW_18	<RE>[$ITM_W_BOW_1_NAME]+	<RE>[$ITM_W_BOW_1_DESCRIPTION]	
$ITM_W_BOW_19	<RE>[$ITM_W_BOW_2_NAME]+	<RE>[$ITM_W_BOW_2_DESCRIPTION]	
$ITM_W_BOW_20	<RE>[$ITM_W_BOW_4_NAME]+	<RE>[$ITM_W_BOW_4_DESCRIPTION]	
$ITM_W_BOW_21	<RE>[$ITM_W_BOW_6_NAME]+	<RE>[$ITM_W_BOW_6_DESCRIPTION]	
$ITM_W_BOW_22	<RE>[$ITM_W_BOW_8_NAME]+	<RE>[$ITM_W_BOW_8_DESCRIPTION]	
$ITM_W_BOW_23	<RE>[$ITM_W_BOW_10_NAME]+	<RE>[$ITM_W_BOW_10_DESCRIPTION]	
$ITM_W_BOW_24	Verstärkter Langbogen+	<RE>$ITM_W_BOW_12_DESC
$ITM_W_STAFF_1	Gehstock	Ein fester, massiver Stock.
$ITM_W_STAFF_2	Hirtenstab	Ein einfacher Hirtenstab.
$ITM_W_STAFF_3	Stab eines Scharlatans	Dieser mit Verzierungen überladene Stab ist mit seltsamem Text entlang des Schafts verziert. Bei näherer Betrachtung zeigt sich, dass die Schrift nicht mehr als Kauderwelsch ist, eingeritzt um die Ungebildeten zu täuschen. An den Enden hat der Stab mehrere hohle Kammern mit Pudern, um farbigen Rauch zu schaffen und etwas, was einst wohl ein Kanarienvogel war.
$ITM_W_STAFF_4	Eichenstab	Ein gut geschnitzter Eichenstab mit einem festen Ledergriff.
$ITM_W_STAFF_5	Erzhirtenstab	Dieser robuste Stab ist übersät mit Talismanen, die in mehreren Quaid-, Ash- und Nomaden-Dialekten, sowie in einigen unidentifizierbaren Sprachen beschrieben sind. Entlang der Stabspitze stehen die Quaid-Wörter <LQ>Meister der Schafe, Hüter der Lager<RQ>. Darunter zeigt das Wappen des Wüstenjuwels, dass der unglückliche Besitzer damit beauftragt war, die bösartigen Wildschafe unter der Stadt zu pflegen. Das untere Ende des Stabs ist übersät mit hunderten von Zahnabdrücken. Einige Zähne stecken noch immer im Holz.	
$ITM_W_STAFF_6	Knüppel	Ein robuster Eichenstab mit einem ausgehöhlten und mit Blei befülltem Ende, um die Masse zu erhöhen.
$ITM_W_STAFF_7	Waffe der Bestie	Dieser außergewöhnliche Stab ist aus einem einzigen Stück Elfenbein geschnitzt. Allein der Gedanke, welches Monster ein so großes Horn hervorbringen kann, ist wahrlich furchterregend. Kunstvolle Schnitzereien entlang des Stabs scheinen die Geschichte eines unbekannten Helden zu erzählen. Sie passt zu keiner Ash-, Nomaden- oder Quaid-Geschichte und es gibt auch keine identifizierenden Worte, sodass sowohl der Schnitzer als auch das Monster, von dem dieser Stab stammt, ein Geheimnis bleiben.
$ITM_W_STAFF_8	Eisenholzstab	Ein ausgezeichneter Stab, der aus den seltensten Hölzern geschnitzt ist.
$ITM_W_STAFF_9	Henkersknüppel	Dieser kräftige Stab ist mit Eisen beschlagen, ein Ende wurde ausgehöhlt und mit Blei gefüllt, um ihm zusätzliche Wucht beim Schwung zu geben. Seltsame Einätzungen verzieren die Metalloberfläche. Die Sprache ist unbekannt, vermutlich eine der vielen Sprachen, die in den nördlichen Stadtstaaten gesprochen werden. Gekreuzte Schlüssel unterhalb eines Totenkopfs symbolisieren vermutlich eine verantwortungsvolle Position, vielleicht ein Gefängniswärter, ein Henker oder ein anderes Amt, das für ein Schwert als unwürdig betrachtet wird. Blutflecken auf der Trefffläche des Stabs zeigen, dass diese Aufgabe häufig in Anspruch genommen wurde.
$ITM_W_STAFF_10	Stahlbeschlagener Stab	Ein robuster Stab, der mit langen Stahlplatten verstärkt wurde.
$ITM_W_STAFF_11	Bewahrer der Flamme	Dieser Stab mit Silberplatten ist nach Generationen der Nutzung angelaufen. Weniger befleckte Stellen scheinen mit altertümlichen Quaid-Schriften bedeckt zu sein. Durch das Verdunkeln des Silbers und das extrem hohe Alter des Dialekts ist das meiste nicht zu entziffern. Die Phrase <LQ>Jene, die die Flamme halten<RQ> erscheint mehrere Male, sowie <LQ>Ekstase... verzehren<RQ>. Beide Enden des Stabs sind dank angehäufter Brandspuren fast schwarz, vielleicht ein Hinweis auf eine Nutzung in einem imperialen Quaid-Feuerritual.	
$ITM_W_STAFF_12	Pilgerstab	Einer der vielen Stäbe, welche die Selini-Mönche Reisenden schenkten. Der Schaft ist mit Stahlplatten verstärkt und in die Holzoberfläche sind Gebete eingeschnitzt.
$ITM_W_STAFF_13	Kozomons Szepter	Dieser rustikale Eichenstab trägt in einem archaischen Ash-Dialekt die Inschrift <LQ>Kozomon Kastankim<RQ>, was dieses einfache Gerät als Eigentum des ersten Jüngers Selinadts ausweist. Dieses Relikt galt als verloren, als sein Kapitelhaus in den letzten Jahren des Quadanischen Kriegs ausgeraubt wurde. Das Gold und die Juwelen, die zur Verzierung genutzt wurden, sind vor langer Zeit entfernt worden, aber der Stab selbst ist unbeschädigt. Jahrhunderte der Verehrung und einige Feuer haben das ursprüngliche Holz fast pechschwarz gemacht, es hat dennoch all seine Stärken behalten.	
$ITM_W_STAFF_14	<RE>[$ITM_W_STAFF_3_NAME]+	<RE>[$ITM_W_STAFF_3_DESCRIPTION]	
$ITM_W_STAFF_15	<RE>[$ITM_W_STAFF_5_NAME]+	<RE>[$ITM_W_STAFF_5_DESCRIPTION]	
$ITM_W_STAFF_16	<RE>[$ITM_W_STAFF_7_NAME]+	<RE>[$ITM_W_STAFF_7_DESCRIPTION]	
$ITM_W_STAFF_17	<RE>[$ITM_W_STAFF_9_NAME]+	<RE>[$ITM_W_STAFF_9_DESCRIPTION]	
$ITM_W_STAFF_18	<RE>[$ITM_W_STAFF_11_NAME]+	<RE>[$ITM_W_STAFF_11_DESCRIPTION]	
$ITM_W_STAFF_19	<RE>[$ITM_W_STAFF_13_NAME]+	<RE>[$ITM_W_STAFF_13_DESCRIPTION]	
$ITM_W_STAFF_20	<RE>[$ITM_W_STAFF_1_NAME]+	<RE>[$ITM_W_STAFF_1_DESCRIPTION] <RE>[$ITM_PLUS_DESCRIPTION]	
$ITM_W_STAFF_21	<RE>[$ITM_W_STAFF_2_NAME]+	<RE>[$ITM_W_STAFF_2_DESCRIPTION] <RE>[$ITM_PLUS_DESCRIPTION]	
$ITM_W_STAFF_22	<RE>[$ITM_W_STAFF_4_NAME]+	<RE>[$ITM_W_STAFF_4_DESCRIPTION] <RE>[$ITM_PLUS_DESCRIPTION]	
$ITM_W_STAFF_23	<RE>[$ITM_W_STAFF_6_NAME]+	<RE>[$ITM_W_STAFF_6_DESCRIPTION] <RE>[$ITM_PLUS_DESCRIPTION]	
$ITM_W_STAFF_24	<RE>[$ITM_W_STAFF_8_NAME]+	<RE>[$ITM_W_STAFF_8_DESCRIPTION] <RE>[$ITM_PLUS_DESCRIPTION]	
$ITM_W_STAFF_25	<RE>[$ITM_W_STAFF_10_NAME]+	<RE>[$ITM_W_STAFF_10_DESCRIPTION] <RE>[$ITM_PLUS_DESCRIPTION]	
$ITM_W_STAFF_26	<RE>[$ITM_W_STAFF_12_NAME]+	<RE>[$ITM_W_STAFF_12_DESCRIPTION] <RE>[$ITM_PLUS_DESCRIPTION]	
$ITM_W_BOOK_1	<RE>$ITM_ACC_BOOK_1_NAME	<RE>$ITM_ACC_BOOK_1_DESCRIPTION	
$ITM_W_BOOK_2	<RE>$ITM_ACC_BOOK_2_NAME	<RE>$ITM_ACC_BOOK_2_DESCRIPTION	
$ITM_W_BOOK_3	<RE>$ITM_ACC_BOOK_3_NAME	<RE>$ITM_ACC_BOOK_3_DESCRIPTION	
$ITM_W_BOOK_4	<RE>$ITM_ACC_BOOK_4_NAME	<RE>$ITM_ACC_BOOK_4_DESCRIPTION	
$ITM_W_BOOK_5	<RE>$ITM_ACC_BOOK_5_NAME	<RE>$ITM_ACC_BOOK_5_DESCRIPTION	
$ITM_W_BOOK_6	<RE>$ITM_ACC_BOOK_6_NAME	<RE>$ITM_ACC_BOOK_6_DESCRIPTION	
$ITM_W_BOOK_7	<RE>$ITM_ACC_BOOK_7_NAME	<RE>$ITM_ACC_BOOK_7_DESCRIPTION	
$ITM_W_BOOK_8	<RE>$ITM_ACC_BOOK_8_NAME	<RE>$ITM_ACC_BOOK_8_DESCRIPTION	
$ITM_W_BOOK_9	<RE>$ITM_ACC_BOOK_9_NAME	<RE>$ITM_ACC_BOOK_9_DESCRIPTION	
$ITM_W_BOOK_10	<RE>$ITM_ACC_BOOK_10_NAME	<RE>$ITM_ACC_BOOK_10_DESCRIPTION	
$ITM_W_BOOK_11	<RE>$ITM_ACC_BOOK_11_NAME	<RE>$ITM_ACC_BOOK_11_DESCRIPTION	
$ITM_W_BOOK_12	<RE>$ITM_ACC_BOOK_12_NAME	<RE>$ITM_ACC_BOOK_12_DESCRIPTION	
$ITM_W_BOOK_13	<RE>$ITM_ACC_BOOK_13_NAME	<RE>$ITM_ACC_BOOK_13_DESCRIPTION	
$ITM_W_BOOK_14	<RE>$ITM_ACC_BOOK_14_NAME	<RE>$ITM_ACC_BOOK_14_DESCRIPTION	
$ITM_W_BOOK_15	<RE>$ITM_ACC_BOOK_15_NAME	<RE>$ITM_ACC_BOOK_15_DESCRIPTION	
$ITM_W_BOOK_16	<RE>$ITM_ACC_BOOK_16_NAME	<RE>$ITM_ACC_BOOK_16_DESCRIPTION	
$ITM_W_BOOK_17	<RE>$ITM_ACC_BOOK_17_NAME	<RE>$ITM_ACC_BOOK_17_DESCRIPTION	
$ITM_W_BOOK_18	<RE>$ITM_ACC_BOOK_18_NAME	<RE>$ITM_ACC_BOOK_18_DESCRIPTION	
$ITM_W_BOOK_19	<RE>$ITM_ACC_BOOK_19_NAME	<RE>$ITM_ACC_BOOK_19_DESCRIPTION	
$ITM_W_BOOK_20	<RE>$ITM_ACC_BOOK_20_NAME	<RE>$ITM_ACC_BOOK_20_DESCRIPTION	
$ITM_W_BOOK_21	<RE>$ITM_ACC_BOOK_21_NAME	<RE>$ITM_ACC_BOOK_21_DESCRIPTION	
$ITM_ACC_BOOK	Buch	<NULL>
$ITM_ACC_BOOK_1	Blitzschlag	Blitze treffen die Feinde und lähmen sie kurzzeitig.
$ITM_ACC_BOOK_10	Psi-Schild	Feinde, die $MCG treffen, ziehen ihr Psi statt TP ab. Für jeden in den Kristallzauber investierten Punkt wird weniger Psi abgezogen.
$ITM_ACC_BOOK_11	Explosiver Anfang	Verteidiger zu beschwören und zu verstärken verursacht kleine Explosionen.
$ITM_ACC_BOOK_12	Explosives Ende	Wird ein Verteidiger besiegt, kommt es zu einer kleinen Explosion.
$ITM_ACC_BOOK_13	Buch der Seuchen	Alle Verteidiger außer $MCG regenerieren nicht und alle Feinde bis auf Bosse sind giftig.<N><N><RE>[$ITM_BOOK_PERHAPS_DESCRIPTION]
$ITM_ACC_BOOK_14	Buch des Blutes	Alle Verteidiger und Feinde bis auf $MCG und Bosse bluten.<N><N><RE>[$ITM_BOOK_PERHAPS_DESCRIPTION]
$ITM_ACC_BOOK_15	Buch der Synergie	Eis, Wasser und Feuer heben sich nicht mehr gegenseitig auf.<N><N><RE>[$ITM_BOOK_PERHAPS_DESCRIPTION]
$ITM_ACC_BOOK_16	Tal der Vergessenen	Dieses Buch hat keine magischen Kräfte. Stattdessen ist es eine Autobiografie. Sie erzählt die Geschichte einer jungen Ashen-Bibliothekarin, die eine Seuche überlebt und daraufhin in einer Kolonie gefangen ist. Sie ist in Form eines Tagebuchs geschrieben und enthält viele Illustrationen, die mit behelfsmäßigen Materialien wie Kohle, Tee, Pflanzenextrakt und Blut angefertigt wurden.<N><N><RE>[$ITM_BOOK_PERHAPS_DESCRIPTION]
$ITM_ACC_BOOK_17	Buch des Wagemuts	Verteidiger können nicht erneut beschworen werden, wenn sie im Kampf fallen oder zurückgerufen werden
$ITM_ACC_BOOK_18	Buch der Stille	$MCG kann im Kampf nicht zaubern.
$ITM_ACC_BOOK_19	Buch des Gesichts	Funkioniert NUR bei EXTREMEN Herausforderungen: <N><N>Feinde aktualisieren ihren <LQ>Status<RQ> zufällig mit neuen Gesichtern. Wie merkwürdig.
$ITM_ACC_BOOK_2	Kettenblitze	Blitze treffen 1 zusätzliches Ziel mit abnehmender Stärke für jeden Talentpunkt in Blitzschlag.
$ITM_ACC_BOOK_20	Anonymes Buch	Funkioniert NUR bei EXTREMEN Herausforderungen: <N><N>Verteidiger werden anonym und erhalten +3% Chance, auszuweichen.
$ITM_ACC_BOOK_21	Buch der Geheimnisse	Du kannst ein leises Flüstern hören, wenn du es an dein Ohr hältst.<N><N><RE>[$ITM_BOOK_PERHAPS_DESCRIPTION]
$ITM_ACC_BOOK_3	Furiouser Anfang	Frisch beschworene Verteidiger sind im Kampfrausch.
$ITM_ACC_BOOK_4	Furiouses Ende	Verteidiger unter 25% ihrer TP erhalten Kampfrausch.
$ITM_ACC_BOOK_5	Licht des Urteils	Heilung zu zaubern macht alle Gegner BLIND.
$ITM_ACC_BOOK_6	Licht der Glorie	Heilung zu zaubern fügt allen Gegnern LICHT-Schaden zu.
$ITM_ACC_BOOK_7	Langsamer Anfang	Gerade erschienene Feinde werden kurzzeitig verlangsamt.
$ITM_ACC_BOOK_8	Langsames Ende	Feinde werden langsamer, je näher sie $MCG kommen.
$ITM_ACC_BOOK_9	Kristallfeld	$MCG beginnt den Level von etlichen Kristallen umringt.
$ITM_ACC_BOOK_PLURAL	Bücher	<NULL>
$ITM_ACC_BOOK_PLURAL_SHORT	Bücher	<NULL>
$ITM_BOOK_PERHAPS	<NOTHING>	Vielleicht solltest du dieses Buch mit auf dein nächstes Abenteuer nehmen.
$ITM_PLUS	Item+	Ein mysteriöses <LQ>+<RQ> Symbol weist darauf hin, dass dieser Gegenstand sehr stark ist.