flag	content
$ENTRY_JOURNAL_INDEX_TITLE	INDICE
$ENTRY_JOURNAL2_INDEX_TITLE	SEGRETI
$ENTRY_JOURNAL_INDEX_LEFT_00	Voci
$ENTRY_JOURNAL_INDEX_LEFT_10	1º giorno: @Dove sono?@
$ENTRY_JOURNAL_INDEX_LEFT_20	1º notte: @[berserker_hero]@
$ENTRY_JOURNAL_INDEX_LEFT_30	3º giorno: @Addendum@
$ENTRY_JOURNAL_INDEX_LEFT_40	3º notte: @Addendum@
$ENTRY_JOURNAL_INDEX_LEFT_50	3º giorno: @In prigione@
$ENTRY_JOURNAL_INDEX_LEFT_60	4º giorno: @Il mondo di mezzo@
$ENTRY_JOURNAL_INDEX_LEFT_61	4º giorno: @Educazione@
$ENTRY_JOURNAL_INDEX_LEFT_62	4º giorno: @Contabilità@
$ENTRY_JOURNAL_INDEX_LEFT_70	5º giorno: @[ranger_hero]@
$ENTRY_JOURNAL_INDEX_LEFT_80	8º giorno: @Addendum@
$ENTRY_JOURNAL_INDEX_LEFT_90	7º notte: @Il rogo di Karsk@
$ENTRY_JOURNAL_INDEX_LEFT_100	8º giorno: @Laksos@
$ENTRY_JOURNAL_INDEX_LEFT_101	9º giorno: @In marcia@
$ENTRY_JOURNAL_INDEX_LEFT_110	10º giorno: @[mcguffin_hero]@
$ENTRY_JOURNAL_INDEX_LEFT_120	10º giorno: @La morte di Ozimal@
$ENTRY_JOURNAL_INDEX_LEFT_130	10º notte: @Il monastero@
$ENTRY_JOURNAL_INDEX_LEFT_140	11º giorno: @[healer_hero]@
$ENTRY_JOURNAL_INDEX_LEFT_141	11º giorno: @Un manoscritto carcassiano@
$ENTRY_JOURNAL_INDEX_LEFT_150	13º giorno: @[mage_hero]@
$ENTRY_JOURNAL_INDEX_LEFT_160	14º giorno: @I nomadi@
$ENTRY_JOURNAL_INDEX_LEFT_170	15º giorno: @Uno strano sogno@
$ENTRY_JOURNAL_INDEX_LEFT_171	15º notte: @Strane parole@
$ENTRY_JOURNAL_INDEX_RIGHT_01	16º giorno: @Parole terribili su labbra sfregiate@
$ENTRY_JOURNAL_INDEX_RIGHT_00	17º giorno: @Il Gioiello del deserto@
$ENTRY_JOURNAL_INDEX_RIGHT_02	17º notte: @La volpe@
$ENTRY_JOURNAL_INDEX_RIGHT_10	18º giorno: @[knight_hero]@
$ENTRY_JOURNAL_INDEX_RIGHT_20	19º giorno: @Una lettera da [knight_hero]@
$ENTRY_JOURNAL_INDEX_RIGHT_30	19º notte: @La mia risposta: 1º bozza@
$ENTRY_JOURNAL_INDEX_RIGHT_40	20º giorno: @La risposta di [knight_hero]@
$ENTRY_JOURNAL_INDEX_RIGHT_50	21º giorno: @Lettera da <LQ>[knight_hero_up]<RQ>@
$ENTRY_JOURNAL_INDEX_RIGHT_60	21º notte: @C.A.: [berserker_hero]@
$ENTRY_JOURNAL_INDEX_RIGHT_70	22º notte: @[dragon_hero]@
$ENTRY_JOURNAL_INDEX_RIGHT_71	23º giorno: @Il discorso@
$ENTRY_JOURNAL_INDEX_RIGHT_72	24º giorno: @L'assassino@	 
$ENTRY_JOURNAL_INDEX_RIGHT_73	24º giorno: @La morte di una superpecora@
$ENTRY_JOURNAL_INDEX_RIGHT_80	24º giorno: @Addendum@
$ENTRY_JOURNAL_INDEX_RIGHT_81	25º giorno: @Vaneggiamenti@
$ENTRY_JOURNAL_INDEX_RIGHT_90	25º giorno: @Il secondo sogno@
$ENTRY_JOURNAL_INDEX_RIGHT_91	26º giorno: @La storia di [mage_hero]@
$ENTRY_JOURNAL_INDEX_RIGHT_92	27º giorno: @Il male interiore@
$ENTRY_JOURNAL_INDEX_RIGHT_93	27º giorno: @La storia di [knight_hero]@
$ENTRY_JOURNAL_INDEX_RIGHT_100	28º giorno: @La morte dell'uomo vestito di rosso@
$ENTRY_JOURNAL_INDEX_RIGHT_110	29º giorno: @Il terzo sogno@
$ENTRY_JOURNAL_INDEX_RIGHT_117	30º giorno: @Sonno e follia@
$ENTRY_JOURNAL_INDEX_RIGHT_111	32º giorno: @L'Imperatrice@
$ENTRY_JOURNAL_INDEX_RIGHT_112	33º giorno: @Le Toghe Nere@
$ENTRY_JOURNAL_INDEX_RIGHT_113	33º giorno: @Il quarto sogno@
$ENTRY_JOURNAL_INDEX_RIGHT_114	34º giorno: @stai lontano dal mio diario@
$ENTRY_JOURNAL_INDEX_RIGHT_115	34º giorno: @Il quinto sogno@
$ENTRY_JOURNAL_INDEX_RIGHT_116	35º giorno: @Il sesto sogno@
$ENTRY_JOURNAL_INDEX_RIGHT_120	35º giorno: @Il trono di Eztli@
$ENTRY_JOURNAL_INDEX_RIGHT_121	36º giorno: @Evni@
$ENTRY_JOURNAL_INDEX_RIGHT_130	37º giorno: @Tletl-Meztli@
$ENTRY_JOURNAL_INDEX_RIGHT_131	38º giorno: @Pace?@
$ENTRY_JOURNAL_INDEX_RIGHT_132	38º giorno: @Il sogno di commiato@
$ENTRY_JOURNAL_INDEX_RIGHT_140	39º giorno: @La scelta@
$ENTRY_JOURNAL_INDEX_RIGHT_150	40º giorno: @All'inseguimento di Zelemir@
$ENTRY_JOURNAL_INDEX_RIGHT_160	@Epilogo@
$ENTRY_JOURNAL_INDEX_RIGHT_170	@Addendum@
$ENTRY_JOURNAL_INDEX_2_LEFT_10	@<LQ>Armatura a piastre<RQ>@
$ENTRY_JOURNAL_INDEX_2_LEFT_100	@Gedemon Dalavbar, Maestro degli Arcieri@
$ENTRY_JOURNAL_INDEX_2_LEFT_110	@Introduzione@
$ENTRY_JOURNAL_INDEX_2_LEFT_120	@La ricetta del sandwich preferito di James@
$ENTRY_JOURNAL_INDEX_2_LEFT_130	@L'armatura del Capo Carceriere@
$ENTRY_JOURNAL_INDEX_2_LEFT_140	@I baffi di Markos@
$ENTRY_JOURNAL_INDEX_2_LEFT_150	@Il nome di Markos@
$ENTRY_JOURNAL_INDEX_2_LEFT_160	@Il gonnellino di Markos@
$ENTRY_JOURNAL_INDEX_2_LEFT_170	@L'aforisma di Markos ed il libro dei cinque anelli@
$ENTRY_JOURNAL_INDEX_2_LEFT_180	@Ti presento il barbaro: scena tagliata@
$ENTRY_JOURNAL_INDEX_2_LEFT_190	@Lingue e nomi@
$ENTRY_JOURNAL_INDEX_2_LEFT_20	@Una nota sul funzionamento delle dimensioni@
$ENTRY_JOURNAL_INDEX_2_LEFT_200	@Il nome del male@
$ENTRY_JOURNAL_INDEX_2_LEFT_210	@Lo spiritualismo dei nomadi@
$ENTRY_JOURNAL_INDEX_2_LEFT_220	@E questo è tutto@
$ENTRY_JOURNAL_INDEX_2_LEFT_230	@Cicatrici@
$ENTRY_JOURNAL_INDEX_2_LEFT_240	@Slak il bibliotecario@
$ENTRY_JOURNAL_INDEX_2_LEFT_250	@Ispirazioni per la trama@
$ENTRY_JOURNAL_INDEX_2_LEFT_260	@La forza di Wocolan@
$ENTRY_JOURNAL_INDEX_2_LEFT_270	@Le tribù del culto del sangue@
$ENTRY_JOURNAL_INDEX_2_LEFT_280	@Le città stato settentrionali@
$ENTRY_JOURNAL_INDEX_2_LEFT_290	@Il Culto del Fuoco dell'Impero Quaid@
$ENTRY_JOURNAL_INDEX_2_LEFT_30	@Citazioni introduttive dei capitoli@
$ENTRY_JOURNAL_INDEX_2_LEFT_300	@I Selini@
$ENTRY_JOURNAL_INDEX_2_LEFT_310	@Il Tempio di Ash@
$ENTRY_JOURNAL_INDEX_2_LEFT_320	@Le usanze dei monaci guerrieri@
$ENTRY_JOURNAL_INDEX_2_LEFT_330	@Il nome di Zelemir@
$ENTRY_JOURNAL_INDEX_2_LEFT_40	@I barbari e il modo corretto di tenere il fodero della spada@
$ENTRY_JOURNAL_INDEX_2_LEFT_50	@Il boss revenant@
$ENTRY_JOURNAL_INDEX_2_LEFT_60	@La veste del capotribù e l'Albero del Mondo@
$ENTRY_JOURNAL_INDEX_2_LEFT_70	@Personaggi scartati: il paladino e il protettore@
$ENTRY_JOURNAL_INDEX_2_LEFT_80	@L'Occhio della Fiamma@
$ENTRY_JOURNAL_INDEX_2_LEFT_90	@La mano destra di Eztli Tenoch@
$ENTRY_JOURNAL_INTRO_TITLE	
$ENTRY_JOURNAL_INTRO_LEFT_00	1º giorno - Dove sono?
$ENTRY_JOURNAL_INTRO_LEFT_10	Probabilmente sono impazzita, ma nondimeno cercherò di registrare gli eventi che si stanno svolgendo davanti ai miei occhi. I lettori potranno trarre le loro conclusioni; io mi limiterò semplicemente a descrivere gli avvenimenti così come li ha percepiti la mia mente febbricitante.<N><N>So per certo di aver contratto la piaga che sta devastando la nostra splendida capitale. So anche che, come gli altri malati prima di me, sono stata portata fuori città e gettata nella Valle. Da lì si è succeduta una serie di eventi così strani e terrificanti che ancora mi chiedo se non stia sognando.<N><N>Quando mi colse la febbre, mi ritrovai in un luogo oscuro. Dinanzi a me si trovava un'altra vittima.
$ENTRY_JOURNAL_INTRO_RIGHT_00	Là apparse un magnifico trono, e su di esso sedeva un uomo, diverso da chiunque avessi mai visto prima. Sembrava completamente fatto d'oro. Inizialmente pensai che dovesse essere una statua, ma nell'istante successivo lo udii lanciare un ordine.<N>La sua voce era anch'essa dorata, e le sue parole crepitavano con il potere del tuono. Era un linguaggio a me completamente sconosciuto, ma il mio corpo scattò al suo comando. Sentii le mie vene tendersi come se il sangue volesse erompere dal mio corpo e precipitarsi da lui.<N>Al solo pensarci, il cuore riprende a battermi all'impazzata. <N><N>-[mcguffin_hero] Livbar
$ENTRY_JOURNAL_SLAK_TITLE	
$ENTRY_JOURNAL_SLAK_LEFT_0_00	1º notte - [berserker_hero]
$ENTRY_JOURNAL_SLAK_LEFT_0_10	Mentre mi accingo a scrivere di [berserker_hero], mi accorgo di dover abbandonare l'austero linguaggio della capitale, per adottare un vernacolo più consono all'argomento.<N><N> [berserker_hero] è un cretino integrale. È la quintessenza della cretinaggine. Ho conosciuto degli asini più intelligenti di lui.<N><N>Ciò che gli manca sul piano intellettuale, tuttavia, lo compensa con l'odore. Se due cumuli di letame bruciato potessero accoppiarsi e generare dei discendenti, la loro putrida progenie scapperebbe di fronte fetore emanato dalle ascelle di [berserker_hero]. In verità, i cadaveri animati che ci danno la caccia hanno al confronto uno squisito profumo.<N><N>Ma [berserker_hero] è più di un bel faccino. Possiede anche una personalità vincente che io posso solo descrivere come <LQ>completamente fuori di melone<RQ>.<N><N>Ieri ha passato un quarto d'ora a litigare col sasso su cui aveva sbattuto l'alluce. E ha perso.
$ENTRY_JOURNAL_SLAK_RIGHT_0_00	Quanto sono fortunata a viaggiare in sua compagnia. 
$ENTRY_JOURNAL_SLAK_RIGHT_0_10	3º giorno - addendum
$ENTRY_JOURNAL_SLAK_RIGHT_0_20	Ad onor del vero, sono costretta ad ammettere che è anche l'uomo più coraggioso che abbia mai conosciuto. Il suo corpo è una ragnatela di cicatrici, anche se questo non è poi così sorprendente vista la sua riluttanza a coprirsi il torace con un qualunque genere di vestito o armatura. Immagino che alla fine il punto sia questo - è sia un pagliaccio insopportabile che un guerriero incredibilmente capace, e devo ammettere con riluttanza di essere contenta di averlo con me.
$ENTRY_JOURNAL_SLAK_RIGHT_0_30	<N>AWWW TI AMO ANCH'IO! XOXOXO<N><N><N><N><N><N><N><N>IO NON DORMO FACCIO SEMPLICEMENTE FLESSIONI DA SDRAIATO MI RASSODANO I GLUTEI
$ENTRY_JOURNAL_SLAK_RIGHT_0_40	<N>Inoltre, sembra che sia capace di leggere e scrivere! Dove mai sarà stato educato questo vagabondo sanguinario?<N><N>P.S. Se mi rubi di nuovo il diario, ti prenderò a legnate nel sonno.
$ENTRY_JOURNAL_SLAK_LEFT_1_00	3º notte - secondo addendum
$ENTRY_JOURNAL_SLAK_LEFT_1_10	Bene, per la cronaca, [berserker_hero] dorme nudo. Tutti i miei tentativi di vendetta d'ora in poi avverranno durante il giorno.<N>E, sì, le cicatrici non si fermano alla cintola.<N><N><N><N><N>Ti odio.
$ENTRY_JOURNAL_SLAK_LEFT_1_20	<N>PERCHÉ, PENSAVI CHE KHAN E CHARISSA SE NE RESTASSERO IN DISPARTE?
$ENTRY_JOURNAL_PRISON_TITLE	
$ENTRY_JOURNAL_PRISON_LEFT_0_00	3º giorno - In prigione
$ENTRY_JOURNAL_PRISON_LEFT_0_10	Tre giorni fa, pensavo alla Valle come a una prigione.  Ora mi rendo conto che anche all'inferno si può trovare sempre di peggio.<N><N>L'uomo che ci trattiene si chiama Ozimal Kaz.  È un essere crudele, meschino, odioso.  Come abbia fatto un compatriota a diventare così irrimediabilmente contorto va oltre la mia comprensione. <N><N>Me lo sarei aspettata dai quaidiani, che hanno trascorso gli ultimi due decenni a perfezionare la loro crudeltà sulle province orientali.  Anche il più spietato dei capotribù nomadi dominerebbe la sua furia omicida meglio di questo degenerato.<N><N>E viene dalla capitale, a giudicare dal suo accento!  Questo mostro ha vissuto all'ombra del Tempio stesso!
$ENTRY_JOURNAL_PRISON_RIGHT_0_00	Siedo qui con gli altri prigionieri, presi indiscriminatamente: briganti e banditi, uomini, donne, bambini, ashiani, nomadi, quaid, tutti in attesa di morire per mano di quest'uomo.  <N>Giorno e notte udiamo i continui versi dei suoi Revenant, un'assordante cacofonia intervallata solo dai gridi di morte della loro ultima vittima. <N><N>Ed eccomi qua, incapace di fare qualsiasi cosa!  Se solo mi trovassi nel colosseo con quelle sfortunate vittime, almeno potrebbero avere una possibilità di combattere.  <N>Nonostante la sua spavalderia, Ozimal sembra esitare a farmi <LQ>giustiziare<RQ> una seconda volta.  Forse teme di perdere troppi dei suoi revenant - non devono essere facili da catturare e mantenere, ed il suo insignificante impero sembra aver bisogno di loro per mantenere l'ordine fra i suoi vassalli.
$ENTRY_JOURNAL_PRISON_LEFT_1_00	Le parole del mio misterioso complice continuano a risuonarmi nella mente.  Ozimal vuole dare una dimostrazione delle mie abilità ad un <LQ>Uomo vestito di Rosso<RQ>.  Chi è quest'Uomo in Rosso?  E chi è questo misterioso straniero così determinato a salvarmi?  Perchè sono importante?  <N>In questo fiume di domande solo una cosa è certa: fino ad ora ho recato violenza solo a coloro che già erano morti, ma se mai dovessi mettere le mani su Ozimal, questa linea di condotta sarà oggetto di revisione.
$ENTRY_JOURNAL_HALFWAY_WORLD_TITLE	
$ENTRY_JOURNAL_HALFWAY_WORLD_LEFT_0_00	4º giorno - Il Mondo di Mezzo
$ENTRY_JOURNAL_HALFWAY_WORLD_LEFT_0_10	<LQ>Mondo di Mezzo<RQ> è il meglio che le mie inadeguate parole possono fare per descrivere il luogo in cui mi ritrovo - ed in cui posso attirare gli altri.<N><N>Una volta, quand'ero molto piccola, sono quasi annegata mentre nuotavo nelle secche del Kevel.  È l'unica esperienza con cui possa tracciare dei paragoni.  Vi è lo stesso panico, la stessa agonia del non poter respirare mentre il cuore cerca di balzarmi fuori dal petto.  Ma questa volta la mano di mio padre non mi porterà in salvo.  Non c'è riva a cui aggrapparsi, solo il momento della morte teso verso l'eternità.<N><N>La dinamica di come io arrivi in quel luogo va oltre la mia comprensione. So solo che è lì che vado quando ce n'è la necessità.  Una volta là posso percepire i miei compagni, non con la vista, ma allo stesso modo in cui sono coscente delle mie braccia e delle mie gambe senza aver bisogno di guardarle. So semplicemente che si trovano lì e li richiamo con le energie di cui dispongo.  Questa forza è poca, ed esercito questi poteri con la fiacchezza del neonato che sta imparando a muovere il suo corpo, ma è quanto basta per salvarmi la vita. 
$ENTRY_JOURNAL_HALFWAY_WORLD_RIGHT_0_00	Per quanto odi avventurarmi in quel terrificante mondo di mezzo, è certamente meglio del destino che altrimenti mi attenderebbe.
$ENTRY_JOURNAL_KETTA_TITLE	
$ENTRY_JOURNAL_KETTA_LEFT_0_00	5º giorno - [ranger_hero]
$ENTRY_JOURNAL_KETTA_LEFT_0_10	Credo che la cosa che mi piace di più di [ranger_hero] sia che puzza come una capra.<N><N>Voglio dire, è un'ardua scelta considerate tutte le sue altre piacevoli caratteristiche, come un'immaturità sfrenata, i continui commenti denigratori, il suo sarcasmo idiota, la propensione ai piccoli furti, e delle abitudini alimentari orribili, ma quando ci si ritrova a condividere una tenda con qualcuno, è il pungente odore di capra a trionfare su tutto il resto.<N><N>Certe notti la brezza soffia attraverso la zona del campo degli uomini, trasportando tra le sue braccia eteree l'inconfondibile odore di [berserker_hero]. Il risultante miscuglio di aromi può solo essere descritto come ambrosiale. Sono proprio quelle le notti in cui dormo il sonno migliore, come se il mio corpo preferisse rifugiarsi nell'incoscienza piuttosto che tentare di elaborare gli stimoli aromatici che battono con prepotenza alle porte dei sensi.
$ENTRY_JOURNAL_KETTA_RIGHT_0_00	8º giorno - Addendum
$ENTRY_JOURNAL_KETTA_RIGHT_0_10	La scorsa notte [ranger_hero] mi ha svegliato gridando qualcosa in dialetto nomade. All'inizio ho pensato che forse stesse sognando della distruzione di cui siamo appena stati testimoni (immagini che continuano a tormentarmi la mente durante il giorno). Tuttavia, affidandomi alla mia scarsa padronanza del linguaggio nomade, mi sono resa conto che il significato dell'urlo era più o meno <LQ>Lui è mio, donna di dubbia moralità!<RQ> Dopo aver espresso il suo confuso messaggio mi ha poi strappato una ciocca di capelli, l'ha messa sotto il cuscino, ed ha prontamente ripreso a dormire.<N><N>Stamane [ranger_hero] si è mostrata stranamente desolata, arrivando addirittura a spiegarmi come intrecciare crine di cavallo ai capelli per nascondere il punto calvo. Sostiene comunque di non avere idea di che genere di sogno abbia provocato il suo scatto. Io resto scettica.
$ENTRY_JOURNAL_AZRA_BY_SLAK_TITLE	
$ENTRY_JOURNAL_AZRA_BY_SLAK_LEFT_0_00	10º giorno - [mcguffin_hero] è una sfigata!
$ENTRY_JOURNAL_AZRA_BY_SLAK_LEFT_0_10	ALLORA CREDI CHE SOLO PERCHÈ NON RIESCO A CAPIRE IL TUO LINGUAGGIO FORBITRICO VUOL DIRE CHE NON MI ACCORGO CHE STAI SCRIVENDO DI ME?<N>BEH INDOVINA UN PO', PRINCIPESSA? ORA SCRIVIAMO NOI QUALCOSA SU DI TE!<N>CHE DIRE DI [mcguffin_hero_up]? CHE HA LA FACCIA COSÌ STRETTA CHE SEMBRA UN PESCE? E POI HA IL COLLO TROPPO TROPPO TROPPO LUNGO.<N>E LE SUE ORECCHIE SEMBRANO ALBICOCCHE APPASSITE. E HA I CAPELLI BRUTTI E STOPPOSI. E IL SUO IGIENE PERSONALE NON È PERFETTO COME CREDE.
$ENTRY_JOURNAL_AZRA_BY_SLAK_RIGHT_0_00	CHE TE NE PARE, SFIGATA? ORA CREDO DI SAPERE CHI SONO I MIEI VERI AMICI.<N><N>CORDIALMENTE,<N>[ranger_hero_up] A CUI PIACE MANGIARE POPÒ EHI [berserker_hero_up] PERCHÈ CI METTI COSÌ TANTO A SCRIVERE IL MIO NOME?
$ENTRY_JOURNAL_KARSK_BURNED_TITLE	
$ENTRY_JOURNAL_KARSK_BURNED_LEFT_0_00	7º notte - Il rogo di Karsk
$ENTRY_JOURNAL_KARSK_BURNED_LEFT_0_10	Non sono estranea alla morte. Nove mesi di epidemia nella capitale mi hanno spogliata di ogni infantile ignoranza che la mia posizione privilegiata mi aveva concesso sull'argomento. Ma mai avevo assistito a una così violenta distruzione. Anche il ricordo delle pire di cadaveri fuori dai Cancelli del Tempio impallidisce al confronto. <N><N>Sono senza parole.<N><N>Ora capisco qualcosa sulla natura del nostro nemico.
$ENTRY_JOURNAL_LAKSOS_TITLE	
$ENTRY_JOURNAL_LAKSOS_LEFT_0_00	8º giorno - Laksos
$ENTRY_JOURNAL_LAKSOS_LEFT_0_10	Siamo stati testimoni di uno strano rituale nomade mentre eravamo a Laksos. Il capo dei Karada, una piccola ma ben organizzata tribù, ha appena avuto un figlio. I genitori hanno presentato il bambino di fronte a due grandi idoli di legno. <N><N>Il capo ha tirato fuori un piccolo blocco di legno, che ha poi poggiato sulla testa di ciascun idolo e infine su quella del piccolo. Ha poi preso un coltellino ed ha intagliato il blocchetto, lasciando cadere i trucioli sul volto dell'infante. Dopo aver finito il lavoro, ha appeso l'intaglio a dei tendini di animale e l'ha messo al collo del bambino. <N><N>C'è stato un enorme grido, e tutti insieme, gli uomini della tribù hanno cominciato a danzare, cantare e celebrare rumorosamente nella tipica maniera dei nomadi. Non sono riuscita a distinguere che cosa ha intagliato il capotribù.
$ENTRY_JOURNAL_LAKSOS_RIGHT_0_00	Più tardi ho chiesto a [ranger_hero] il significato di quel rituale e lei mi ha mostrato una piccola volpe di legno che tiene appesa al collo. Ha detto che il suo spirito serve gli dei della sua tribù, e che le è stato dato alla nascita come protettore e guida, e per essere seppellito con lei alla morte allo scopo di garantirle un passaggio sicuro per il Paradiso. Proprio come gli dèi tribali sono stati donati dal Creatore alla tribù nel momento della sua fondazione, così gli spiriti guida vengono dati alla nascita a tutti i suoi membri. <N><N>Ho chiesto a [ranger_hero] se per un individuo perdere il proprio idolo personale è catastrofico quanto perdere gli idoli tribali lo è per la tribù. Ha sorriso e mi ha mostrato sette idoli strappati ai nemici, spiegando che ora le loro anime avrebbero impiegato un'eternità a trovare da sole la strada per il paradiso. Le ho chiesto se si sentisse in colpa per aver fatto questo ad altri nomadi e lei mi ha lanciato un'occhiata vacua, mi ha chiesto se per caso io mi sento in colpa ad avere le orecchie troppo grandi, e se n'è andata canticchiando qualcosa a proposito di mangiare lingue di capra. <N><N>Un giorno o l'altro finirò per tirarle in testa una pietra.
$ENTRY_JOURNAL_OZIMAL_DEAD_TITLE	
$ENTRY_JOURNAL_OZIMAL_DEAD_LEFT_0_00	10º giorno - La morte di Ozimal
$ENTRY_JOURNAL_OZIMAL_DEAD_LEFT_0_10	<N>Credevo che avrei ottenuto un po' di soddisfazione dalla morte di Ozimal. Non è stato così.<N><N>Alla fine era solo uno dei tanti strascicanti cadaveri dagli occhi vitrei piegati al volere del nemico, una marionetta anche prima di morire.  Il mondo si è disfatto di un uomo malvagio e crudele.  Qui nella Valle, qualcuno noterà la differenza?
$ENTRY_JOURNAL_MONASTERY_TITLE	
$ENTRY_JOURNAL_MONASTERY_LEFT_0_00	10º notte - Il Monastero
$ENTRY_JOURNAL_MONASTERY_LEFT_0_10	Suppongo sia stato ingenuo da parte mia aspettarmi di trovare nella Valle qualcosa che mi ricordasse casa, ma è stato comunque scioccante vedere il monastero dei Selini costruito quaggiù.  È un'imponente, minacciosa struttura, più fortezza che tempio.  Comprendo la necessità di tali precauzioni, ma è difficile riconciliare tutto questo con il ricordo della Fontana del Tempio con cui sono cresciuta, dove persino le guardie portavano con sè solo armi contundenti, in modo da non seminare scompiglio e distruzione nel luogo dell'armonia.<N><N>Che cosa rassicurante era immergere le mani nella Fontana, sapendo di trovarmi nello stesso luogo in cui sono stati tutti i credenti delle epoche passate, fino a risalire allo stesso Selinadt.  Là io ero un'umile servitrice, separata da re e profeti soltanto dal tempo.<N><N><LQ>Proprio come l'acqua si leva sulla valle come nebbia, cade come neve sulle montagne, scorre nei fiumi fino al mare, così ogni uomo, nato dalla stessa essenza, deve servire
$ENTRY_JOURNAL_MONASTERY_RIGHT_0_00	i diversi ruoli del suo tempo e della sua condizione, per arrivare all'armonia nell'Apparato Celeste.<RQ><N><N>Mi chiedo ora qual'è il ruolo che mi spetta in questo luogo selvaggio e terribile, dove armonia e saggezza sembrano remote fantasie.<N><N>Suppongo ci sia un po' di conforto da trovare in questa fortezza-tempio.  Questi monaci non svolgono forse il loro compito?  Le imponenti mura e le difese militari non sono altro che gli accorgimenti necessari a consentire allo spirito di Selinadt di essere servito anche in questa terra senza legge.<N><N>Proprio come il grande uomo disse una volta, <LQ>La verità rimane la verità, a prescindere dal linguaggio in cui viene scritta<RQ>.  Queste difese altro non sono che il linguaggio della Valle; la verità che proteggono rimane autentica.
$ENTRY_JOURNAL_BAKAL_TITLE	
$ENTRY_JOURNAL_BAKAL_LEFT_0_00	11º giorno - [healer_hero]
$ENTRY_JOURNAL_BAKAL_LEFT_0_10	Il Reverendo [healer_hero] rappresenta un oasi di buon senso in questa terra caotica.  Anche se l'urgenza della fuga lascia poco spazio alla conversazione, le poche fugaci parole che siamo riusciti a scambiare hanno enormemente sollevato il mio spirito.<N><N>Vorrei poter fare lo stesso per lui. C'è una qualche angoscia interiore che lo tormenta.  Posso vederla ribollire, ogni tanto, dietro il suo placido volto di monaco. È evidente che una volta era un soldato: le cicatrici, il portamento e le maniere accennano tutte ad una vita da guerriero.  <N><N>Nel monastero ho scoperto che non fa veramente parte del clero, ma tutti lo chiamano comunque Reverendo Anziano.  In verità, non ricopre nessuna posizione di autorità, o almeno non in veste ufficiale.  E tuttavia i suoi pari cercano regolarmente il suo consiglio e lo seguono come se fosse un loro superiore.  Persino lo stesso Abate sembra essere un suo fedele discepolo.
$ENTRY_JOURNAL_BAKAL_RIGHT_0_00	La corrente avventura sembra sia agitare che ispirare [healer_hero], come se la sua anima fosse in qualche modo in bilico.  Posso capire perchè [ranger_hero] ne sia intimorita.  Ogni tanto scorgo nei suoi occhi una determinazione che rivaleggia con quella del nostro inseguitore.  Spero solo che un giorno [healer_hero] possa trovare per sè la stessa pace che dona agli altri.
$ENTRY_JOURNAL_WRENNA_TITLE	
$ENTRY_JOURNAL_WRENNA_LEFT_0_00	13º giorno - [mage_hero_fu]
$ENTRY_JOURNAL_WRENNA_LEFT_0_10	La descrizione della stirpe reale quaidiana riportata da Polimon non è un'esagerazione. [mage_hero] è davvero <LQ>più pallida della luna e due volte più distante<RQ>. Se mi è permesso aggiungervi il mio parere, scriverei anche <LQ>quattro volte più volubile<RQ>. Non ho mai visto nessuno attraversare così tanti stadi della pazzia con una tale rapidità. Persino [berserker_hero] è più coerente nella sua follia. [mage_hero] è come un oceano in tempesta, un momento appare diabolicamente scaltra ed il prossimo irrimediabilmente ingenua. Spesso le sue azioni danno l'impressione di essere una farsa ben congeniata e tuttavia, proprio quando sono ormai convinta della fondatezza dei miei sospetti, lei viene colta da qualche infantile e pericolosa follia a cui nessuna mente razionale si esporrebbe volontariamente. <N><N>A volte dietro questa follia credo di riuscire a scorgere una ragazza molto simile a me: spaventata, sola, e oberata da un potere terrificante. Mi chiedo se anche lei riesca a vedere questo lato di se stessa.
$ENTRY_JOURNAL_NOMADS_TITLE	
$ENTRY_JOURNAL_NOMADS_LEFT_0_00	14º giorno - I nomadi
$ENTRY_JOURNAL_NOMADS_LEFT_0_10	È stato molto interessante vedere di persona le tribù dei nomadi, la popolazione indigena che occupa le steppe e le montagne tra le città Ashiane e l'Impero Quaid. Oltre un centinaio di diverse tribù furono documentate da Kantimal Polimon nel suo grande viaggio verso oriente, anche se credo che molte di queste siano state estinte dalle devastazioni della guerra. Qui nella Valle ho incontrato membri di ventisette* diverse tribù, quante altre sopravvivano nel mondo esterno è impossibile da dire.<N><N>Come suggerito dal nome, le tribù conducono una vita nomade, allevando nelle steppe capre e cavalli. Ben poco di questo stile di vita si è conservato nella Valle, dove la protezione richiede difese permanenti.
$ENTRY_JOURNAL_NOMADS_LEFT_0_20	*meno della metà sono tribù autosufficienti.
$ENTRY_JOURNAL_NOMADS_RIGHT_0_00	Le tribù meglio organizzate creano villaggi come Karsk, ricavando il necessario per vivere dalla pastorizia e una rudimentale agricoltura. <N><N>I nomadi indipendenti (le cui tribù sono state distrutte o disperse) trovano rifugio negli insediamenti più cosmopoliti come Laksos, o diventano mercenari - trasportando messaggi e proteggendo il commercio tra i villaggi della Valle.
$ENTRY_JOURNAL_DREAM1_TITLE	
$ENTRY_JOURNAL_DREAM1_LEFT_0_00	15º giorno - Uno strano sogno
$ENTRY_JOURNAL_DREAM1_LEFT_0_10	È passato molto tempo dall'ultima volta che ho sognato.  Le terrificanti sensazioni del mondo di mezzo sembrano dominare il mio spirito a tal punto che anche nel sonno non riesco a provare nient'altro che i loro echi.  E tuttavia ieri notte, per la prima volta dalle visioni febbrili della mia malattia, ho sognato.<N><N>È stato un sogno così intenso da liberare la mia mente da tutti gli orrori di cui sono stata testimone.  In verità, tutte le esperienze dei miei 23 anni sembrarono svanire al suo cospetto. <N><N>Mi trovavo in un alto terrazzo.  E non ero me stessa.  Le mie braccia erano scure e cisellate, ricoperte di strani simboli e ornate da bracciali d'oro.  La mia veste era una moltitudine di gioielli, tanto che la ricchezza di un'intera nazione sarebbe bastata appena a costituirne l'orlo.
$ENTRY_JOURNAL_DREAM1_RIGHT_0_00	La luna pendeva bassa in cielo, gigante, d'un rosso intenso.  Avrei potuto allungare il braccio e sfiorarla con la punta delle dita.<N><N>Una voce alle mie spalle mi ha chiamato e mi sono voltata.  C'era un uomo vicino a me sul balcone.  Era alto, l'uomo più alto che avessi mai visto.  I suoi capelli e la sua barba erano scuri come la mezzanotte, lunghi e adornati di anelli d'oro.  In sua presenza il mondo sembrava piccolo e vacuo.<N><N>I suoi occhi dal color dell'onice hanno guardato nei miei, ed allora ho compreso che eravamo una cosa sola. Ho tirato giù la luna di fuoco dividendola fra noi.<N><N>Mi sono svegliata tremando, stringendo la mano al petto come se ancora tenesse quella luna rossa.  Sono stata colta da un così grande senso di perdita che ho pianto.  Nel momento del risveglio avrei fatto qualunque cosa per poter tornare a sognare.
$ENTRY_JOURNAL_DESERT_FORTRESS_TITLE	
$ENTRY_JOURNAL_DESERT_FORTRESS_LEFT_0_00	17º giorno - Il Gioiello del deserto
$ENTRY_JOURNAL_DESERT_FORTRESS_LEFT_0_10	<N>Mi sono spesso chiesta che aspetto avessero le case dei nostri grandi nemici dell'Est. Nella capitale la guerra era come un terrore intangibile, comunicato solo attraverso gli infausti rapporti sulle perdite quotidiane e i lamenti dei numerosi reduci che, rimasti storpi, chiedevano l'elemosina nelle strade. <N><N>Dopo una vita di paure informi, la vista di una vera città Quaid è una strana esperienza. Sono colpita dalla bellezza e l'ingegno delle sue forme, ma più di ogni altra cosa, sono scioccata dalla sua familiarità. <N><N>Vedo tutti i dettagli che segnano la vita di una città: i ciottoli consumati delle strade molto trafficate, il monumento arricchito dal vandalismo di generazioni di giovani, le bancarelle del mercato sistemate come in qualunque altra città.
$ENTRY_JOURNAL_DESERT_FORTRESS_RIGHT_0_00	Non mi è per niente difficile immaginare il mio stesso padre seduto all'angolo della strada, ridendo, bestemmiando e scambiando storie con gli altri anziani della città.<N><N>Eppure, gli abitanti di questo posto sono gli stessi che hanno distrutto Terna e ucciso tutti i suoi abitanti, uomini, donne e bambini.
$ENTRY_JOURNAL_MARKOS_TITLE	
$ENTRY_JOURNAL_MARKOS_LEFT_0_00	18º giorno - [knight_hero]
$ENTRY_JOURNAL_MARKOS_LEFT_0_10	Sono forse così abituata alla compagnia dei pazzi da non riuscire più a credere nella normalità?<N><N>[knight_hero] è educato, intelligente, ben intenzionato, a volte persino divertente - accidenti, tiene addirittura all'igiene personale... ed io continuo ad aspettare di perdere anche l'altra scarpa.<N><N>Ci sarà pure qualcosa che non va in lui!  Qualche vizio, qualche stranezza, qualche irrazionalità.  Se c'è una cosa che ho imparato da tutta questa avventura, è che nella Valle la normalità non esiste.<N><N>Sono i baffi, non è così?  Tiene nascoste tutte le stranezze dietro ai mustacchi.
$ENTRY_JOURNAL_LETTER_MARKOS_1_TITLE	
$ENTRY_JOURNAL_LETTER_MARKOS_1_LEFT_0_00	19º giorno
$ENTRY_JOURNAL_LETTER_MARKOS_1_LEFT_0_10	A Lady [mcguffin_hero] Livbar da [knight_hero_fu] Kashantir, cavaliere della Compagnia di Ash.<N>Signorina, con il massimo rispetto della vostra posizione di comandante del gruppo, vorrei sollevare qualche perplessità sui vostri compagni.  Nello specifico, non posso garantire la vostra sicurezza, ovvero la sicurezza dell'intera spedizione, fino a quando continueremo a viaggiare con [mage_hero_fu] Lan Laxmi.<N>Potreste assicurarmi che lei <LQ>non è così male<RQ> e che la guerra col Quaid è finita, ma vi assicuro che per lei decisamente non è così.  È fanaticamente devota a qualcosa che non esiste più.  Non c'è una gerarchia di comando in grado di tenere a freno la sua follia.  Se [mage_hero_fu] credesse che tagliarci la gola durante il sonno sia necessario per gloria del Quaid, nessuno nella nostra compagnia vedrebbe la prossima alba.
$ENTRY_JOURNAL_LETTER_MARKOS_1_RIGHT_0_00	Vi suggerisco che tagliare ogni legame con lei il più presto e delicatamente possibile.<N>Il vostro umile servitore,<N>[knight_hero_fu] Kashantir
$ENTRY_JOURNAL_LETTER_MARKOS_2_TITLE	
$ENTRY_JOURNAL_LETTER_MARKOS_2_LEFT_0_00	19º notte - Lettera a [knight_hero_fu], bozza n. 1
$ENTRY_JOURNAL_LETTER_MARKOS_2_LEFT_0_10	Caro [knight_hero_fu],<N>In risposta alla vostra lettera, vorrei sollevare tre punti.<N>Primo, perchè mandarmi una lettera, quando sarebbe bastato fare tre metri e parlarmi di persona? C'è qualcosa che non va nel mio igiene personale?  Forse la gente ne parla alle mie spalle?<N>Secondo, ma piantatela di chiamarmi Signorina.<N>Terzo, lasciate in pace [mage_hero] oppure io... non lo so, darò fuoco alle vostre basette o qualcosa del genere.
$ENTRY_JOURNAL_LETTER_MARKOS_2_RIGHT_0_00	P.S. - Stavo solo scherzando sulle basette, non gli darei mai fuoco perchè poi sembrereste strano e dovrei inventarmi un altro soprannome con cui prendervi in giro, e Mr. Magnifistacchio suona già benissimo.  Comunque, tutto quello che intendo dire è che [mage_hero_fu] ha obiettivamente passato dei momenti terribili, quindi perchè non prendersela con qualcuno che se lo merita, come [berserker_hero_up], che sembra credere non mi sia accorta che sta leggendo da sopra la mia spalla anche se è un ebete sbavante che puzza come due mucchi di
$ENTRY_JOURNAL_LETTER_MARKOS_2_RIGHT_0_10	<N>TI AMO [knight_hero_up] VOGLIO SPOSARE I TUOI MUSTACCHI ANCHE SE SEI MOLTO MENO FIGO DI [berserker_hero_up] E PORTI ANCHE LA GONNA HAHAHAHA SPOSIAMOCI!!!!
$ENTRY_JOURNAL_LETTER_MARKOS_3_TITLE	
$ENTRY_JOURNAL_LETTER_MARKOS_3_LEFT_0_00	20º giorno 
$ENTRY_JOURNAL_LETTER_MARKOS_3_LEFT_0_10	Signorina [mcguffin_hero_fu],<N><N>Presumo che non avrei mai dovuto ricevere la vostra ultima lettera, dato che mi è stata consegnata da [berserker_hero_fu], il quale è poi stato immediatamente inseguito da voi stessa fuori dal campo e selvaggiamente picchiato con il mestolo per la zuppa.  <N><N>Tutto questo è per dirvi che vi restituisco la missiva senza averla letta.  Vi prego inoltre di lavare quel mestolo prima di usarlo di nuovo.  Grazie.<N><N>P.S. - Mr. Magnifistacchio?  Seriamente?  Era il meglio che potevate fare?<N><N>-[knight_hero_fu] Kashantir
$ENTRY_JOURNAL_LETTER_MARKOS_SLAK_TITLE	
$ENTRY_JOURNAL_LETTER_MARKOS_SLAK_LEFT_0_00	21º giorno
$ENTRY_JOURNAL_LETTER_MARKOS_SLAK_LEFT_0_10	EHI [mcguffin_hero_up] SONO [knight_hero_up] VOGLIO AVERE I TUOI BAMBINI PERCHÈ SONO UNA DONNA ECCO PERCHÉ CHE INDOSSO UNA GONNA OH E [berserker_hero_up] È TROPPO FIGO<N><N>CORDIALMENTE<N><N>IL VERO [knight_hero_up]
$ENTRY_JOURNAL_LETTER_AZRA_SLAK_TITLE	
$ENTRY_JOURNAL_LETTER_AZRA_SLAK_LEFT_0_00	21º notte 
$ENTRY_JOURNAL_LETTER_AZRA_SLAK_LEFT_0_10	Caro [berserker_hero_fu],<N><N>Se stai leggendo questo messaggio, vuol dire che ti sei ancora una volta intrufolato nella mia tenda per vandalizzare il mio diario e/o fare un'altra delle tue pessime imitazioni.  Bene, stavolta non succederà.  Vedi quell'apertura nella tenda dietro di te?  Indovina cosa c'è lì dietro? <N><N>Ti do un indizio: ha in mano un mestolo e non le sei molto simpatico.
$ENTRY_JOURNAL_LETTER_AZRA_SLAK_LEFT_0_20	HAHA PER UN ATTIMO TI HO QUASI CREDUTO COMUNQUE IL MIO NOME È [knight_hero_up] E AMO INDOSSARE DEI BEI VESTITINI E PQ___
$ENTRY_JOURNAL_NIRU_TITLE	
$ENTRY_JOURNAL_NIRU_LEFT_0_00	22º notte - [dragon_hero]
$ENTRY_JOURNAL_NIRU_LEFT_0_10	Ho sentito parlare molte volte dei draghi. Da bambina erano un'ossessione di mia cugina, che divorava avidamente qualunque leggenda potessi trovare in biblioteca, dagli assiomi scientifici di Polimon ai racconti popolari dei nomadi.  Poi queste storie le rigurgitava a me nella maniera tipica dei bambini: al contrario e alla rinfusa e senza prendere pause per respirare.  Nonostante la qualità delle lezioni, una gran parte di quel materiale si è adagiato nei recessi della mia memoria.  Ora che sono in compagnia di un drago in carne e ossa, i ricordi di quelle lezioni infantili si rifanno vivi prepotentemente.<N><N>Nel corso di questa avventura ho imparato ad aspettarmi di trovare i miei preconcetti completamente inadeguati rispetto alla realtà.  Tuttavia, in questo caso trovo il mio bagaglio di conoscenze perfettamente accurato: [dragon_hero] è una grassa, avida, egoista, presuntuosa lucertola troppo cresciuta, dedicata ad accumulare tesori e alludere alla sua divinità.
$ENTRY_JOURNAL_NIRU_RIGHT_0_00	Una creatura così potente è in effetti un pericolo molto tangibile. Non ha espresso alcuna remora sul voler mangiare alcuni membri del nostro gruppo o uccidere qualunque cosa la irriti, e in generale tratta tutto ciò che ha a che vedere con i <LQ>mortali<RQ> come qualcosa indegno di lei.<N><N>La superbia è spesso il paladino dell'ignoranza.  [dragon_hero] possiede una preziosa <LQ>coppa per draghi<RQ>.  Se non avesse ritenuto la lingua di Ash indegna di lei, saprebbe dall'iscrizione sul lato che l'artifatto in questione è in realtà nientepopodimenoche <LQ>Il Vaso da Notte di Lord Redamal<RQ>.  Ogni volta che mi sento esasperata dalle sue maniere, mi basta pensare al gioioso uso che fa di questo <LQ>calice<RQ>.
$ENTRY_JOURNAL_NIRU_LEFT_1_00	24º notte - Addendum
$ENTRY_JOURNAL_NIRU_LEFT_1_10	A dispetto della sua generale ambivalenza nei confronti di tutto ciò che non la riguarda personalmente, [dragon_hero] è una genitrice notevolmente premurosa.<N><N>Quando la vedo farsi in quattro per il bene della sua covata non riesco a fare a meno di pensare che mi ricorda un po' mia madre.  Uno strano pensiero da rivolgere a un gigantesco mostro che minaccia di immolarti e/o divorarti quasi quotidianamente, ma è quello che ho provato.  <N><N>So che esprimerle una tale simpatia mi farebbe uccidere, ma non posso immaginare la perdita che deve aver provato per i piccoli che i Revenant le hanno strappato via.  Sembra che neanche i più potenti e distaccati fra noi vengano risparmiati da questa immane tragedia del nostro tempo.
$ENTRY_JOURNAL_DREAM2_TITLE	
$ENTRY_JOURNAL_DREAM2_LEFT_0_00	25º giorno - Secondo sogno
$ENTRY_JOURNAL_DREAM2_LEFT_0_10	Il sogno è tornato a me ieri notte.  Era in apparenza diverso, ma sapevo che si trattava dello stesso sogno - o per lo meno che io ero la stessa sognatrice.<N><N>Mi trovavo in una grande sala.  Le sue mura si allungavano sopra di me, torreggiando così in alto che il soffitto era fatto di nuvole.  Ogni parete era d'oro splendente e adornata con meravigliosi gioielli a perdita d'occhio.  Nelle mie mani c'era un calice, intagliato da qualche materiale lucente, scuro come il vino e freddo al tatto.<N><N>Nonostante tutte le meraviglie che mi circondavano, il calice mi era più prezioso d'ogni altra cosa, e lo tenevo in modo da non versare neanche una singola goccia dal suo orlo. All'improvviso la sala si fece buia e una sudicia plebaglia la invase. Mi colpirono mi e maltrattarono, strappandomi il calice dalle mani. Urlai e sfoderai dalla veste una daga affilata, tagliando e colpendo finchè la sala divenne scura come il sangue.
$ENTRY_JOURNAL_DREAM2_RIGHT_0_00	Nonostante le vittime l'orda continuò a incalzare, finchè fui costretta ad abbandonare la sala, finendo in un'anticamera semibuia. Continuai a combattere, ma tutt'intorno a me la marmaglia rispondeva colpo su colpo fino a quando fui infine sconfitta. Caddi a terra e la folla mi travolse, impaziente di strappare gli scintillanti gioielli dalle mura.<N><N>Rimasi lì per lungo tempo, credendo di essere morta. Quando finalmente riuscii a rimettermi in piedi, la sala era vuota. Le mura erano state spaccate e abbattute e tutto era ricoperto di fuliggine e sporcizia. Cercavo, ma il calice non si trovava da nessuna parte. Vagai nella sala per un'eternità, piangendo, ma ero sola. Il calice mi era stato portato via.<N><N>Seduta tra le rovine mi abbandonai alle lacrime.
$ENTRY_JOURNAL_ZELEMIR_DEAD_TITLE	
$ENTRY_JOURNAL_ZELEMIR_DEAD_LEFT_0_00	28º giorno - La morte dell'uomo vestito di rosso
$ENTRY_JOURNAL_ZELEMIR_DEAD_LEFT_0_10	Riesco a ricordare, vagamente, di averlo visto quand'ero una bambina, anche se la mia mente non riesce a conciliare l'immagine di quella fioca memoria con l'uomo che ora giace morto.<N><N>A quel tempo portava i capelli lunghi, secondo lo stile delle Provincie Orientali, e gran parte del suo volto era coperto dalle pesanti bende che gli avvolgevano il capo ed un occhio. In effetti, fu solo grazie alla frettolosa reverenza con cui mia madre mi tirò indietro che capii che lui era diverso da tutti gli altri veterani mutilati che si erano uniti a noi presso la Fontana del Tempio.<N><N>Mi ricordo di come sollevò un altro soldato, costretto alle stampelle, tirandolo per la manica vuota in cui avrebbe dovuto essere il suo braccio, in modo che il giovane potesse abbeverarsi dalla Fontana. Mi ricordo di come rimase lì fermo, molto a lungo, dopo che il ragazzo zoppicò via. Mi ricordo di come la luce scintillò sulle lacrime che scesero dal suo occhio scoperto, attraversarono la sua barba, e caddero nelle pure acque del Tempio.
$ENTRY_JOURNAL_ZELEMIR_DEAD_RIGHT_0_00	Ed ora è morto, per mano mia.<N><N>Diventare una regicida è una sensazione amara.  Era l'unica cosa da fare, continuo a ripetermi, ma ho comunque versato il sangue reale di Ash.  Si era così allontanato dai suoi propositi da mettere a repentaglio l'intero ordine delle cose.  E tuttavia, la sensazione mi perseguita.  È la prima volta che uccido un uomo in carne e ossa.<N>[mage_hero] oscilla dalla gioia alla rabbia, maledicendo il suo nome come se potesse uccidere il defunto ancora una volta.  Suppongo che sia un desiderio non completamente privo di logica, considerate le vicessitudini delle ultime settimane.<N>Ma ciò che mi tormenta di più è il fatto che i Revenant ci danno ancora la caccia.  Il loro creatore e condottiero è morto.  Come può la sua volontà guidarli ancora?<N>Nell'istante in cui formulo la domanda mi rendo conto di conoscerne già la risposta, anche se non vorrei ammetterlo. Non è la sua volontà. Riesco a sentire la differenza. È un'altra mano a guidarli. Ho percepito l'alieno potere di cui ha parlato Zelemir, la malvagità imprigionata dal sacrificio di sangue.  Eztli-Tenoch.
$ENTRY_JOURNAL_DREAM3_TITLE	
$ENTRY_JOURNAL_DREAM3_LEFT_0_00	29º giorno - Il terzo sogno
$ENTRY_JOURNAL_DREAM3_LEFT_0_10	Ieri notte ho sognato ancora.<N><N>Mi trovavo in un luogo desolato.  Davanti a me un gigantesco cristallo si ergeva per un centinaio di piedi verso il cielo.  Stavo piangendo.  Le lacrime scorrevano giù per la mia pelle, attraverso l'oro e gli amuleti, fino a toccare a terra.  Serpeggiarono sulla terra polverosa verso il cristallo e in quel momento mi resi conto che non si trattava di lacrime, ma di rivoli di sangue.  <N><N>Una montagna di cadaveri giaceva ai miei piedi - uomini, donne e bambini.  Le mie mani erano lorde del loro sangue.  Mi girai e vidi un esercito dietro di me, ricoperto, come lo ero io, di sangue.  Attendevano che io parlassi.  <N><N>Alzai le mani verso il cielo gridando con voce di tuono. L'armata si unì al grido.  Era una parola che non avevo mai udito prima, ma ne intuii immediatamente il significato.  La parola era <LQ>sangue<RQ>.  Il grido crebbe fino a far tremare la terra.
$ENTRY_JOURNAL_DREAM3_RIGHT_0_00	
$ENTRY_JOURNAL_THRONE_ROOM_TITLE	
$ENTRY_JOURNAL_THRONE_ROOM_LEFT_0_00	35º giorno - Il trono di Eztli
$ENTRY_JOURNAL_THRONE_ROOM_LEFT_0_10	[berserker_hero] se ne sta spaparanzato sul trono mentre scrivo queste righe.  Il trono di Eztli-Tenoch.<N><N>È un atto che di primo acchito mi ha messo molto a disagio.  Ma perchè dovrebbe?  Che rispetto merita la malvagità?  Quell'uomo dorato non è nient'altro che un bullo avvinghiato alla sua divinità.  C'è qualcosa di profondamente patetico insito in quel genere di malvagità.  Puzza della stessa autosuggestione dei sedicenti uomini di potere.  Basta guardare questo posto: un intero palazzo dedicato alla sua egocentrica immagine.  'Guardatemi', sembra dire, 'io sono l'incarnazione del vero potere'.  Eztli-Tenoch il dio, impotente nella sua gabbia di cristallo.
$ENTRY_JOURNAL_THRONE_ROOM_RIGHT_0_00	<N>E tuttavia, c'è una parte di me che lo capisce.  Una parte di me che ha già camminato in queste sale, che ha conosciuto la divinità.  Ho seduto al suo fianco, giudicando la plebe.  Ho sentito la nostra vocazione divina. Forse è questo sapore, il sapore dei sogni, ad alimentare il mio disprezzo.  Ho visto sia ciò che lui è e sia ciò che crede di essere.
$ENTRY_JOURNAL_ANTIAZRA_TITLE	
$ENTRY_JOURNAL_ANTIAZRA_LEFT_0_00	37º giorno - Tletl-Meztli
$ENTRY_JOURNAL_ANTIAZRA_LEFT_0_10	Non sono riuscita a capire molto, almeno in concreto, di quanto è successo nella camera del tesoro.<N>Mi sono vista morire; o almeno, ho visto morire un'altra me stessa.  Tletl-Meztli, la luna di fuoco.<N>È una sensazione molto strana guardare qualcun altro e dire <LQ>io ero questa persona<RQ>.  Ma è così.  Il potere, la perdita, il castigo.  Ho vissuto, almeno in parte, le cose che l'hanno definita.  Ora ho assistito al sacrificio che l'ha distrutta.
$ENTRY_JOURNAL_ESCAPE_TITLE	
$ENTRY_JOURNAL_ESCAPE_LEFT_0_00	39º giorno - La scelta
$ENTRY_JOURNAL_ESCAPE_LEFT_0_10	Zelemir è tornato.  E porta con sè un'insidiosa offerta: la nostra libertà e la salvezza del mondo.  Il tutto al prezzo di qualche migliaio di vite.  Un'altra goccia nel già ribollente mare di sangue.<N>[dragon_hero] è fuori di sè.  [mage_hero] sta praticamente schiumando dalla bocca.<N><N>Ecco la nostra occasione di fuggire!<N>Ogni scelta è gravida di pericoli: opponendomi a Zelemir rischierei la mia vita, e le vite di tutti coloro che cadranno di fronte a un Eztli-Tenoch di nuovo in libertà.  Metterei a repentaglio il destino del mondo!  Ma acconsentendo al suo piano metterei a repentaglio la mia anima.<N>Vorrei essere morta ad Ash. Preferirei qualunque cosa piuttosto che fare questa scelta.
$ENTRY_JOURNAL_FOLLOWING_ZELEMIR_TITLE	
$ENTRY_JOURNAL_FOLLOWING_ZELEMIR_LEFT_0_00	40º giorno  - All'inseguimento di Zelemir
$ENTRY_JOURNAL_FOLLOWING_ZELEMIR_LEFT_0_10	<N>Non posso più etichettare il piano di Zelemir come una follia.  È razionale, ben congegnato - il lavoro di un maestro stratega che ha risolto una terribile maledizione.<N>Ed è abominevole.<N>Chi cerca di combattere il male assassinando degli innocenti tradisce la sua stessa causa.<N>L'ho già combattuto una volta. E lo farò ogni volta che sarà necessario per proteggere queste persone.  O morirò nel tentativo.
$ENTRY_JOURNAL_EPILOGUE_TITLE	
$ENTRY_JOURNAL_EPILOGUE_LEFT_0_00	Epilogo
$ENTRY_JOURNAL_EPILOGUE_LEFT_0_10	Che strana sensazione è il poter stare ferma e dire <LQ>In questo momento non c'è niente che sta cercando di uccidermi.<RQ><N>Non sono ancora sicura di poterci credere.  Continuo ad aspettarmi di veder piombare una carica di pecore assassine nelle sale della biblioteca.  Per ora non c'è stato altro che un topo, prontamente liquidato con il sempre utile <LQ>Trattato di Polimon sulla Giusta Cura delle Piante<RQ>.<N>[knight_hero] è diventato un frequentatore assiduo della biblioteca.  Lo scorso mese ha voluto vedere praticamente tutti i saggi militari che potessi procurargli, ed una volta esauriti gli argomenti in materia, è passato a praticamente qualunque cosa che potessi tirar giù dagli scaffali.  Mi sembra che l'ultima cosa che ha cercato sia stato un manuale sull'allevamento dei furetti, che potrei giurare abbia scelto totalmente a caso, e poi ha passato il resto della visita a parlare con me invece di leggerlo.  Sapevo che anche lui doveva avere qualcosa di strano.
$ENTRY_JOURNAL_EPILOGUE_RIGHT_0_00	Comunque, è bello avere qualcuno con cui conversare mentre rifornisco gli scaffali.  Così tanti libri sono stati bruciati come combustibile durante la pestilenza, che il contenuto della biblioteca è stato decimato.  Gli scaffali giacevano vuoti in maniera quasi scheletrica quando sono tornata.  <N><N>[knight_hero] ci ha donato alcuni dei suoi libri, acquistati da mercanti nomadi, e ieri ho ricevuto un pacchetto indirizzato <LQ>A [mcguffin_hero_up] AL SUO NOIOSO POSTO DI LAVORO CHE È MOLTO MENO FIGO DEL MIO CHE È UCCIDERE DI TUTTO<RQ><N>All'interno vi erano diversi testi occidentali incredibilmente rari, datati almeno tre secoli or sono, ed una serie di omini stilizzati etichettati <LQ>IO<RQ>, ognuno rozzamente disegnato nell'atto di uccidere varie mostruosità.  Tutto questo verrà conservato per i posteri nella recentemente restaurata Ala Orientale, insieme a queste cronache, non appena le avrò terminate.<N>Mi chiedo spesso come se la stiano cavando i miei vecchi compagni.
$ENTRY_JOURNAL_EPILOGUE_LEFT_1_00	Sono solo passati due mesi, ma so che due mesi corrispondono a diverse centinaia di avventure per qualcuno come [berserker_hero] e [ranger_hero].<N>Non ho saputo molto di [mage_hero], anche se ogni tanto i commercianti nomadi accennano alla <LQ>Pazza Imperatrice delle Rovine,<RQ> che posso solo immaginare significhi che la sua riconquista stia procedendo bene.<N>A volte mi preoccupo per lei - con la scomparsa della piaga e dei Revenant, l'Impero Quaid è diventato un bersaglio invitante per ogni aspirante re-bandito o signore della guerra, per non parlare dei vari Regni del Nord.  Comunque, se c'è qualcuno che può combattere il mondo intero e vincere con il sorriso, quella è proprio [mage_hero].<N>[healer_hero] è ritornato al suo monastero.  Ogni tanto ricevo le sue lettere, che descrivono la lenta trasformazione della Valle.  Commercianti, viaggiatori e pellegrini stanno timidamente iniziando ad avventurarvisi, anche se ci vorrà del tempo prima che la stigmatizzazione
$ENTRY_JOURNAL_EPILOGUE_RIGHT_1_00	del luogo svanisca.  Forse potrei accettare il suo invito a fargli visita durante il prossimo mese.  La città è in via di ricostruzione e questo comporta una frenetica vita metropolitana in cui non mi sento più a mio agio.<N>I miei occhi bramano orizzonti distanti e spazi aperti.  Forse c'è un'avventuriera dentro di me, dopotutto.  Non dubito che [knight_hero] e le sue guardie mi accompagnerebbero, quindi il viaggio non dovrebbe presentare pericoli, e se riuscissi a convincerlo a cantare di nuovo non ci sarà sicuramente da annoiarsi.<N>Credevo che [dragon_hero] avesse permanentemente abbandonato il mondo dei <LQ>mortali,<RQ> ma non ne sono più così certa.  La scorsa settimana una pila di libri rilegati in oro è stata lasciata in cima al tetto della Libreria.  Ci vorrebbe uno scalatore davvero formidabile per portare un peso del genere a così grande altezza. Preferisco pensare che il nostro misterioso benefattore sia dotato del dono del volo, il che significa che una certa sedicente dea ha trovato un compagno per allevare i suoi piccoli.
$ENTRY_JOURNAL_EPILOGUE_LEFT_2_00	È un bel pensiero, e me lo terrò stretto.<N>È strano parlare con la gente estranea al nostro piccolo gruppo.  Le poche persone con cui ho iniziato a confidarmi hanno liquidato le mie parole, oppure hanno già sentito fin troppi degli esageratissimi racconti degli altri sopravvissuti.  <N>Questa mattina in strada sono stata fermata da due bambini che mi hanno supplicato di squagliare la faccia al bullo che gli stava dando fastidio.  Ancora con questa storia.  Un'occhiataccia è stata più che sufficiente per spedirlo a casa per un urgente cambio di biancheria, il che tra il mio pubblico ha riscosso molto più successo di quanto lo squagliamento della sua faccia avrebbe mai potuto fare.  Altri passanti mi hanno chiesto invece di curare loro le verruche, benedire i loro asini, lanciare il malocchio ai vicini fastidiosi, eccetera eccetera.<N>Forse è per questo che sono così felice di vedere [knight_hero] visitare la Biblioteca.
$ENTRY_JOURNAL_EPILOGUE_RIGHT_2_00	Non parliamo mai delle nostre passate avventure, ma abbiamo una mutua comprensione, una familiarità che non potrò mai condividere con chi non è stato mai parte della nostra compagnia.<N>Mi chiedo, riusciremo mai a rivederci tutti ancora una volta?<N>-[mcguffin_hero] Yalkie Livbar
$ENTRY_JOURNAL_EPILOGUE_RIGHT_2_10	MI CHIEDO SE IMPARERAI MAI A TENERE QUESTO DIARIO IN UN NASCONDIGLIO MIGLIORE HAHA PROBABILMENTE NO PERCHÉ SONO TROPPO FIGO E COMUNQUE IO SONO [knight_hero_up] E NON SONO FIGO PER NIENTE E MI PIACE METTERE DEI BEI FIORELLINI FRA I CAPELLI E BALLARE AGITANDO LA MIA GONNA VIOLA MENTRE CANTO LALALALALA<N>MA SERIAMENTE CON [knight_hero_up] MA TI DEVO SPIEGARE TUTTO?  STAI VERAME-
$ENTRY_JOURNAL_EPILOGUE_RIGHT_2_20	Ho conservato il mestolo.
$ENTRY_JOURNAL2_ACTQUOTES_LEFT_00	Introduzioni dei capitoli
$ENTRY_JOURNAL2_ACTQUOTES_LEFT_10	Una delle cose che più mi è piaciuto scrivere sono le piccole citazioni che introducono ogni capitolo della storia. Mi hanno davvero permesso di giocare con diversi punti di vista e dare ai giocatori piccoli scorci del più ampio mondo in cui è ambientata la storia. Giunto al momento di iniziare il capitolo sette mi sono venute in mente ben tre frasi diverse fra cui ho poi scelto la mia preferita per inserirla nel gioco. Ecco le due che non sono state incluse:<N><N><LQ>Messo davanti a una decisione, l'uomo egoista immagina una miriade di risultati, soppesando le opzioni che più gli gioveranno.  Il vero uomo pensa solo a ciò che gioverà alla Fiamma.<RQ><N>- Dal Libro delle Sette Massime sulla Via della Spada<N><N><LQ>Guardando i volti dei nostri mercenari nordici vi trovo la disperazione dell'uomo che ha scommesso e perso.  Tutti noi moriremo, ma io morirò per la mia patria, la mia famiglia, per il Re e per il Tempio.  Loro invece moriranno per una manciata d'oro.<RQ><N>- Soldato anonimo, assedio del passo di Karedon
$ENTRY_JOURNAL2_ACTQUOTES_LEFT_1_00	è stata presa da Thief: The Dark Projekt, uno dei miei giochi preferiti di tutti i tempi. Non credo ad aver mai giocato a nient'altro con un'ambientazione così riccamente dettagliata, piena di sfaccettature e di una bellezza così evocativa. Il maestro ladro Garrett scivola silenziosamente tra le ombre della città tra rumorose macchine industriali ed orrori occulti, passando inosservato fra le belligeranti fazioni di magia e ragione in un'immagine che mi accompagnerà per sempre. A volte mi viene da piangere quando ci penso. Anche se quello potrebbe avere più a che fare con tutta la vernice che ho mangiato da bambino...
$ENTRY_JOURNAL2_ACTQUOTES_RIGHT_0_00	Quella che è stata inclusa nel gioco è la seguente:<N><N><LQ>Si dice che l'uomo abbia paura della morte. Nella mia esperienza ciò che l'uomo teme davvero è l'incertezza della morte. Nel mezzo di quell'ordalia, quando la morte era ormai certa, fui assalito da un'imperturbabile calma, una sensazione mai provata né prima né dopo. Solo quando apparve la speranza di poter sopravvivere sentii la vera morsa del terrore.<RQ><N>- dalle Memorie di Gedemon Dalavbar, Maestro degli Arcieri, Storia delle sue Imprese e Avventure al Servizio del Re di Ash<N><N>Questa frase fu profondamente ispirata da un passagio di "Shadow of the Torturer" di Gene Wolfe, che iniziai a leggere al termine del mio lavoro su Defender's Quest (non mi resi conto di quest'ispirazione se non molto tempo dopo aver finito di scrivere il pezzo). È un libro incredibilmente strano, spesso inquietante, che non raccomanderei ai lettori più giovani. Tuttavia, per un pubblico maturo interessato ad avventurarsi in luoghi nuovi e alieni, il libro cattura col suo mondo e i suoi valori un senso di diversità che raramente si trova nella letteratura moderna.<N><N>A proposito di ispirazione, l'idea di aprire ogni atto con una citazione
$ENTRY_JOURNAL2_ACTQUOTES_RIGHT_1_00	 
$ENTRY_JOURNAL2_ACTQUOTES_TITLE	 
$ENTRY_JOURNAL2_ASHTEMPLE_LEFT_00	Il Tempio di Ash
$ENTRY_JOURNAL2_ASHTEMPLE_LEFT_10	Il Tempio di Ash è una filosofia religiosa monoteistica monarchica, basata sui principi di comunità ed equilibrio. Vede il mondo come un gigantesco marchingegno, funzionante grazie alla spinta dell'Immobile Motore, il creatore che mette ogni cosa in movimento. Il ruolo dell'individuo è di espletare la sua funzione di ingranaggio del grande marchingegno, essendo in equilibrio col loro posto nel mondo. Il male, o squilibrio, è visto come il fallimento di adempiere a ciò. (Questo posto nel mondo è dettato dalla struttura sociale – grande enfasi è posta sulle catene di comando, o catene dell'essere). Il centro della religione è l'Alto Tempio, che una volta fu la scuola del filosofo fondatore. L'acqua è elemento chiave nei rituali del Tempio, essendo il ciclo dell'acqua un perfetto esempio di un elemento in equilibrio con il suo ruolo nella grande macchina. Dopo la morte, coloro che hanno adempiuto il loro scopo nella Macchina Terrena vengono raccolti dall'Immobile Motore e resi parte della Macchina Celeste, la versione perfetta del mondo terreno.<N>Il Tempio di Ash fu fondato da Selinadt, un filosofo esiliato da una delle lontane
$ENTRY_JOURNAL2_ASHTEMPLE_LEFT_1_00	 
$ENTRY_JOURNAL2_ASHTEMPLE_RIGHT_0_00	città stato indipendenti del nord. Bandito dalla sua terra d'origine attraverso le macchinazioni dei suoi rivali politici, Selinadt vagò verso sud, offrendo i suoi servizi di consigliere a vari regnanti locali. Il re di Ash lo accolse dopo che ebbe sconfitto i suoi stessi saggi in una gara di indovinelli. La filosofia religiosa di Selinadt, in seguito alla conversione del re di Ash, divenne estremamente popolare nella regione.<N><N>Dato che il re fu il primo discepolo, ognuno dei suoi successorì è considerato il custode del Tempio. La religione viene praticata fra i piccoli regni confinanti, ma l'Alto Tempio di Ash ne rimane il centro. Per questo motivo, Ash viene visto come totalmente neutrale nelle guerre che scoppiano tra i suoi vicini. Nelle rare occasioni in cui un regno confinante si è azzardato a minacciarlo, gli altri si sono coalizzati contro l'aggressore per difendere il Tempio. Questa neutralità ha consentito ad Ash di crescere come un robusto centro di scambi e commerci, accrescendo enormemente il suo potere e la sua influenza. Con la minaccia dell'Impero Quaid, i regni confinanti con Ash si sono uniti in quella che in pratica risulta essere una federazione, facendo di Ash un impero tangibile, anche se diviso.
$ENTRY_JOURNAL2_ASHTEMPLE_RIGHT_1_00	 
$ENTRY_JOURNAL2_ASHTEMPLE_TITLE	 
$ENTRY_JOURNAL2_BERSERKERS_LEFT_00	I barbari e il modo corretto di tenere il fodero della spada
$ENTRY_JOURNAL2_BERSERKERS_LEFT_10	Ragazzi, è davvero figo il modo in cui un letale spadaccino tiene la sua magnifica spada dietro la schiena piuttosto che al fianco come fanno le persone normali! Talmente figo, in effetti, che originariamente avevo visualizzato l'aspetto dei barbari proprio in questo modo. Fortunatamente, la personificazione della mia ossessione nevrotica per l'accuratezza storica si è materializzata davanti a me, mi ha schiaffeggiato con un autentico guanto in maglia ad anelli, e mi ha fatto notare che tenere la spada dietro la schiena è la cosa più stupida che si possa fare.<N><N><LQ>M-ma c'è Link! E Geralt! E i ninja!<RQ> ho protestato.<N><N> Al che, lo spirito dell'ossessione per l'accuratezza storica ha risposto:<N><N><LQ>La schiena è un buon posto per tenere le cose che hai intenzione di portarti appresso. Uno zaino, ad esempio.<N>Ma se vuoi essere in grado di sfoderare un'arma scoprirai che è impossibile farlo da dietro la schiena. Avanti, provaci. Sfilare un oggetto di qualunque lunghezza
$ENTRY_JOURNAL2_BERSERKERS_LEFT_1_00	fascino di sfoderare le spade da dietro la schiena che ha progettato dei foderi speciali che esistono soltanto per questo scopo. Hanno questo strano genere di mezzo fodero e sembrano stupidi e sono stupidi e soltanto gli stupidi le usano e comunque sono molto più scomodi di un fodero normale (molti mettono anche all'estremità un grande anello di metallo, così si ottiene quel suono di metallo contro metallo... sì, perchè ora c'è un anello gigante di metallo che sta smussando la lama).<N><N>Ma comunque, il punto è che c'è gente così ossessionata da quanto <LQ>ganzo<RQ> è sfoderare la spada dalla schiena anche se mai e poi mai - nemmeno progettando un qualche genere di super fodero proprio per questa specifica ragione - sarà funzionale come lo sfoderarla dal fianco come una persona normale.<N><N>Fortunatamente ho rettificato il mio grave errore, ed ora tutti i nostri barbari godono di un fodero in posizione corretta e fisiologicamente ragionevole. Dopodichè ho trascorso due ore su YouTube a guardare video tedeschi di duelli con la spada e piangere per i miei peccati.
$ENTRY_JOURNAL2_BERSERKERS_RIGHT_0_00	dal fodero è un'impresa erculea.<RQ> (Un imperatore romano di cui al momento sono troppo pigro per controllarne il nome - Adriano, mi pare? - si è effettivamente vantato in uno dei suoi scritti di come Londra fosse una città così soggiogata che le sue truppe potevano marciare per le strade con le armi dietro schiena. Questo perchè... se dovessi correre il rischio di venire attaccato... vorrai tenere le armi dove è effettivamente possibile raggiungerle.)<N><N> La prossima volta che vedete un film dove c'è un figaccio che tiene la spada (o ancora meglio, due spade) dietro la schiena, fate attenzione a quando la sfodera. Noterete che la scena viene convenientemente tagliata - lui estrarrà qualche centimetro (con il classico suono squillante di metallo contro metallo che in realtà sarebbe possibile solo se qualcosa stesse graffiando di brutto la lama) e magicamente la scena passa al tizio con la spada già completamente sfoderata. Questo perchè la parte che viene tagliata è anatomicamente impossibile – non si può sfoderare da dietro la schiena qualcosa di più lungo del proprio braccio. Almeno non senza slogarsi qualcosa.<N><N>Ora, c'è gente così ossessionata dal
$ENTRY_JOURNAL2_BERSERKERS_RIGHT_1_00	PS: Nei giochi 3D in cui i personaggi portano le spade dietro la schiena, noterete che la lama passa magicamente attraverso il fodero invece di venire estratta dall'imboccatura.<N><N>PPS: alcune sciabole militari del periodo napoleonico e vittoriano hanno un fodero di metallo con una molla all'imboccatura che preme sulla lama per tenerla fermamente al suo posto, così quando vengono sfoderate fanno davvero quel rumore di metallo sfregato che piace così tanto ai film. La molla provoca anche l'usura della lama, quindi le sciabole di quell'epoca ancora esistenti sono molto spesso rovinate nel punto in cui vi sfregavano contro ogni benedetta volta che venivano sfoderate. Quindi sì, quel bel suono scintillante viene da qualcosa, ma è molto limitato ed è comunque dannoso per la lama a lungo andare. Ora, se volete scusarmi, dovrei andare a fustigarmi mentre leggo dei manuali di combattimento con spada e scudo.
$ENTRY_JOURNAL2_BERSERKERS_TITLE	 
$ENTRY_JOURNAL2_BLOODMAD_LEFT_00	Le tribù del Culto del Sangue
$ENTRY_JOURNAL2_BLOODMAD_LEFT_10	I nomadi sono in realtà i superstiti di un'antica civiltà che una volta faceva parte del dominio di Eztli-Tenoch.  Quando Eztli-Tenoch fu sconfitto molti di loro si dispersero, diventando il popolo nomade, tribale e politeistico che conosciamo.  Ma alcuni di loro rimasero fedeli al loro <LQ>dio<RQ> sconfitto, e sotto la guida della loro misteriosa regina, si trasformarono in un culto sciamanistico della morte dedicato alla liberazione di Eztli-Tenoch dalla sua prigionia.  Queste tribù occuparono le aree circostanti la prigione di Eztli e si dedicarono a infrangere il sigillo di sangue nell'unico modo che conoscevano: uccidendo chiunque gli capitasse fra le mani e dipingendo la Grande Pietra con il loro sangue, sperando un giorno di trovare finalmente le persone giuste.  La gente imparò molto presto a evitare quelle zone, e così i Cultisti del Sangue si espansero, spingendosi infine nel territorio dell'Impero Quaid.  Ovviamente, lasciare che sul proprio territorio i viaggiatori vengano massacrati in sacrifici rituali non giova agli affari, nè tantomeno alla gloria della Fiamma Cosmica, e quindi l'Impero Quaid lanciò diverse guerre di eradicazione contro questi culti (Wrenna ne fa riferimento durante il gioco).
$ENTRY_JOURNAL2_BLOODMAD_LEFT_1_00	in grado di riconoscere i cultisti.<N><N>Un applauso a Lars per aver avuto l'idea di far avvelenare Ozimal da Zelemir.  Senza di lui le tribù del culto del sangue non mi sarebbero mai venute in mente. (In origine, Ozimal avrebbe dovuto trasformarsi in revenant dopo essere stato brutalmente assassinato da Zelemir, ma al mio bagno di sangue tarantinesco è stato posto un veto, in favore dell'avvelenamento dietro le quinte. A proposito, anche la <LQ>Guardia con la benda sull'occhio<RQ>, che ha inspiegabilmente guadagnato un piccolo fan club, doveva morire nella battaglia.)<N>
$ENTRY_JOURNAL2_BLOODMAD_RIGHT_0_00	I cultisti vennero dispersi ma non completamente sconfitti. Con la scomparsa della loro Regina, secoli prima, i culti iniziarono a dimenticare molte delle ragioni dietro ai loro complicati rituali. Gran parte dei culti del sangue non gravitavano più attorno alla stessa Grande Pietra, adorando invece delle sue piccole riproduzioni.  Tuttavia, con la parziale liberazione di Eztli Tenoch dalla sua prigione, egli si mise in contatto con i suoi figli perduti. Gli sciamani dei vari culti del sangue hanno udito la sua chiamata, e stanno guidando nuovamente la loro gente verso la Valle, verso la Grande Pietra, prigione del loro dio.<N><N>I cultisti continuano a utilizzare veleno nella loro dieta (lo stesso veleno utilizzato da Zelemir su Ozimal) e la folle credenza di essere pervasi dallo spirito del loro signore. Questo veleno gli consente di trasformarsi in revenant a seconda della necessità. (La "Mano Destra di Eztli-Tenoch" è uno sciamano, o forse un gruppo di sciamani, disposto a sacrificarsi per diventare uno strumento orribilmente contorto del volere di Etzil).<N><N>La tribù di Ketta, chiamata Geka, fu massacrata dai cultisti del sangue quand'era poco più che adolescente, ed è per questo che lei ha pochi legami tribali ed è stata
$ENTRY_JOURNAL2_BLOODMAD_RIGHT_1_00	 
$ENTRY_JOURNAL2_BLOODMAD_TITLE	 
$ENTRY_JOURNAL2_BOSSREVENANT_LEFT_00	Il boss revenant
$ENTRY_JOURNAL2_BOSSREVENANT_LEFT_10	Per chi di voi volesse saperne di più sul boss revenant, ecco una spiegazione tratta dai nostri documenti di progettazione:<N><N>Alcuni revenant possono essere più potenti di altri, a seconda di quanta concentrazione spirituale viene esercitata dal mago su di essi. Inoltre, alcuni <LQ>gusci<RQ> sono più conduttivi di altri. Per esempio, un potente negromante potrebbe occupare il corpo di uno scoiattolo. E anche se un esercito di scoiattoli zombi sarebbe decisamente divertente, gli scoiattoli non hanno la stessa profondità spirituale degli umani – la loro presenza nel regno delle ombre è più debole. In pratica, più è grande il vuoto lasciato da un'anima e più spazio avrà a disposizione uno stregone per riempirlo con il suo spirito (idealmente all'istante della morte – man mano che il corpo si decompone lo stesso accade alle sue dimensioni spirituali, quindi più il tempo passa e più diminuiscono le sue potenzialità). Il discorso vale anche per le persone. Non tutte offrono lo stesso margine d'azione allo stregone. Gli involucri più deboli possono solo assorbire una piccola quantità di spirito, e non gli consentiranno di svolgere azioni che richiedono più energia
$ENTRY_JOURNAL2_BOSSREVENANT_LEFT_1_00	 
$ENTRY_JOURNAL2_BOSSREVENANT_RIGHT_0_00	di quel che possono contenere. D'altro canto, alcune persone hanno una profondità spirituale notevolmente maggiore, consentendogli molta più libertà d'azione – più nuovo è il corpo e più ampio sarà il vuoto spirituale da riempire.
$ENTRY_JOURNAL2_BOSSREVENANT_RIGHT_1_00	 
$ENTRY_JOURNAL2_BOSSREVENANT_TITLE	 
$ENTRY_JOURNAL2_CHIEFTANSTUNIC_LEFT_00	La veste del capotribù e l'Albero del Mondo
$ENTRY_JOURNAL2_CHIEFTANSTUNIC_LEFT_10	Le tortuose radici dell'Albero del Mondo che adornano la veste del capotribù erano parte dei miei svariati tentativi di accennare alle culture e tradizioni delle varie fazioni, in questo caso i nomadi.<N><N>Molte culture del mondo reale possiedono il concetto di un Albero del Mondo, ma ciò che mi ha ispirato in particolare è stato un pezzo molto strano di folklore greco che avevo letto, che parlava di alcuni demonietti balcanici chiamati Kallikantzaroi. I Kallikantzaroi trascorrono l'intero anno sottoterra a segare le radici dell'Albero del Mondo, sperando di provocarne il collasso (e di conseguenza quello del mondo intero). I Kallikantzaroi sono quel genere di carogne, a quanto pare. Comunque, l'unica occasione in cui non cercano di distruggere il mondo è a Natale, che capita proprio quando stanno per completare l'opera. A partire da Natale tornano in superficie dove vanno in giro a urinare nella birra della gente, rubare caramelle ai bambini, buttarvi lo spazzolino nel water, e più in generale a comportarsi da imbecilli di primo livello. Il divertimento termina il giorno dell'Epifania,
$ENTRY_JOURNAL2_CHIEFTANSTUNIC_LEFT_1_00	 
$ENTRY_JOURNAL2_CHIEFTANSTUNIC_RIGHT_0_00	quando vengono nuovamente esiliati sottoterra. A quel punto si accorgono che lo scherzo gli si è ritorto contro, dato che l'Albero del Mondo ha fatto in tempo a rigenerarsi completamente. Questo accade puntualmente ogni anno, dato che i Kallikantzaroi non sono solo degli imbecilli, sono degli imbecilli incredibilmente stupidi.(Mi piace immaginare che l'Albero del Mondo sia andato a pisciargli nella birra mentre erano via.)<N><N>Oh, e se volete proteggere dai Kallikantzaroi la vostra birra, le caramelle e gli spazzolini, tutto ciò che dovete fare è mettere uno scolapasta all'ingresso di casa. I Kallikantzaroi sanno solo contare fino a due – dato che il tre, essendo il numero della Trinità, è un numero sacro, e un Kallikantzaroi morirebbe istantaneamente se lo pronunciasse a voce alta. Quindi se lasciate un colapasta davanti alla porta, quei teppistelli dei Kallikantzaroi staranno svegli tutta la notte cercando di contarne tutti i buchi e perdendo sempre il conto dopo il numero due. Dopo di che vi alzate la mattina, tirate fuori la vostra fida 45 Magnum, sparate a quegli sciocchi tragicamente ossessionati dalla matematica nel loro collettivo deretano, buttate i corpi nella monnezza, e vi godete la vostra birra senza urina per il resto del periodo festivo. O almeno, questo è quello che farei io.
$ENTRY_JOURNAL2_CHIEFTANSTUNIC_RIGHT_1_00	 
$ENTRY_JOURNAL2_CHIEFTANSTUNIC_TITLE	 
$ENTRY_JOURNAL2_CITYSTATES_LEFT_00	Le città-stato del nord
$ENTRY_JOURNAL2_CITYSTATES_LEFT_10	Mentre lavoravo su tutte queste nuove aggiunte alla trama per il lancio della versione HD mi sono imbattuto in un vecchio blocco per gli appunti. A quanto pare, a un certo punto in passato avevo deciso che i popoli delle città-stato settentrionali a cui il gioco fa riferimento ogni tanto fossero chiamati i Carcassiani. Ho pensato che il nome suonasse bene, quindi sono tornato al lavoro e ho iniziato a inserirlo in diversi punti. Entusiasmato da come questo vecchio taccuino sembrasse una sorta di portale magico verso un mondo in cui avrei dovuto lavorare di meno, ho continuato a leggere. A quanto sembra, il mago del ghiaccio era un tipo chiamato Laz che faceva l'orologiaio. Inoltre, l'ultima pagina è una lista delle cose da fare che dice:<N><N>1. Pulire il garage<N>2. Chiamare l'idraulico per il rubinetto che perde<N>3. Vincere lotteria, sposare principessa/supermodella finlandese, traslocare in isola caraibica privata, costruire castello, fare 2.5 figli<N><N>Se ve lo state chiedendo, sì, il garage è ancora un casino.
$ENTRY_JOURNAL2_CITYSTATES_LEFT_1_00	 
$ENTRY_JOURNAL2_CITYSTATES_RIGHT_0_00	 
$ENTRY_JOURNAL2_CITYSTATES_RIGHT_1_00	 
$ENTRY_JOURNAL2_CITYSTATES_TITLE	 
$ENTRY_JOURNAL2_CUTCHARS_LEFT_00	Personaggi scartati: il paladino e il protettore
$ENTRY_JOURNAL2_CUTCHARS_LEFT_10	In principio progettavamo di avere un cast di personaggi ancora più esteso, ma abbiamo dovuto abbandonarne qualcuno per mantenere le cose a un livello un po' più gestibile. Tra quelli finiti sul patibolo ci sono il paladino ed il protettore.<N><N>Il protettore doveva essere un'unità di tipo <LQ>tank<RQ>, dotato di un enorme scudo ed estremamente finalizzato alla difesa. La sua peculiarità era l'essere in grado di proteggere non solo se stesso, ma anche agli alleati attorno a lui. Quando un personaggio nelle vicinanze sarebbe stato normalmente colpito da un attacco, il protettore sarebbe intervenuto, bloccando il colpo con il suo scudo. Per quel che riguarda la loro storia, se ricordo bene, i protettori facevano parte di un fanatico corpo militare d'elite ashiano che credeva di essere moralmente obbligato a difendere qualunque territorio in cui uno dei suoi membri avesse versato sangue. Alcune caratteristiche del protettore sono state riprese da Markos il cavaliere, anche se il suo marcato fanatismo <LQ>Per il nostro sangue! Il sangue dei patrioti!<RQ> è stato scartato.
$ENTRY_JOURNAL2_CUTCHARS_LEFT_1_00	 
$ENTRY_JOURNAL2_CUTCHARS_RIGHT_0_00	Anche il paladino, che è stato a sua volta eliminato, aveva molte similitudini con il cavaliere. Per la verità questa è la classe di cui originariamente avrebbe dovuto far parte Wrenna – la <LQ>fanatica e bellicosa principessa nemica diventata riluttante alleata<RQ> sembrava calzare a pennello per un personaggio munito di spada. Quando alla fine la classe venne scartata, decisi che il personaggio della principessa nemica era troppo buono per non essere utilizzato in qualche modo, e così è nata la maga del ghiaccio che tutti conosciamo e amiamo.<N><N> Restando sul tema di classi che sono poi state modificate, i draghi dovevano essere originariamente "cavalieri del drago". Quest'unità assurdamente potente era essenzialmente un drago con un arciere montato in sella. Per come stanno le cose, gli arcieri sono già una delle classi più sbilanciate del gioco, e quindi i cavalieri dragoni vennero retrocessi a dei semplici cari vecchi draghi. Ritengo che Niru lo abbia apprezzato.
$ENTRY_JOURNAL2_CUTCHARS_RIGHT_1_00	 
$ENTRY_JOURNAL2_CUTCHARS_TITLE	 
$ENTRY_JOURNAL2_DIMENSIONS_LEFT_00	Nota sulle dimensioni 
$ENTRY_JOURNAL2_DIMENSIONS_LEFT_10	Per chi di voi è interessato alla natura del <LQ>mondo di mezzo,<RQ> ecco una descrizione di come funzionano le dimensioni tratta dai nostri appunti:<N><N>La realtà è costituita da molti strati diversi. Ciò che percepiamo è la combinazione di una piccola parte di ciascuna <LQ>dimensione<RQ> o <LQ>regno.<RQ> Colore, gusto, tatto, olfatto, ecc. sono tutti dei piccoli scorci verso la loro dimensione. Soltanto la punta dell'iceberg si interseca col mondo. Ma concentrandosi intensamente, un individuo può separare questi strati e sperimentare una dimensione nella sua totalità. Il <LQ>regno<RQ> con cui avremo più a che fare è quello che i personaggi chiamano il regno delle <LQ>ombre<RQ>. Il regno delle ombre è la dimensione dello spirito – qualcosa di simile all'ideale platonico, ma per ogni oggetto esistente. Ogni essere vivente è animato da un'invisibile forza che noi percepiamo a malapena, ma che nel regno delle ombre può essere sperimentata appieno e vi si può interagire. Come spiega il guaritore:
$ENTRY_JOURNAL2_DIMENSIONS_LEFT_1_00	 
$ENTRY_JOURNAL2_DIMENSIONS_RIGHT_0_00	GUARITORE: Ognuno dei nostri sensi ci dà soltanto una vaga idea di ciò che esiste realmente.<N><N>PROTAGONISTA: Capisco.<N><N>GUARITORE: La realtà è composta di strati –<N><N>BARBARO: Come una torta?<N><N>GUARITORE: ... Si... come una torta. Questi strati costituiscono il mondo che noi sperimentiamo –<N><N>BARBARO: Che genere di torta?<N><N>PROTAGONISTA: Una torta alla realtà, ora fai silenzio!<N><N>BARBARO: Mmmm... torta alla realtà.<N><N>
$ENTRY_JOURNAL2_DIMENSIONS_RIGHT_1_00	 
$ENTRY_JOURNAL2_DIMENSIONS_TITLE	 
$ENTRY_JOURNAL2_EYEOFFLAME_LEFT_00	L'Occhio della Fiamma
$ENTRY_JOURNAL2_EYEOFFLAME_LEFT_10	La descrizione di quest'oggetto è stata ispirata dal poema anglosassone <LQ>The Ruin,<RQ> un opera elegiaca che riflette sulle rorvine di una città romana distrutta da lungo tempo. Il poema si trova in un solo manoscritto, così severamente danneggiato che la fine del poema termina con frasi e parole sconnesse. Una delle ultime parti comprensibili del testo si traduce in <LQ>è una cosa regale...<RQ><N><N>Se non l'avete mai letto vi consiglio caldamente di procurarvi una copia, passare una decina d'anni a padroneggiare la lingua anglosassone, e leggere l'originale. Oppure suppongo che possiate semplicemente trovare una delle tante traduzioni disponibili, ma in tal caso non potrete sentirvi moralmente superiori alla gente che incontrate alle feste, alienare tutti e passare il resto della nottata seduto in un angolo a bere da solo borbottando parolacce anglosassoni verso tutti e venire buttato fuori perchè le parolacce anglosassoni sono praticamente identiche a quelle dell'inglese moderno.
$ENTRY_JOURNAL2_EYEOFFLAME_LEFT_1_00	 
$ENTRY_JOURNAL2_EYEOFFLAME_RIGHT_0_00	 
$ENTRY_JOURNAL2_EYEOFFLAME_RIGHT_1_00	 
$ENTRY_JOURNAL2_EYEOFFLAME_TITLE	 
$ENTRY_JOURNAL2_FIRECULT_LEFT_00	Il Culto del Fuoco dell'Impero Quaid
$ENTRY_JOURNAL2_FIRECULT_LEFT_10	L'Impero Quaid è una delle culture più antiche del mondo e la sua religione è altrettanto antica, anche se nel corso del tempo ha lentamente assimilato alcuni aspetti delle religioni confinanti. In pratica, il culto imperiale è una religione monoteistica relativamente sofisticata che ruota attorno all'adorazione del fuoco.<N><N>Gli esponenti della famiglia imperiale vengono visti come i discendenti più prossimi della Fiamma Cosmica. Tramite l'atto del portare gloria all'Impero Quaid essi si guadagnano il diritto di ricongiungersi ai loro antenati nell'aldilà. I nomi di coloro che hanno in qualche modo reso gloria all'Impero vengono ricordati su un grande muro di pietra del palazzo imperiale – questo muro ha la funzione di una specie di passaporto rituale, che attesta il loro diritto a procedere nell'aldilà. Coloro che durante la vita hanno fallito nel portare gloria all'impero in qualche modo, vengono cancellati da tutti i resoconti storici ed il loro corpo viene seppellito invece di essere cremato – un disonore indicibile, dato che la cremazione è l'unico modo per ricongiungersi alla Fiamma Cosmica.
$ENTRY_JOURNAL2_FIRECULT_LEFT_1_00	 
$ENTRY_JOURNAL2_FIRECULT_RIGHT_0_00	 Questo significa che se da un lato l'aristocrazia gode di molti benefici rispetto alla gente comune, dall'altro ha enormi aspettative che gravano su di essa.<N><N>Molti imperatori sono stati deposti e assassinati dai loro sottoposti perchè sembravano ignorare i loro doveri. Per svariate generazioni di imperatori il conflitto con Ash è stato un'ottima occasione per <LQ>rendere gloria all'impero<RQ> attraverso la guerra.
$ENTRY_JOURNAL2_FIRECULT_RIGHT_1_00	 
$ENTRY_JOURNAL2_FIRECULT_TITLE	 
$ENTRY_JOURNAL2_INTRODUCTION_LEFT_00	Introduzione
$ENTRY_JOURNAL2_INTRODUCTION_LEFT_10	Salve a tutti! Questo è il nostro diario top-secret-dietro-le-quinte, pieno zeppo di ogni genere di informazioni top-secret-dietro-le-quinte, tipo cosa mi passava per la testa mentre scrivevo una certa parte della storia (in genere qualcosa come <LQ>quand'è stata l'ultima volta che ho visto il sole?<RQ> e <LQ>perchè Hugh Jackman non ha mai risposto a nessuna delle mie richieste di amicizia?<RQ> ma talvolta anche interessanti dettagli sulla trama che potreste voler conoscere, ad esempio <LQ>la cicatrice sulla guancia di Wrenna deriva dall'episiodio in cui fu fatta prigioniera durante la guerra e cercò di tagliarsi la lingua piuttosto che rivelare dei segreti sotto tortura<RQ> e <LQ>Ora sono io lo scrittore e posso mettere tra parentesi tutte le frasi che voglio! Ha ha ha ha ha ha!<RQ> (seriamente, qui sembra di stare in una matrioska)).<N><N>Ah già, probabilmente dovrei presentarmi. Salve, mi chiamo James <LQ>lo sceneggiatore diabolicamente affascinante<RQ> Cavin. Come potete dedurre dall'accuratissimo secondo nome che i miei genitori mi hanno dato alla nascita, sono l'autore della storia di Defender's Quest: Valley of the Forgotten. Dovrei anche
$ENTRY_JOURNAL2_INTRODUCTION_LEFT_1_00	 
$ENTRY_JOURNAL2_INTRODUCTION_RIGHT_0_00	menzionare Lars <LQ>non affascinante quanto James ma pur sempre molto affascinante e intendo in maniera totalmente platonica<RQ> Doucet, che ha scritto le descrizioni di alcuni nemici e oggetti quando non era occupato a programmare o fare altro (diamine, i nostri genitori hanno avuto un'incredibile lungimiranza nel compilare i nostri certificati di nascita).<N><N>Comunque, questo diario avrà ogni genere di retroscena e informazioni interessanti, appunti su come abbiamo progettato l'universo del gioco, idee scartate, ecc. Sarà come dare un'occhiata al concitato e meraviglioso processo creativo che ha dato la luce alla storia di Valley of the Forgotten, meno tutto quel mangiare cibo spazzatura ed il piangere la notte fino ad addormentarsi. Che magnifico viaggio faremo insieme!<N><N>Inoltre, Hugh, (posso chiamarti Hugh?) se stai leggendo, hai ricevuto l'invito alla mia festa di compleanno? Fidati, solo i più completi sfigati non verranno. Tutti i miei animaletti di peluche saranno lì!
$ENTRY_JOURNAL2_INTRODUCTION_RIGHT_1_00	 
$ENTRY_JOURNAL2_INTRODUCTION_TITLE	 
$ENTRY_JOURNAL2_LORDWARDEN_LEFT_00	L'armatura del Capo Carceriere
$ENTRY_JOURNAL2_LORDWARDEN_LEFT_10	In principio il Capo Carceriere doveva essere uno dei personaggi principali della stora. Nelle mie primissime bozze era l'antagonista principale. Segretamente corrotto dalla pestilenza, avrebbe usato la sua posizione di autorità all'interno del regno di Ash per operare clandestinamente al servizio del creatore della malattia. Fu eventualmente rimpiazzato da Zelemir, che aveva motivazioni di gran lunga più interessanti e complesse. Tuttavia, il titolo e la posizione di Capo Carceriere mi piacevano molto, e quindi venne riproposto sotto forma di armatura. Ehi, almeno ora il suo nome è nel gioco (che è pur sempre meglio di quanto è successo agli altri personaggi scartati)!
$ENTRY_JOURNAL2_LORDWARDEN_LEFT_1_00	 
$ENTRY_JOURNAL2_LORDWARDEN_RIGHT_0_00	 
$ENTRY_JOURNAL2_LORDWARDEN_RIGHT_1_00	 
$ENTRY_JOURNAL2_LORDWARDEN_TITLE	 
$ENTRY_JOURNAL2_MARKOS_MUSTACHE_LEFT_00	I baffi di Markos
$ENTRY_JOURNAL2_MARKOS_MUSTACHE_LEFT_10	Gli enormi basettoni di Markos vennero creati perchè la gente pensava che il suo pizzetto originale lo facesse sembrare troppo un <LQ>venditore d'auto usate.<RQ><N><N>La sua attuale criniera facciale è stata ispirata dal generale unionista Ambrose Everett Burnside (patrono delle basette) e dal leader dei Motörhead, Lemmy Kilmister (patrono del suonare una musica così metal che se si trasferisse di fianco a casa vostra il vostro prato seccherebbe). Vai così, fratello. Vai così.<N><N>Se pensate al fatto che la lama della sua spada è l'unica che ha a disposizione per curarsi la barba, la cosa è decisamente notevole...
$ENTRY_JOURNAL2_MARKOS_MUSTACHE_LEFT_1_00	 
$ENTRY_JOURNAL2_MARKOS_MUSTACHE_RIGHT_0_00	 
$ENTRY_JOURNAL2_MARKOS_MUSTACHE_RIGHT_1_00	 
$ENTRY_JOURNAL2_MARKOS_MUSTACHE_TITLE	 
$ENTRY_JOURNAL2_MARKOS_NAME_LEFT_00	Il nome di Markos
$ENTRY_JOURNAL2_MARKOS_NAME_LEFT_10	Il nome di Markos deriva in realtà da una bizzarra storia raccontata ad un mio caro amico da un suo professore della St. Andrews. Il professore, in gioventù, fece un giro dell'Europa. Mentre era in Francia, visitò una delle tante cattedrali medievali aperte al pubblico. Venne così incantato dalla struttura che decise che sarebbe stata un'ottima idea separarsi dalla sua comitiva e nascondersi così che quando tutti fossero andati a casa, dopo la chiusura, avrebbe potuto sgattaiolare in giro e guardare dappertutto senza che qualche fastidiosa guida turistica gli dicesse dove poter o non poter andare.<N><N>Il suo piano funzionò, e non appena la cattedrale venne chiusa scivolò fuori dal suo nascondiglio e iniziò ad esplorare. Fu più o meno a quel punto che notò un paio di piedi che spuntavano da dietro un arazzo. A quanto pare, non era l'unico ad aver avuto l'idea di esplorare di soppiatto l'architettura medievale. La persona diatro l'arazzo era una delle giovani donne della sua stessa comitiva, e i due iniziarono ad esplorare insieme la cattedrale.
$ENTRY_JOURNAL2_MARKOS_NAME_LEFT_1_00	 Alla fine, il futuro professore e la giovane donna finirono per sposarsi. Per quanto riguarda Markos, mi piace pensare che viva da qualche parte in una grotta sotto una cattedrale.<N><N>Il personaggio mi è piaciuto così tanto che decisi che prima o poi ne avrei usato il nome in qualche occasione.
$ENTRY_JOURNAL2_MARKOS_NAME_RIGHT_0_00	Distratti dal parlare, i due non si accorsero dell'arrivo di un terzo uomo che chiese loro se volessero un <LQ>giro turistico segreto.<RQ> L'uomo, presentatosi come Markos, aveva capelli arruffati, barba incolta e unghie molto lunghe. Pare che anch'egli avesse preso l'abitudine di nascondersi nelle cattedrali fino alla chiusura per esplorarle la notte ed era a conoscenza di una caterva di informazioni, improvvisando perfino una performance con l'organo della chiesa. Fu grossomodo a quel punto che spiegò che molte cattedrali cristiane medievali vennero in realtà erette su più antichi siti pagani, e che molto spesso questi siti persistevano ancora al di sotto della struttura più recente. Questo era per la verità il suo interesse principale nelle cattedrali, come se fosse un druido. Dopo aver passato un po' di tempo a esplorare il retro della chiesa, individuò con successo nel pavimento una botola dall'aspetto importante, che si apriva su una catacomba sottostante la cattedrale. Apparentemente non trovando nulla di strano nel seguire uno strano uomo in una camera di morte sotterranea, i due turisti raggiunsero Markos sottoterra, dove trovarono i resti della tomba pagana su cui venne edificata la chiesa. Dopo aver giocherellato con i teschi per un po' Markos gli diede la buonanotte, e tutti s'incamminarono per la proprie strade.
$ENTRY_JOURNAL2_MARKOS_NAME_RIGHT_1_00	 
$ENTRY_JOURNAL2_MARKOS_NAME_TITLE	 
$ENTRY_JOURNAL2_MARKOS_SKIRT_LEFT_00	Il gonnellino di Markos
$ENTRY_JOURNAL2_MARKOS_SKIRT_LEFT_10	Per chi lo volesse sapere, il <LQ>gonnellino<RQ> dell'armatura di Markos è composto da strisce di cuoio chiamate pterigi. Ma quante ne sappiamo!<N><N>Potreste riconoscerle nelle armature dei soldati greci e romani – includerle all'armatura di Markos è stato parte dei miei sforzi di dare ad Ash uno stile bizantino/mediterraneo.
$ENTRY_JOURNAL2_MARKOS_SKIRT_LEFT_1_00	 
$ENTRY_JOURNAL2_MARKOS_SKIRT_RIGHT_0_00	 
$ENTRY_JOURNAL2_MARKOS_SKIRT_RIGHT_1_00	 
$ENTRY_JOURNAL2_MARKOS_SKIRT_TITLE	 
$ENTRY_JOURNAL2_MARKOS_SPELL_LEFT_00	L'aforisma di Markos ed il libro dei cinque anelli
$ENTRY_JOURNAL2_MARKOS_SPELL_LEFT_10	<LQ>Non colpire con la forza delle braccia, ma con quella dello spirito, e così, corpo e mente una cosa sola, scaglia li tuo nemico lontano da te.<RQ>
$ENTRY_JOURNAL2_MARKOS_SPELL_LEFT_1_00	 
$ENTRY_JOURNAL2_MARKOS_SPELL_LEFT_20	L'<LQ>aforisma<RQ> di Markos è ispirato al linguaggio del libro dei cinque anelli, un affascinante trattato su samurai, tattiche e scherma scritto intorno al 1645. L'autore, Miyamoto Musashi, è uno dei più famosi samurai di tutti i tempi. Ha inoltre ispirato alcuni bellissimi film di Toshiro Mifune, che consiglio caldamente a chi adora guardare Toshiro Mifune mentre fa a fettine un sacco di gente nel glorioso technicolor anni 50 (anche Toshiro Mifune riceverebbe assolutamente un invito alla mia festa di compleanno se non fosse che, sapete, morì quando avevo 11 anni).
$ENTRY_JOURNAL2_MARKOS_SPELL_RIGHT_0_00	 
$ENTRY_JOURNAL2_MARKOS_SPELL_RIGHT_1_00	 
$ENTRY_JOURNAL2_MARKOS_SPELL_TITLE	 
$ENTRY_JOURNAL2_MASTEROFARCHERS_LEFT_00	Gedemon Dalavbar, Maestro degli Arcieri
$ENTRY_JOURNAL2_MASTEROFARCHERS_LEFT_10	Gedemon Dalavbar, la cui citazione illustra l'introduzione del settimo capitolo, è uno dei tanti ad aver indossato l'armatura di Maestro degli Arcieri.<N><N>Ho brevemente intrattenuto l'idea di scrivere un intero libro sulle sue avventure prima di concludere che questo livello di attenzione per i dettagli mi avrebbe fatto uscire di testa.<N><N>Chissà, forse un giorno...<N><N>(Naturalmente, anche Klest Kada, avventuriero nomade, avrebbe avuto la sua storia.)
$ENTRY_JOURNAL2_MASTEROFARCHERS_LEFT_1_00	 
$ENTRY_JOURNAL2_MASTEROFARCHERS_RIGHT_0_00	 
$ENTRY_JOURNAL2_MASTEROFARCHERS_RIGHT_1_00	 
$ENTRY_JOURNAL2_MASTEROFARCHERS_TITLE	 
$ENTRY_JOURNAL2_MEET_BERSERKER_LEFT_00	Ti presento il barbaro:<N>scena tagliata
$ENTRY_JOURNAL2_MEET_BERSERKER_LEFT_10	In principio Slak era ottenibile soltanto dopo la prima battaglia. Il primo combattimento andava svolto interamente con l'abilità fulmine di Azra – alla fine, ci siamo accorti che questo confondeva i giocatori, che iniziavano a credere che il fulcro del gioco fosse usare gli incantesimi piuttosto che i personaggi.<N><N>Abbiamo quindi riscritto alcune parti, piazzato Slak nella prima battaglia e i giocatori non si sono più confusi! Per chi di voi volesse sapere come Slak veniva introdotto originariamente, ecco la vecchia scena che abbiamo tagliato:<N><N>AZRA:<N>(stordita)<N>    <LQ>Accidenti... cosa diavolo è stato?<RQ><N><N>AZRA:<N>(confusa)<N>    <LQ>Da quanto mi trovo qui?<RQ>
$ENTRY_JOURNAL2_MEET_BERSERKER_LEFT_1_00	SLAK:<N>(entusiasmato)<N>    <LQ>È stato FANTASTICO!<RQ><N><N>AZRA:<N>(confusa)<N>    <LQ>Senti, non ho idea di cosa parli. Tutto quello che so è che ero molto malata-<RQ><N><N>SLAK:<N>(colloquiale)<N>    <LQ>-E ti hanno buttato qui a morire.<RQ><N><N>AZRA<N>(confusa)<N>    <LQ>Già.<RQ><N><N>SLAK:<N>(imitando)<N>    <LQ>E gli zombi hanno fatto tipo 'Oh, adesso ti mangiamo.'<RQ><N><N>SLAK:<N>(fuori di testa)
$ENTRY_JOURNAL2_MEET_BERSERKER_LEFT_2_00	AZRA:<N>(infastidita)<N>    <LQ>Senti, per quanto apprezzi il tuo spettacolo teatrale, non ho assolutamente idea di cosa ci faccio qui, quindi se non ti dispiace -<RQ><N><N>SLAK:<N>(amichevole)<N>    <LQ>Be' per tua fortuna, bambola, ti sei appena imbattuta nella miglior guida turistica dell'intera Valle!<RQ><N><N>AZRA:<N>(scocciata)<N>    <LQ>Guida turistica?<RQ><N><N>SLAK:<N>(amichevole)<N>    <LQ>Ascolta, qui ci sono un sacco di pericoli per una neofita come te. Revenant, banditi, capibanda... non sopravviveresti più di cinque secondi da sola. Ma per il basso, bassissimo prezzo di assolutamente gratis, ti mostrerò quello che c'è da sapere per sopravvivere in questo buco dimenticato da dio.<RQ>
$ENTRY_JOURNAL2_MEET_BERSERKER_RIGHT_0_00	(arriva SLAK)<N><N>SLAK:<N>(entusiasmato)<N>    <LQ>È stato fantastico!<RQ><N><N>AZRA:<N>(confusa)<N>    <LQ>Cosa?<RQ><N><N>SLAK:<N>(entusiasmato)<N>    <LQ>Hai appena ucciso qualcosa come una ventina di Revenant!<RQ><N><N>AZRA:<N>(confusa)<N>    <LQ>Revenant?<RQ><N><N>SLAK:<N>(colloquiale)<N>    <LQ>Sì, hai presente, i mostri, zombi, orrori semoventi, cadaveri rianimati che se vanno in giro a mangiare la gente: Revenant.<RQ>
$ENTRY_JOURNAL2_MEET_BERSERKER_RIGHT_1_00	    <LQ>E tu eri tipo: 'Non credo proprio, mangiatori di melma! Preparatevi a papparvi una cucchiaiata di fulmini!'<RQ><N><N>SLAK:<N>(riparandosi con le braccia)<N>    <LQ>E loro hanno fatto tipo 'Oddio! Ti prego non friggerci con i tuoi fantastici poteri elettrici mortali! AHHH! Che male! Brucia! BRUCIA COME LA PREPOTENTE FURIA DI MILLE SOLI MORENTI!'<RQ><N><N>SLAK:<N>(deluso)<N>    <LQ>E io ero tipo 'Accidenti, sembra che non le potrò rubare le scarpe.'<RQ><N><N>AZRA:<N>(infastidita)<N>    <LQ>...<RQ><N><N>SLAK:<N>(colloquiale)<N>    <LQ>Dimentica l'ultima parte.<RQ>
$ENTRY_JOURNAL2_MEET_BERSERKER_RIGHT_2_00	AZRA:<N>(confusa)<N>    <LQ>Hai detto gratis?<RQ><N><N>SLAK:<N>(amichevole)<N>    <LQ>Certo. Il tutto grazie alla bontà del mio cuore incredibilmente sexy e muscoloso, senza nessunissimo obbligo riguardo all'uso dei tuoi incredibili poteri per accumulare ricchezza personale.<RQ><N><N>SLAK:<N>(proclamando)<N>    <LQ>Prossima fermata, la sala del tesoro di Ozimal Kaz!<RQ>
$ENTRY_JOURNAL2_MEET_BERSERKER_TITLE	 
$ENTRY_JOURNAL2_NAMES_LANG_LEFT_00	Nomi e linguaggi
$ENTRY_JOURNAL2_NAMES_LANG_LEFT_10	Un sacco di gente ha commentato sugli strani e inusuali nomi generati casualmente dal gioco per le reclute generiche che si possono reclutare nei villaggi. Questi nomi sono parte dei nostri sforzi per sottolineare le differenze fra le culture principali: il regno di Ash, l'impero Quaid e i nomadi.<N><N>Noterete che certi nomi spuntano in concomitanza con alcuni tratti somatici. Questo perchè il gioco ha una lista delle caratteristiche fisiche di ogni civiltà ed anche una lista dei nomi di ogni cultura – quando il giocatore clicca per reclutare un personaggio, inizialmente il gioco assegna casualmente una delle tre culture alla recluta e poi seleziona casualmente un nome e delle caratteristiche fisiche dalla lista di quella cultura. Per tutti quelli che fra voi sono interessati all'argomento (tutti e tre) ecco la nostra vecchia guida sulla scelta dei nomi:
$ENTRY_JOURNAL2_NAMES_LANG_LEFT_1_00	 e si pronuncia <LQ>sk<RQ> o <LQ>st<RQ> ed è l'unica lingua ad usare il suono 'j'.<N><N>Aspetto dei nomadi:<N><N>Pelle marrone chiaro<N>Occhi verdi, blu, marroni-verdi<N>Capelli rosso-castano scuro, chiaro e medio, talvolta neri<N><N>    Nel complesso, un insieme di tratti afgani e rom. Avendo una popolazione ridotta che si sposa prevalentemente al suo interno significa che i geni più rari, come i capelli rossi e gli occhi verdi, tendono a comparire con più frequenza. Nomi quaidiani - molte 'W' ed 'L', prendendo ispirazione dal gallese e l'hawaiano (più che altro perchè stavo cercando lettere non usate molto per i nomi ashiani, ed 'L' e 'W' sembravano calzare a pennello.) C'è anche un pizzico di influenza anglosassone. Il quaid preferisce la lettera 'C' alla 'K', e usa spesso la 'Y' come 'I' morbida. I nomi femminili tendono a finire in -a e spesso <LQ>-nna.<RQ>
$ENTRY_JOURNAL2_NAMES_LANG_LEFT_20	Qui c'è la nostra cisterna di nomi per personaggi generici. I nomi sono divisi in base alle culture. Aggiungete pure quelli che vi vengono in mente. In generale, per i nomi vale la seguente regola:
$ENTRY_JOURNAL2_NAMES_LANG_LEFT_2_00	Tavida (femminile)<N>Yoavna (femminile)<N>Kesmir<N>Vasmon<N>Zenimon<N>Kastal<N>Kavni (femminile)<N>Bazan<N>Evni (femminile)<N>Rostal<N>Kezal<N>Tezra (femminile)<N>Zinak<N>Restavni (femminile)<N>Sedemon<N>Zerevna (femminile)<N>Ezran<N>Tanos<N>Yevkani (femminile)<N>Keznimon<N>Ayimi (femminile)<N>Admon<N>Azakal<N>Bakaza
$ENTRY_JOURNAL2_NAMES_LANG_LEFT_3_00	Nesk<N>Dysta (femminile)<N>Skod<N>Senji (femminile)<N>Klest<N>Zekka (femminile)<N>Kask<N>Droat<N>Jek<N>Jekka (femminile)<N>Kaji (femminile)<N>Plosk<N>Skent<N>Foska (femminile)<N>Fytt<N>Zesk<N>Sajesh<N><N><N>Quaid Names:<N><N>Lawan<N>Sawul<N>Wassa
$ENTRY_JOURNAL2_NAMES_LANG_LEFT_4_00	Cuwain<N>Cella (femminile)<N>Celuwanna (femminile)<N>Celuwon<N>Cylehal<N>Awan<N>Alenna (femminile)<N>Awucella (femminile)<N>Awucan<N>Iowan<N>Ittella (femminile)<N>Walla<N>Lacan
$ENTRY_JOURNAL2_NAMES_LANG_RIGHT_0_00	nomi ashiani: un sacco di 'Z' e 'V', consonanti marcate e continue e un generale stile mediterraneo. I nomi maschili terminano spesso in -mon/man, -ir o -al, i nomi femminili tendono a terminare con -a o -i e a volte <LQ>-vni<RQ>. Combinazioni fonetiche comuni includono <LQ>vn<RQ> e <LQ>zr<RQ><N><N>tratti somatici ashiani:<N><N>Pelle dai toni olivastri e talvolta africani<N><N>capelli neri, castani, biondo scuro, e occasionalmente rossi<N><N>Occhi marroni, marroni-verdi e blu.<N><N>    In generale, una combinazione di tratti mediterranei/greci/germanici/arabi. Gli ashiani hanno la varietà di aspetto più ampia data la frequenza dei matrimoni misti con i popoli circostanti.<N><N>Nomi dei nomadi: nomi dalle sillabe corte e marcate terminanti in consonanti discontinue. I nomi femminili tendono a finire con -a. La 'k' è frequente, 
$ENTRY_JOURNAL2_NAMES_LANG_RIGHT_1_00	aspetto dei quaidiani:<N><N>Pelle molto chiara<N>Capelli o molto scuri o molto chiari (completamente neri o biondo paglierini, con poche sfumature tra i due). Il biondo è piuttosto raro nella gente comune, ma più prevalente nella famiglia imperiale.<N>Occhi neri (castano scurissimo), castani e grigi.<N><N>    Nell'insieme, una combinazione di tratti gallesi/scandinavi/del lontano oriente.<N><N>Nomi ashiani:<N><N>Zir<N>Kered<N>Kolos<N>Teluman<N>Gozal<N>Gozra (femminile)<N>Sivnah (femminile)<N>Zamena (femminile)<N>Hektamon<N>Devdi (femminile)
$ENTRY_JOURNAL2_NAMES_LANG_RIGHT_2_00	Kevnimi (femminile)<N><N>Nomi dei nomadi:<N><N>Senna (femminile)<N>Koat<N>Kem<N>Raska (femminile)<N>Saja (femminile)<N>Tulk<N>Rendt<N>Senga (femminile)<N>Jast<N>Pak<N>Tanna (femminile)<N>Dank<N>Serk<N>Drask<N>Sotta (femminile)<N>Leska (femminile)<N>Joata (femminile)<N>Saj<N>Het<N>Tetch
$ENTRY_JOURNAL2_NAMES_LANG_RIGHT_3_00	Aluwo<N>Sanna (femminile)<N>Wocolan<N>Celu<N>Laclanna (femminile)<N>Walucella (femminile)<N>Xeowan<N>Xeowanna (femminile)<N>Wastan<N>Luwella (femminile)<N>Lumenna (femminile)<N>Stawan<N>Wacali (femminile)<N>Neorxennawanga (femminile)<N>Centawal<N>Solowan<N>Cyleth<N>Wulacal<N>Cedmal<N>Lanna (femminile)<N>Hylla (femminile)<N>Hywada (femminile)<N>Walacanna (femminile)<N>Cullad
$ENTRY_JOURNAL2_NAMES_LANG_TITLE	 
$ENTRY_JOURNAL2_NAMINGEVIL_LEFT_00	Il nome del male
$ENTRY_JOURNAL2_NAMINGEVIL_LEFT_10	Quando venne il momento di dare un nome al nostro cattivone supremo, avevo intenzione di dargliene uno che lo facesse sembrare notevolmente più esotico rispetto agli altri personaggi e luoghi. A complicare le cose c'era il fatto che avevo già tre civiltà prominenti che stavo cercando di differenziare tra loro.<N><N>Decisi alla fine di provare con dei nomi Nahuatl (Aztechi), dato che era un linguaggio notevolmente diverso da quelli che stavamo già usando come ispirazione (greco e arabico per Ash, gallese/hawaiano/anglosassone per il Quaid, afgano e finlandese posticcio per i nomadi).<N><N>A posteriori, mischiare nomi reali come Azra e Zelemir, con e pastrocchi inventati di sana pianta come Ketta e Bakal è stato un po' strano (anche se in linea con le nostre radici di JRPG, immagino).<N><N>Questo significa anche che tutta la nostra trama può essere riassunta in, per citare Lars, <LQ>una continua serie di inseguimenti con un dio azteco sepolto alla fine.<RQ>
$ENTRY_JOURNAL2_NAMINGEVIL_LEFT_1_00	 
$ENTRY_JOURNAL2_NAMINGEVIL_RIGHT_0_00	 
$ENTRY_JOURNAL2_NAMINGEVIL_RIGHT_1_00	 
$ENTRY_JOURNAL2_NAMINGEVIL_TITLE	 
$ENTRY_JOURNAL2_NOMADSPIRIT_LEFT_00	Lo spiritualismo dei nomadi
$ENTRY_JOURNAL2_NOMADSPIRIT_LEFT_10	In principio i nomadi praticavano un politeismo basato sulle tribù. Ogni tribù aveva i suoi dèi (e all'interno di molte tribù ogni famiglia aveva il suo sottogruppo di semidei domestici) rappresentati da degli idoli. Questi dèi erano lì al servizio del bene della tribù, ma in cambio dovevano anche essere onorati e serviti. Faide e lotte intestine sono molto comuni fra le diverse tribù, dato che il loro vagare le spinge frequentemente a invadere il territorio altrui, o al furto di bestiame e al saccheggio. Gli dèi tribali fungono da stendardi in questi conflitti. Per una tribù, perdere i propri idoli è la disgrazia più totale e generalmente segna la fine della sua stessa esistenza (a meno che non le sia possibile riconquistare gli idoli in combattimento). Una tribù senza i suoi dèi è considerata il peggio del peggio, ed è bandita dal commercio ed altri incontri.<N><N>A ogni individuo nomade viene inoltre assegnato alla nascita un idolo personale, che si ritiene essere un servo degli dèi della tribù. Questi spiriti servitori fungono da guide e guardiani per l'individuo nel corso della sua vita. Alla morte del nomade l'idolo personale viene seppellito con il suo proprietario in modo da garantirgli un viaggio sicuro verso il paradiso. Perdere il proprio
$ENTRY_JOURNAL2_NOMADSPIRIT_LEFT_1_00	 
$ENTRY_JOURNAL2_NOMADSPIRIT_RIGHT_0_00	idolo è per un nomade una catastrofe immane. Senza il suo spirito guardiano a indicargli la via, il fantasma del nomade è condannato a impiegare molte epoche per trovare la strada per il paradiso.<N>    I lunghi contatti intrattenuti con il regno di Ash tramite commercio ecc. hanno portato molte tribù ad adottare gli insegnamenti del Tempio di Ash. Solo una manciata di esse hanno volontariamente abbandonato del tutto le vecchie usanze per convertirsi completamente. La maggior parte cerca invece di conciliare le proprie divinità con quella ashiana. Questo miscuglio di fedi ha suscitato molta animosità religiosa nel Tempio di Ash, aggiungendosi ai pregiudizi generali contro i nomadi già esistenti nel regno di Ash.
$ENTRY_JOURNAL2_NOMADSPIRIT_RIGHT_1_00	 
$ENTRY_JOURNAL2_NOMADSPIRIT_TITLE	 
$ENTRY_JOURNAL2_OUTRO_LEFT_00	E questo è tutto
$ENTRY_JOURNAL2_OUTRO_LEFT_10	Come, siamo già arrivati alla fine del nostro retroscena?<N><N>Che magnifico viaggio è stato! Abbiamo riso, abbiamo pianto, siamo ascesi ad alti piani dell'esistenza, e abbiamo intravisto verità sconosciute! Sento che si è creato un legame fra noi. Vi considero tutti come dei fratellini adesso, meno il rubarmi i giocattoli e mettermi sul letto delle puntine da disegno dello stesso colore del piumone, e mamma non voleva farmelo mettere in lavatrice perchè pensava che le puntine da disegno l'avrebbero rotto, e così ho passato tutto l'inverno a dormire in un letto sporco e pieno di puntine… Vlad.<N><N>In ogni caso, è stata una bella avventura! Spero che vi sia piaciuto questo scorcio sul concitato e terrificante processo creativo che ci ha dato Defender's Quest: Valley of the Forgotten (meno tutto quel piangere fino ad addormentarmi la notte, bevendo collutorio e guardando teleshopping spagnoli dal cavo rubato dei vicini).<N>
$ENTRY_JOURNAL2_OUTRO_LEFT_1_00	 
$ENTRY_JOURNAL2_OUTRO_RIGHT_0_00	Ci rivediamo tutti per Defender's Quest 2!<N><N>Ma come, allora si farà?<N><N>Certo che sì! E sarà magnifico!<N><N>Dovreste andare a comprarlo subito!<N><N>PS: ti sei perso una festa di compleanno ecceziunale veramente, Hugh. Qualcuno ha portato del collutorio e le cose sono andate da sballo.<N><N>PPS: Se ve lo state chiedendo la frase "il cavo rubato dei vicini" significa che sono stati i vicini a rubare il cavo, non io a loro. Ehi, anch'io ho degli standard. Io mi limito a guardare la loro tv via cavo con dei binocoli attraverso la finestra sul retro.
$ENTRY_JOURNAL2_OUTRO_RIGHT_1_00	 
$ENTRY_JOURNAL2_OUTRO_TITLE	 
$ENTRY_JOURNAL2_PLATEMAIL_LEFT_00	<LQ>Armatura a piastre<RQ>
$ENTRY_JOURNAL2_PLATEMAIL_LEFT_10	Un sacco di gente adora tirare in ballo a sproposito il termine <LQ>armatura a piastre<RQ>. Nel momento in cui è apparso in Defender's Quest per descrivere le armature pesanti ho interrotto immediatamente quello che stavo facendo (fissare in maniera inopportuna un manuale di scherma tedesca) e sono scattato in azione. Vedete, <LQ>armatura a piastre<RQ> è un termine stupido e ridondante che non dovrebbe mai essere associato a qualcosa che abbia un minimo di utilità. Ma... se ci sono le <LQ>cotte di maglia<RQ>, allora un'armatura a piastre sarà, tipo, una <LQ>cotta di piastre<RQ>, giusto? SBAGLIATO!<N><N>La parola <LQ>maglia<RQ> (o <LQ>maille<RQ>, se volete essere sofisticati), deriva dalla parola medievale francese per <LQ>catena<RQ>. La frase <LQ>cotta di maglia<RQ> è una ridondanza che saltò fuori solo nel diciannovesimo secolo. Una volta che <LQ>cotta di maglia<RQ> è entrata nel linguaggio comune, la gente ha dimenticato il significato originale di <LQ>maglia<RQ> interpretandolo come <LQ>armatura o qualcosa del genere, credo<RQ>. E poi hanno iniziato ad appiopparlo alla fine di qualunque cosa che avrebbe dovuto semplicemente essere chiamata armatura.
$ENTRY_JOURNAL2_PLATEMAIL_LEFT_1_00	 
$ENTRY_JOURNAL2_PLATEMAIL_RIGHT_0_00	E visto che sto già alienando tutti quanti, possiamo parlare della mania di mettere spuntoni su ogni cosa? Che cosa avete intenzione di fare, abbracciare la gente fino alla morte? Che succede se volete alzare le braccia per più di 30 gradi e gli spuntoni di venti centimetri sugli spallacci vi passano attraverso la testa? Come si può pensare di muoversi e combattere dentro qualcosa che rischia di impalare chi la indossa in qualunque postura diversa da <LQ>pose drammatiche da locandina<RQ>?<N><N>Ehi, dove siete andati tutti quanti?
$ENTRY_JOURNAL2_PLATEMAIL_RIGHT_1_00	 
$ENTRY_JOURNAL2_PLATEMAIL_TITLE	 
$ENTRY_JOURNAL2_RIGHTHAND_LEFT_00	La mano destra di Eztli Tenoch
$ENTRY_JOURNAL2_RIGHTHAND_LEFT_10	In principio, quando inclusi nella storia la Mano Destra di Eztli Tenoch, intendevo <LQ>mano destra<RQ> nello stesso modo in cui un generale è la <LQ>mano destra del re<RQ> – in senso puramente figurato. La Mano Destra di Eztli Tenoch doveva essere semplicemente un revenant particolarmente grosso e cattivo con il ruolo di miglior aiutante di Eztli.<N><N>In qualche modo, durante la produzione, le cose sono state prese un po' troppo alla lettera, e così è nato lo sprite della terrificante mano gigante utilizzato ora nel gioco. Riluttanti a rifare da zero tutte le immagini per il personaggio, ho semplicemente aggiunto alcune righe di spiegazione nei dialoghi. Questo equivoco è in effetti responsabile di uno dei più memorabili boss del gioco! (Vorrei anche sottolineare che è stato Lars a scrivere la descrizione del mostro, quindi il <LQ>sinistro<RQ> doppio senso non è assolutamente colpa mia.)
$ENTRY_JOURNAL2_RIGHTHAND_LEFT_1_00	 
$ENTRY_JOURNAL2_RIGHTHAND_RIGHT_0_00	 
$ENTRY_JOURNAL2_RIGHTHAND_RIGHT_1_00	 
$ENTRY_JOURNAL2_RIGHTHAND_TITLE	 
$ENTRY_JOURNAL2_SANDWICH_LEFT_00	La ricetta del sandwich preferito di James
$ENTRY_JOURNAL2_SANDWICH_LEFT_10	Ragazzi, tutto questo scrivere di retroscena mi ha fatto venire appetito. Voi avete fame? Io sì. Vediamo di rimediare.<N><N>Vi serviranno:<N><N>Salsiccia<N>Uova<N>Pane<N>Pomodori<N>Crauti<N>Mostarda<N>Yogurt (senza dolcificanti e altri aromi, perchè non siete delle mammolette)<N>Salsa piccante (io la preferisco nello stile della Louisiana, ma se siete dei devianti o dei comunisti potete usare quella che volete)
$ENTRY_JOURNAL2_SANDWICH_LEFT_1_00	La cosa importante è che il pane sia stato trasformato da qualcosa che potrebbe ancora conservare dei valori nutrizionali ad un croccante, supercalorico e stragrasso induttore d'infarto. Ricordatevi, se un pasto non vi riempie di rammarico state sbagliando tutto.<N><N>6º:<N>Adesso la salsina! Versate mostarda e yogurt in parti grossomodo uguali in una ciotola o un altro contenitore del genere, come l'incavo del teschio dei vostri nemici. Aggiungete la salsa piccante, assaggiate e mescolate il tutto finchè è amalgamato. Se vi rimane ancora del grasso di salsiccia, questo è un buon posto in cui metterlo.<N><N>7º:<N>È arrivato il momento di fare il sandwich! Spalmate liberamente la salsina su entrambe le fette di pane. Ora impilate tutti i vostri ingredienti nell'ordine che volete: uova fritte, fettine di salsiccia fritta, crauti, pomodoro a fette, dita tagliate accidentalmente, ecc. Il maestoso monumento alla vostra magnificenza che ne verrà fuori sarà alto almeno una decina di centimetri.
$ENTRY_JOURNAL2_SANDWICH_RIGHT_0_00	1º:<N>Uccidete un animale (preferibilmente un magnifico animale, come uno squalo), macinatelo e poi riempite il suo stesso intestino con la carne sminuzzata. In alternativa suppongo che possiate semplicemente andare a comprare della salsicca, ma così dove sarebbe il divertimento?<N><N>2º:<N>Tagliate la salsiccia a fettine sottili nel senso della lunghezza.<N><N>3º:<N>Friggetele in una padella, assicurandovi che vengano belle croccanti da tutti e due i lati, ma senza esagerare.<N><N>4º:<N>Friggete le uova (tante quante ritenete possano entrare in un sandwich – io di solito ne metto due, ma non lasciate che questo vi fermi) nel grasso residuo della salsiccia.<N><N>5º:<N>Quel pane sembra un po' troppo salubre rispetto a tutto il resto degli ingredienti. Friggetelo nell'unto della salsiccia che è rimasto! Se necessario, potete aggiungere altro grasso.
$ENTRY_JOURNAL2_SANDWICH_RIGHT_1_00	8º:<N>Divoratelo. Visto che tutti gli ingredienti sono imbevuti d'olio, il sandwich tende a rammollirsi. Non c'è modo di salvarlo, quindi mangiatelo tutto subito! Nessuna pietà! Non prendete prigionieri! Ne va della democrazia!<N><N>9º:<N>Pentitevene.
$ENTRY_JOURNAL2_SANDWICH_TITLE	 
$ENTRY_JOURNAL2_SCARS_LEFT_00	Cicatrici
$ENTRY_JOURNAL2_SCARS_LEFT_10	Il gioco non si sofferma molto su questo, ma le cicatrici sul viso di Wrenna risalgono al periodo in cui lei fu catturata durante la guerra fra Ash e Quaid. Temendo di poter rivelare dei segreti sotto tortura, Wrenna cercò di tagliarsi la lingua per evitare di tradire il suo paese. In principio le cicatrici erano un po' più visibili, ma ci siamo resi conto che la facevano assomigliare troppo a Joker e le abbiamo modificate.<N><N>Sebbene Wrenna sia l'unico personaggio con una particolare storia associata alle sue cicatrici, abbiamo cercato di rendere la maggior parte degli altri sopravvissuti visibilmente sfregiata in un modo o nell'altro. Questo non solo ha contribuito a rafforzare l'idea della valle come un luogo di costante pericolo e violenza, ma ha anche aiutato a distinguere Azra come <LQ>carne fresca<RQ>. Essendo una residente relativamente nuova della valle, Azra semplicemente non ha avuto il tempo di collezionare tutte le vecchie cicatrici di battaglia che hanno gli altri.
$ENTRY_JOURNAL2_SCARS_LEFT_1_00	 
$ENTRY_JOURNAL2_SCARS_RIGHT_0_00	 
$ENTRY_JOURNAL2_SCARS_RIGHT_1_00	 
$ENTRY_JOURNAL2_SCARS_TITLE	 
$ENTRY_JOURNAL2_SELINI_LEFT_00	I Selini
$ENTRY_JOURNAL2_SELINI_LEFT_10	Le scuole di pensiero e le sette sono comuni tra i fedeli del Tempio di Ash. I Selini sono una setta monastica del Tempio di Ash che si focalizza sull'emulazione della vita del fondatore della religione, Selinadt, ripristinando l'equilibrio nel mondo. Questo compito viene espletato sia attraverso l'ascetismo personale che assistendo e tutelando il mondo circostante. La maggior parte dei monasteri dei Selini fungono da santuari e ospedali in aree martoriate dalla guerra o comunque instabili (carenti appunto di equilibrio).
$ENTRY_JOURNAL2_SELINI_LEFT_1_00	 
$ENTRY_JOURNAL2_SELINI_RIGHT_0_00	 
$ENTRY_JOURNAL2_SELINI_RIGHT_1_00	 
$ENTRY_JOURNAL2_SELINI_TITLE	 
$ENTRY_JOURNAL2_SLAKLIBRARIAN_LEFT_00	Slak il bibliotecario
$ENTRY_JOURNAL2_SLAKLIBRARIAN_LEFT_10	Sapevate che all'inizio era Slak, e non Azra, che avrebbe dovuto essere il bibliotecario del gruppo?<N><N>Dalla biografia originale di Slak:
$ENTRY_JOURNAL2_SLAKLIBRARIAN_LEFT_1_00	 
$ENTRY_JOURNAL2_SLAKLIBRARIAN_LEFT_20	Occupazione: prima di essere incarcerato era un bibliotecario, discendente da una lunga stirpe di bibliotecari della capitale.  Ora è un avventuriero di professione e un mercenario per le varie fazioni della valle.<N><N>Educazione: estremamente colto, le sue materie preferite sono la storia e la letteratura epica.  Odia le scienze applicate come la matematica.<N>
$ENTRY_JOURNAL2_SLAKLIBRARIAN_LEFT_30	Alla fine, il ruolo venne dato ad Azra, che divenne la bibliotecaria armata di mestolo un tantino nevrotica che tutti conosciamo e amiamo. E Slak è diventato... qualcosa di completamente diverso.
$ENTRY_JOURNAL2_SLAKLIBRARIAN_RIGHT_0_00	 
$ENTRY_JOURNAL2_SLAKLIBRARIAN_RIGHT_1_00	 
$ENTRY_JOURNAL2_SLAKLIBRARIAN_TITLE	 
$ENTRY_JOURNAL2_STORYINSPIRE_LEFT_00	Ispirazioni per la trama
$ENTRY_JOURNAL2_STORYINSPIRE_LEFT_10	Una volta un collega laureato in lettere mi chiese quali fossero state le ispirazioni letterarie per la trama de 'la Valle dei Dimenticati'. Per chi di voi è interessato a questo argomento (sì, tutti e due), queste sono le tre cose principali che avevo in mente mentre scrivevo:<N><N>l'idea della colonia di quarantena è nata in effetti da un racconto di Rudyard Kipling, The Strange Ride of Morrowbie Jukes. La lessi intorno agli 11 o 12 anni e l'idea di una prigione naturale piena zeppa di persone <LQ>morte<RQ> ma che poi si sono riprese non mi ha più lasciato. C'era questo senso molo forte di comunità dei malati che mi ha poi ispirato per molti dei dettagli della Valle. (Ad esempio, l'assenza di cavalli. Una delle prime cose che accade a Morrowbie è che il suo cavallo viene ucciso e mangiato - anche se poi lui riceve una porzione della carne, quindi non gli è andata del tutto male.)<N><N>Andando oltre, molta dell'atmosfera culturale del gioco deriva da documenti storici bizantini. Gran parte della cultura dei Selini si basa sulle scritture dei primi patriarchi del deserto
$ENTRY_JOURNAL2_STORYINSPIRE_LEFT_1_00	 
$ENTRY_JOURNAL2_STORYINSPIRE_RIGHT_0_00	e di altri cristiani dell'oriente.<N><N>E per concludere con la mia nerdaggine sulla letteratura storica, un'ispirazione ENORME deriva dalla letteratura anglosassone. Quando iniziai a lavorare a Defender's Quest avevo appena fatto un corso di inglese antico, ed il linguaggio e la sua cultura mi furono di grandissima ispirazione quasi per tutto. Il tono molto meditabondo, elegiaco, sembrava perfetto per la nostra ambientazione post-apocalittica medievale. Consiglio caldamente di dare un'occhiata a The Ruin, se vi interessa questo genere di cose; è breve e cattura molto bene il genere di tono malinconico tipico della letteratura anglosassone.<N><N>Naturalmente ci sono una tonnellata di altre opere, ma queste tre hanno probabilmente esercitato la maggior influenza sulla nostra ambientazione. Be', quelle ma anche una sana dose dei miei autori umoristici preferiti.
$ENTRY_JOURNAL2_STORYINSPIRE_RIGHT_1_00	 
$ENTRY_JOURNAL2_STORYINSPIRE_TITLE	 
$ENTRY_JOURNAL2_WARRIORMONK_LEFT_00	Il nono capitolo dei Selini, Casa Militante, Difensori di Ordine e Verità
$ENTRY_JOURNAL2_WARRIORMONK_LEFT_10	Una delle ispirazioni principali per la religione di Ash - e in particolare i Selini come Bakal – è stato il cristianesimo orientale. Mentre scrivevo, iniziai a preoccuparmi che l'ispirazione fosse un po' troppo ovvia. Piuttosto che creare una religione che sembrasse un elemento organico del suo mondo, stavo cercando disperatamente di non scopiazzare in blocco un'intera religione del mondo reale in un universo immaginario.<N><N>Iniziai allora a cercare dei modi per far differire la filosofia ashiana dalle mie ispirazioni, pensare a come i suoi valori potessero evolversi in maniera unica, ecc. Una delle cose che immediatamente mi sono balzate in mente è stato il pacifismo. Il cristianesimo orientale, pur permettendo un certo grado di ineluttabile violenza, ha un accento incredibilmente pacifista. Al clero è tassativamente proibito uccidere per qualsiasi ragione – anche l'autodifesa (che fra l'altro è malvista tra i laici). I preti devono essere in grado di 
$ENTRY_JOURNAL2_WARRIORMONK_LEFT_1_00	 guerrieri, una gerarchia basata sulla casta che governa l'ordine sociale, un Immobile Motore di accezione marcatamente deista, i riti dell'acqua, ecc., ho iniziato a confidare che il Tempio di Ash stesse iniziando a diventare un'entità a sè stante, piuttosto che essere una semplice rielaborazione di una religione del mondo reale.
$ENTRY_JOURNAL2_WARRIORMONK_RIGHT_0_00	celebrare un <LQ>sacrificio senza sangue<RQ> durante la liturgia, il fulcro della vita religiosa (addirittura, se un uomo del clero è coinvolto in una morte accidentale - diciamo un incidente d'auto - non potrà mai più tornare in servizio).<N> Questo sembrava un elemento che non avrebbe necessariamente funzionato con la filosofia dei Selini che avevo creato fino ad allora. Data l'importanza attribuita al concetto di ordine nella religione di Ash, è lecito pensare che la violenza possa essere vista, in momenti di assoluta necessità, come un sacro dovere. A volte, un ingranaggio rotto deve essere rimosso prima che possa danneggiare il resto della macchina. E chi sarebbe più adatto a questo compito di un guerrierio Selini? Anche considerando la violenza come un rimedio estremo, i Selini non avrebbero remore ad imbracciare le armi, visto che a differenza del cristianesimo orientale la religione che ho creato non ha il <LQ>sacrificio senza sangue<RQ> come sua colonna portante.<N><N>Ed è così che abbiamo incluso i monaci guerrieri, che non compaiono nemmeno nel gioco, ma ehi, vengono menzionati qualche volta (i Selini hanno molti rami o capitoli, e solo alcuni di essi sono <LQ>case militanti<RQ>. Bakal fa parte di un capitolo molto più pacifista). Con i monaci
$ENTRY_JOURNAL2_WARRIORMONK_RIGHT_1_00	 
$ENTRY_JOURNAL2_WARRIORMONK_TITLE	 
$ENTRY_JOURNAL2_WOCOLAN_LEFT_00	La forza di Wocolan
$ENTRY_JOURNAL2_WOCOLAN_LEFT_10	La descrizione di <LQ>Wocolan che spacca la testa di un orso a mani nude<RQ> che decora quest'armatura pesante era un tentativo di alludere ad una più vasta mitologia quaidiana. <LQ>Al di sotto, i suoi figli Wastan e Wacella bevono il sangue grondante dalla bocca dell'orso, per sopravvivere all'estenuante marcia della loro famiglia verso l'esilio.<RQ> Non ci siamo mai spinti in ulteriori dettagli, ma la storia di Wocolan e dei suoi bambini fa parte della creazione della religione quaidiana, così come della formazione dell'impero. Durante il suo esilio, Wocolan viene scelto dalla Fiamma Cosmica e gli viene donata non solo la forza di sopravvivere al suo calvario, ma anche di diventare il patriarca fondatore di tutto il Quaid.<N><N>Ho cercato di renderlo particolarmente esotico, in modo da catturare l'impressione di autentica mitologia antica. Ogni volta che volete dare a qualcosa il sapore di <LQ>antica religione,<RQ> fate mangiare a un personaggio qualcosa di vagamente inquietante. (Oppure immagino che si possa fare tutto in stile "antico Egitto", ma questo avrebbe significato infrangere il limite PEGI-13 che ci eravamo imposti.)
$ENTRY_JOURNAL2_WOCOLAN_LEFT_1_00	 
$ENTRY_JOURNAL2_WOCOLAN_RIGHT_0_00	 
$ENTRY_JOURNAL2_WOCOLAN_RIGHT_1_00	 
$ENTRY_JOURNAL2_WOCOLAN_TITLE	 
$ENTRY_JOURNAL2_ZELEMIR_NAME_LEFT_00	Il nome di Zelemir
$ENTRY_JOURNAL2_ZELEMIR_NAME_LEFT_10	Ho scelto questo nome per due ragioni: 1) inizia con la Z, il che è magnifico, e 2) significa <LQ>Desiderio di pace<RQ> in slavo antico. Curiosamente, la parola per <LQ>pace<RQ> (<LQ>mir<RQ>) significa anche <LQ>mondo<RQ>. Un'interpretazione alternativa del suo nome sarebbe quindi <LQ>Desiderare il mondo<RQ>. L'ho trovata una dicotomia interessante e molto appropriata per il nostro combattuto antagonista.
$ENTRY_JOURNAL2_ZELEMIR_NAME_LEFT_1_00	 
$ENTRY_JOURNAL2_ZELEMIR_NAME_RIGHT_0_00	 
$ENTRY_JOURNAL2_ZELEMIR_NAME_RIGHT_1_00	 
$ENTRY_JOURNAL2_ZELEMIR_NAME_TITLE	 
$ENTRY_JOURNAL_AN_EDUCATION_LEFT_0_00	4º giorno - Educazione
$ENTRY_JOURNAL_AN_EDUCATION_LEFT_0_10	Quest'oggi, con la mente ancora in subbuglio per la nostra ultima vittoria, la mia attenzione è stata catturata da un pezzo di carta rimasto a terra. Ansiosa di rifornire le mie tristemente limitate scorte, ho recuperato la pagina abbandonata. Sono stata immediatamente colpita dalla sua qualità. Sebbene le pieghe e le smagliature mostravano l'usura del suo viaggio nella Valle, la sua consistenza ed il colore cremoso, immacolato, tradivano la ricchezza da cui aveva avuto origine. Quella non era carta comune da scrivano.<N><N>È stato allora che ho notato il sigillo del Signore Reggente. Avidamente, il mio sguardo è volato alla prima riga:
$ENTRY_JOURNAL_AN_EDUCATION_LEFT_0_20	<N><LQ>Tu, disgraziato vagabondo errante, a malapena degno di essere chiamato mio figlio,<RQ>
$ENTRY_JOURNAL_AN_EDUCATION_LEFT_0_30	Colta da quella che Zenimon il Saggio chiamava la <LQ>gioia derivante delle disgrazie altrui<RQ>, ho continuato a leggere con curiosità imbarazzante:
$ENTRY_JOURNAL_AN_EDUCATION_LEFT_0_40	<LQ>Non ci sono parole per esprimere la mia rabbia. Vashtal mi riferisce che, arrivato nelle terre dei Carcassiani, ha
$ENTRY_JOURNAL_AN_EDUCATION_RIGHT_0_00	scoperto che tu non stavi frequentando l'Università, come avevo disposto per il tuo bene e la tua sicurezza, ma ha invece trovato un sudicio nomade infedele, mascherato sotto tuo nome, che studiava in tua vece. Questo ripugnante barbaro ha rivelato di aver ricevuto una non indifferente somma di denaro per frequentare le lezioni al tuo posto, mentre tu, senza dubbio, andavi a zonzo per le terre selvagge in cerca di – <RQ>
$ENTRY_JOURNAL_AN_EDUCATION_RIGHT_0_10	Il resto del testo è per me un mistero, poichè, proprio nel punto in cui la narrazione si stava facendo particolarmente interessante, [berserker_hero] mi ha strappato la pagina di mano, l'ha appallotolata, e poi l'ha ingoiata urlandomi in faccia <LQ>Sa di menzogne! Menzogne e pecora morta! Ma soprattutto menzogne!<RQ>. Il suo alito lascia piuttosto a desiderare.<N><N>Ha poi tirato un sasso a [ranger_hero], e i due si sono lanciati in una gara di schiaffi che è durata una buona mezz'ora.
$ENTRY_JOURNAL_AN_EDUCATION_TITLE
$ENTRY_JOURNAL_ASSASSIN_LEFT_0_00	24º giorno - L'Assassino
$ENTRY_JOURNAL_ASSASSIN_LEFT_0_10	Ho fatto una strana scoperta oggi, nei singolari ed euforici momenti che sempre seguono una delle nostre più combattute vittorie. Stavamo rovistando fra i resti dei nostri nemici sconfitti, alla ricerca di qualcosa di recuperabile, quando mi sono imbattuta in un oggetto di natura molto particolare.<N><N> Assomigliava a una protezione lamellare, o ciò che ne è rimasto, con frammenti di un sottile gambesone che probabilmente una volta veniva indossato al di sotto di essa. Le piastre sono più piccole, e le loro connessioni più intricate che in qualunque equipaggiamento abbia mai visto nelle nostre armate o in quelle del Quaid. Il delicato profilo del suo disegno, così come la presenza di fibre incastrate tra i segmenti, mi portano a credere che venisse portato sotto il normale abbigliamento. Questo tentativo di segretezza mi suggerisce che l'armatura in questione fosse di origine civile, piuttosto che militare.<N><N>Il più grande mistero posto dall'oggetto è una lesione che, deprecabilmente, lo rende a noi inutilizzabile. C'è un buco, più largo di una mano, all'incirca all'altezza del cuore. 
$ENTRY_JOURNAL_ASSASSIN_LEFT_1_00	convertire un'armatura inutilizzabile in materiali commerciabili. Stavo per afferrare la manica del gambesone rimasta e strapparla via, quando [knight_hero] mi ha fermato la mano. Sempre stringendomi il polso, ha estratto il coltello e squarciato la cucitura del gambesone. All'interno vi era una fila di aghi appuntiti. Ha continuato a tagliare per la lunghezza della manica rivelando altri aghi nascosti. In totale, ce n'erano 32, ognuno di essi imbevuto di veleno e cucito nello strato esterno del tessuto ove si potrebbe afferrare il braccio di un attaccante.<N><N>Mentre [knight_hero] proseguiva con la dissezione, abbiamo scoperto una piccola tasca attaccata al polsino. All'interno c'era un pezzo arrotolato di pergamena. L'illustrazione non era diversa da quelle degli illuminati manoscritti con cui avevo a che fare nella grande Biblioteca di Ash, anche se di stile esotico. Nonostante danni significativi, l'immagine era ancora distinguibile: una donna snella seduta su un trono. Il suo viso era oscurato dai segni di bruciature, ma lunghi capelli bianchi le scendevano le spalle e si intrecciavano con i gioielli che teneva al collo. Ai suoi piedi sedevano due fanciulli, dalla pelle scura e gli occhi d'oro. La donna teneva le mani sul capo dei ragazzi. I loro capelli, come quelli della donna, erano bianchi.
$ENTRY_JOURNAL_ASSASSIN_RIGHT_0_00	Le piastre circostanti sono deformate e annerite come se vittime di incredibile forza e calore.<N><N>Tale distruzione non risulta nuova per me. L'ho vista innumerevoli volte sui corpi sconfitti dei revenant, quando ho usato i miei scarsi poteri per abbatterli con la forza del fulmine. Ma questa non è opera mia.<N><N>Ancora più preoccupante è il fatto che le piastre danneggiate sono piegate verso l'esterno, come se la terrificante pressione e il calore siano stati esercitati dall'interno dell'armatura.<N><N>Non posso fare a meno di chiedermi quale genere di persona avrà mai usato quest'equipaggiamento, e ancora, che cosa l'avrà uccisa in una maniera tanto bizzarra?<N><N>ADDENDUM:<N><N>Mentre scrivo queste parole mi ritrovo ancora a tremare, per gli eventi appena occorsi e la morte a cui sono sfuggita per un soffio.<N><N>Avevo iniziato a smontare la corazza che avevo precedentemente descritto, staccando le piastre metalliche dalla corda di seta che li univa, sperando di
$ENTRY_JOURNAL_ASSASSIN_RIGHT_1_00	I bordi del foglio erano frastagliati, come se fosse stato tagliato da una pagina molto più larga con un coltello. La parte posteriore era coperta da un assortimento di simboli di origine sconosciuta, meticolosamente tracciati con inchiostro nero.<N><N>[knight_hero], dal canto suo, ha cercato di minimizzare l'intero episodio. Gli aghi, dice, sono rimasti inutilizzati per così tanto tempo che certamente il loro veleno ha perso ogni efficacia. Mi ha assicurato di essere intervenuto solo per evitarmi un dito dolente. Così ha detto, ma nei suoi occhi ho scorto una preoccupazione che tradiva il suo umorismo.<N><N>Come abbia fatto ad anticipare l'esistenza di quegli aghi nel vestito dell'assassino è un segreto che non sono stata in grado di strappargli.
$ENTRY_JOURNAL_ASSASSIN_TITLE
$ENTRY_JOURNAL_BLACKROBES_LEFT_0_00	33º giorno - Le Toghe Nere
$ENTRY_JOURNAL_BLACKROBES_LEFT_0_10	[berserker_hero] ha iniziato a raccogliere le tuniche insanguinate dei cultisti per un qualche genere di progetto su cui preferisco rimanere all'oscuro. È strano vedere i volti celati dietro alle maschere, per quanto siano stati sfigurati dalla repentinea trasformazione in revenant. Molti di loro sono mutilati da ferite che, posso solo immaginare, sembrano essere autoinflitte. Nonostante questo, è ancora possibile vederli come gli uomini che erano. Una volta, forse, non sarebbero sembrati fuori posto in compagnia dei nomadi.<N><N>[mage_hero] è stranamente gioiosa di averli affrontati, come se combattere lo stesso nemico di suo nonno le avesse permesso di condividere la sua gloria di eroe. I cultisti, come mi ha spiegato, una volta erano la più grande minaccia per l'Impero Quaid. Uniti sotto il vessillo di un matriarcato centralizzato, questi folli costituivano un vero e proprio regno, lanciando invasioni su larga scala per saziare il loro infinito appetito di vittime sacrificali. Per generazioni i quaidiani sono a malapena riusciti a tenervi testa, e non fu sino ai tempi del nonno di [mage_hero] che l'Impero riuscì a lanciare una controffensiva. Le sue vittorie furono veloci e brutali; apparentemente, dopo
$ENTRY_JOURNAL_BLACKROBES_LEFT_1_00	[ranger_hero] rimane reticente sull'argomento. A parte i suoi iniziali, quasi frivoli, commenti dopo la battaglia, non ha detto nient'altro. Apparentemente, una cosa è celebrare la vittoria, e un'altra è assecondare la <LQ>sgradevole curiosità<RQ> di una forestiera. Forse la mia curiosità è insensibile. Quando crede di non essere osservata, ho notato [ranger_hero] toccare nervosamente l'idolo di volpe che porta al collo, scrutando nervosamente le sagome cadute dei nostri nuovi nemici.<N><N>Che i Geka, e con loro una giovane [ranger_hero], abbiano già avuto in passato delle macabre esperienze con questi pazzi, sembra quasi una certezza.<N><N>Per una volta, sono io a sentirmi rozza e inopportuna.
$ENTRY_JOURNAL_BLACKROBES_LEFT_1_10	Non riescho a fare a meno di ripensare alla preghiera segreta di [ranger_hero] per essere salvati da <LQ>coloro che si sono separati,<RQ> e il suo debito quasi suicida nei confronti dei figli di Krast.
$ENTRY_JOURNAL_BLACKROBES_RIGHT_0_00	 generazioni di successi, i cultisti caddero vittime della loro stessa degenerazione. La potente istituzione matriarcale lasciò il passo ad una disorganizzata classe dominante di sommi sacerdoti, ognuno più interessato al suo potere personale che al bene comune. Senza l'autorità centrale della <LQ>Regina dei Molti Diavoli<RQ> (come i quaidiani usavano chiamarla), i cultisti non furono in grado di organizzare una resistenza coesa, e caddero sotto la furia dell'offensiva del Quaid.<N><N>Fino agli anni della piaga, [mage_hero] e il suo popolo credettero sradicato il culto del sangue. Ora, nell'epoca del caos, sembra che questi pazzi abbiano fatto il loro ritorno, alimentati da un nuovo e oscuro potere. La tempistica non può essere una coincidenza. Eztli-Tenoch ha trovato i suoi servitori, uomini disposti a sacrificare la propria umanità per lui.<N><N>[ranger_hero] li ha chiamati le <LQ>tribù anatema,<RQ> il che, assieme al loro aspetto, mi porta a chiedermi se questi uomini non siano stati una volta dei nomadi come lei. Cosa possa averli persuasi a scegliere questa vita (o per lo meno la vita che hanno avuto) è una cosa che non riesco a immaginare.
$ENTRY_JOURNAL_BLACKROBES_RIGHT_1_00	Addendum – 33º notte
$ENTRY_JOURNAL_BLACKROBES_RIGHT_1_10	La mia mente viene attratta, ripetutamente, dalle parole che ho udito pronunciare ai cultisti, magie oscure in una lingua oscura. Sento una nauseante familiarità. Nel profondo della notte, non sono estranee alle mie labbra, quando la mia mente non è più mia.<N><N>Queste esternazioni macchiate di sangue non sono l'unica cosa di cui sento una segreta comprensione. Qui, sotto l'intenso splendore della luna crescente, vedo cose che non avrei potuto vedere alla luce del giorno. Conosco quelle tuniche nere, quelle maschere coperte di sangue, e le schiere di diavoli che le hanno indossate.<N><N>Li ho comandati nei miei sogni.
$ENTRY_JOURNAL_BLACKROBES_TITLE
$ENTRY_JOURNAL_BOOKKEEPING_LEFT_0_00	5º giorno - Contabilità
$ENTRY_JOURNAL_BOOKKEEPING_LEFT_0_10	Dopo aver liberato l'ultimo prigioniero dal patetico covo di Ozimal, devo confessare di aver avuto una certa soddisfazione nel razziare gli alloggi personali del disgraziato quarters. Le poche guardie rimaste erano fuggite nel vedere la nostra vittoria sui loro revenant addestrati, lasciando le stanze del piccolo tiranno pronte per il saccheggio. Abbiamo preso tutto ciò che potevamo dalla sua dispensa privata, appropriandoci di salsicce, olio, e una notevole quantità di formaggio per sostenerci durante il nostro viaggio. Avrei voluto dare fuoco al resto, ma temevo che il fumo avrebbe tradito la nostra posizione, e anticipato il ritorno del malfattore e del suo esercito. Come intuendo la mia frustrazione, [berserker_hero] si è occupato personalmente di <LQ>dissacrare<RQ> il rimanente cibo. È poi andato a dissacrare il letto, buona parte del pavimento ed alcune pareti. Non è stata un'impresa che una ragazza della mia posizione dovrebbe approvare, ma mi è difficile non sogghignare pensando alla spiacevole scoperta che aspetta Ozimal al suo ritorno.<N><N>[berserker_hero] dev'essere in grado di assumere una quantità d'acqua davvero prodigiosa.
$ENTRY_JOURNAL_BOOKKEEPING_LEFT_1_00	Per il nostro contatto ashiano – prova della morte del Capocarceriere.<N><N>Per il Filosofo Universitario – carni degli infetti preservata, teschi talismano, amuleti affini.<N><N>Per le Toghe Nere – sopravvisuti ashiani, meglio se appena arrivati.<N><N>Per i Carcassiani - ragazzo d'aspetto nomade, capelli bianchi, forse in viaggio con un compagno d'identico aspetto. Ne si desidera la morte. Si richiedono prove.<RQ>
$ENTRY_JOURNAL_BOOKKEEPING_LEFT_1_10	Vedere il mio stesso destino, che pur mi sembrava fantastico nonostante tutto il suo orrore, ridotto ad un singolo elemento in una lista di malefatte programmate, è un'esperienza che dà da pensare. Ritenevo la mia disgrazia una grande eccezione. Ora scopro che cose di questo genere sono solo ordinaria amministrazione per la ripugnante società di Ozimal.<N><N>Più di tutto, trovo melanconico il pensiero che molti di quei crimini sono stati perpetrati su richiesta di soggetti al di fuori della Valle. Che cosa avrà mai da offrire questo miserabile luogo al mondo esterno?
$ENTRY_JOURNAL_BOOKKEEPING_RIGHT_0_00	Purtroppo, la mia è stata un'effimera allegria. Sul leggio di Ozimal ho trovato (appena prima della <LQ>dissacrazione<RQ>) diversi frammenti di pergamena che probabilmente costituiscono la contabilità del suo vile impero. Rivedendole ora, vedo davanti a me, in maniera molto pragmatica, l'ammontare dei tributi imposti, le punizioni distribuite, gli schiavi rapiti – lui descrive vite umane come se non fossero altro che prosciutti affumicati con cui riempire la sua dispensa, e se stesso come un mercante affacendato.<N><N>Un manoscritto, in particolare, mi assilla la mente.
$ENTRY_JOURNAL_BOOKKEEPING_RIGHT_0_10	<N><LQ>Da procurarsi:<N><N>Per il Collezionista Rosso – sopravvissuti di aspetto e abilità inusuali.<N><N>Per i quaidiani - giovane donna quaidiana, capelli biondi, cicatrici sul volto, probabilmente con i Selini. Ne si desidera la morte. Si richiedono prove.<N><N>Per i venditori d'uomini – ragazze nomadi, attraenti. Prezzo più alto se molto giovani.
$ENTRY_JOURNAL_BOOKKEEPING_RIGHT_1_00	Sono tempi davvero cupi, quelli in cui gli uomini si avventurano all'inferno alla ricerca di nuovi mali.
$ENTRY_JOURNAL_BOOKKEEPING_TITLE
$ENTRY_JOURNAL_DREAM1A_LEFT_0_00	15º notte - Strane parole
$ENTRY_JOURNAL_DREAM1A_LEFT_0_10	A dispetto dei tumultuosi eventi della giornata, [ranger_hero] è rimasta la solita imperturbabile antipatica. Abbiamo consumato il nostro pasto e ci siamo ritirati nel piccolo alloggio che l'ospedale ci aveva fornito come se nulla fosse successo. O così mi è sembrato al momento. Sono stata svegliata in modo strano durante la notte. [ranger_hero] mi teneva la mano sulla bocca. <LQ>Stavi parlando,<RQ> mi ha spiegato, mentre tornava alla sua cuccetta. Le ho chiesto che cosa avessi detto, ma lei ha soltanto scosso la testa. <LQ>Non ho capito,<RQ> ha detto. I suoi occhi tradivano una paura che in lei non avevo mai visto prima. Dopo lunghi momenti, quando deve avermi creduto di nuovo addormentata, ha iniziato a sussurrare. Non riuscivo a capire molto dei suoi toni sommessi, ma una frase nomade mi è rimasta nelle orecchie. Significava grossomodo <LQ>Proteggimi da coloro che sono separati<RQ>.<N><N>Quando i sussurri sono cessati, e sono stata certa che fosse tornata a dormire, ho tirato fuori il mio diario e iniziato a scrivere questa voce alla luce del fuoco tremolante.
$ENTRY_JOURNAL_DREAM1A_RIGHT_0_00	Avevo solo una vaga impressione delle parole che le mie labbra hanno profferito inconsciamente – mezzi suoni, strani ed estranei. Mentre cercavo di ritornare con la mente a quello stato di pre risveglio, un ricordo improvviso mi ha colpito, non delle sillabe a cui ho dato voce, ma del significato che cercavano di comunicare.<N><N>Ho iniziato a scrivere febbrilmente, temendo che se mi fossi fermata a comprendere i miei pensieri, essi svanirebbero.<N><N>Ho finito la mia trascrizione, così com'è. Non so cosa pensare.
$ENTRY_JOURNAL_DREAM1A_RIGHT_0_10	Sono come una tempesta intrappolata<N><N>che si autocannibalizza<N><N>privata anche della morte<N><N>il dio dentro di me mi tormenta
$ENTRY_JOURNAL_DREAM1A_TITLE
$ENTRY_JOURNAL_DREAM4_LEFT_0_00	33º giorno: Il quarto sogno
$ENTRY_JOURNAL_DREAM4_LEFT_0_10	I sogni, o meglio il sogno, al singolare, che si estende fra mie notti in un'unica continua narrazione, giunge ora a me con maggior frequenza ed intensità. Ogni notte ho quasi paura di chiudere gli occhi; mi sembra che quand'è avvolta dal sonno, la mia mente non sia più mia.<N><N>Mi trovavo in un luogo desolato e buio. Il sole era tramontato e non tornava più. Ho pianto, implorando il cielo, ma nel mio cuore sapevo che il sole non avrebbe mai più brillato.<N><N>La grande folla intorno a me iniziò a lamentarsi e offrire doni, supplicando per ciò che non capivano. Ferivano se stessi e l'un l'altro, attaccando tutto ciò che gli stava intorno come se l'insensata distruzione potesse riportare indietro la luce che li aveva abbandonati. Nel buio, i loro occhi erano ciechi a tutto tranne che alla violenza. Esattamente come gli avevo insegnato.<N><N>Sono scappata dalla mia creazione. Le urla dei folli si estinguevano nell'oscurità dell'orizzonte.  Ho continuato a correre al buio, per
$ENTRY_JOURNAL_DREAM4_LEFT_1_00	il meglio che il suo regno di ragnatele ha da offrire. L'ho guardato e non ho provato niente. In quel momento il vuoto nel mio cuore era il più lieto sollievo – veder la mia vorticante, angosciosa tempesta nella mia mente sostituita dal vuoto… Era più di ciò che potessi sperare o meritare. Non sentire niente era la più dolce fantasia… ho abbracciato l'oblio.<N><N>Da quell'abbraccio ho avuto una gioia amara. Tirando indietro le mani ho visto che ognuna di loro conteneva una piccola fiamma.<N><N>Ho pianto di nuovo. Quale diritto di nascita è stato rubato, a queste mie piccole luci. Avrebbero dovuto essere stelle.<N><N>Presi i due pezzi del mio cuore, i bambini gemelli dai capelli e la pelle d'oro, come i miei, il colore della luce delle stelle. Li ho stretti al petto mentre chiamavano il padre che avrebbero dovuto avere, il padre che non hanno mai potuto conoscere. Ed eccoli qui, stranezze in un regno solitario, figli della fame.<N><N>L'oscurità continuava a crescere.
$ENTRY_JOURNAL_DREAM4_RIGHT_0_00	ciò che mi è parso un'eternità, aspettando che il tempo stesso finisse. Ma il tempo non finì. Traboccò nell'oscurità, stendendosi da orizzonte invisibile a orizzonte invisibile e su tutto ciò che vi stava in mezzo.<N><N>Non so dire quanto tempo trascorse in questo modo – ora che ci penso, mi meraviglio che una singola notte sia stata in grado di contenere ciò che avrebbe ecceduto diverse vite. Ho riempito l'infinito con il pensiero di ciò che avevo perso e ciò che avevo avuto – le mie lacrime erano veleno, la mia mente una degna vittima. Il freddo dell'oscurità congelò le lacrime sul mio corpo. Continuai a correre, ma non c'era via di fuga. Ciò da cui stavo fuggendo era me stessa.<N><N>Finalmente, dopo interminabili ere vidi -non posso chiamarla luce, poichè ciò lo paragonerebbe alla luce che avevo perduto. Era semplicemente una diminuzione dell'oscurità. Ma avevo speso così tanto tempo nel nero più intenso, privata di ogni sensazione eccetto la mia agoscia, che questa presenza sembrava una fuga. Mi girai e vidi davanti a me una piccola candela, misera e fioca, tremolante al freddo vento notturno. Sempre piangendo, mi sono avvicinata e ho guardato mentre cercava di avvisarmi.<N><N>Non era una candela, ma un uomo, piccolo e grigio. L'ho osservato mentre sistemava i ninnoli impolverati della sua corte,
$ENTRY_JOURNAL_DREAM4_RIGHT_1_00	Nel mio pianto, avevo spento la candela.<N><N>Mi sono svegliata, con le labbra che formavano parole che non sono in grado di riconoscere – nomi a cui non oso pensare oltre.
$ENTRY_JOURNAL_DREAM4_TITLE
$ENTRY_JOURNAL_DREAM4_TITLE
$ENTRY_JOURNAL_DREAM5_LEFT_0_00	34º giorno: Il quinto sogno
$ENTRY_JOURNAL_DREAM5_LEFT_0_10	Sembra che lo svegliarmi nel cuore della notte con strane parole sulle labbra e la mente piena di pensieri oscuri che non mi appartengono, sia ormai diventata un'occorrenza regolare.<N>Sono sgattaiolata oltre [ranger_hero], che dormiva tenendo in una mano il suo idolo di volpe, e nell'altra il manico del suo coltello, e febbrilmente la mia penna ha inciso la pergamena, insicura delle parole finchè non comparivano sulla pagina.
$ENTRY_JOURNAL_DREAM5_LEFT_0_20	<N>Quanto ho desiderato vederle<N>quelle luci che avrebbero dovuto essere mie<N>ignoranti del loro diritto di nascita<N>e penso<N>quanto splenderebbero d'oro<N>se solo potessero assaporare<N>la corruzione della mia divinità<N>eppure eppure eppure<N>la luce dentro di me sa<N>che sarei la loro rovina<N>come lo sono stato per te
$ENTRY_JOURNAL_DREAM5_TITLE
$ENTRY_JOURNAL_DREAM6_LEFT_0_00	35º giorno: Il sesto sogno
$ENTRY_JOURNAL_DREAM6_LEFT_0_10	Sembra che ogni notte il sonno cerchi di eludermi, ed i pochi scampoli che riesco a cogliere sono colmi dei pensieri e delle vite di altri. Altre parole senza voci, che si accaniscono sulla mia mente esausta.
$ENTRY_JOURNAL_DREAM6_LEFT_0_20	La voce di dio ha chiamato<N>e ti sei scrollata di dosso la polvere grigia<N>hai gettato via gli squallidi amuleti dei mortali<N>e sei corsa a me<N>tenendo tra le braccia una diade di redenzione<N><N>Se me l'avessi chiesto l'avrei dato<N>e messo fine al mondo<N>o a me stesso
$ENTRY_JOURNAL_DREAM6_LEFT_0_30	Chi parla tramite le mie labbra? Chi vive attraverso i miei sogni?<N><N>Mi pongo la domanda ma non desidero una risposta.
$ENTRY_JOURNAL_DREAM6_TITLE
$ENTRY_JOURNAL_DREAM7_LEFT_0_00	38º giorno - Il sogno di commiato
$ENTRY_JOURNAL_DREAM7_LEFT_0_10	<N>Mi è più facile dormire ora, dopo gli strani eventi occorsi nella sala del tesoro. Mi sono svegliata solo una volta, per ragioni tutt'altro che banali.<N><N>La notte era tiepida, e dormivamo con la tenda aperta. Mi sono svegliata trovando una luna piena che scintillava ardentemente attraverso l'apertura, con una luce così intensa che mi sono sentita riscaldare dalla sua presenza.<N><N>Quella vista ha suscitato in me una reazione che trovo difficile da descrivere. Ero al contempo euforica e addolorata. Nell'impeto del momento, ho iniziato a parlare.<N><N>Le strane ed estranee parole che mi sono venute alle labbra sono ormai sfuggite alla mia mente, ma il loro significato permane.
$ENTRY_JOURNAL_DREAM7_LEFT_0_20	<N>Sei venuta sei venuta sei venuta<N>con i segreti desideri del mio cuore infranto<N>ad eclissare la mia oscurità<N>o a liberarla
$ENTRY_JOURNAL_DREAM7_TITLE
$ENTRY_JOURNAL_EMPRESS_LEFT_0_00	32º giorno - L'Imperatrice
$ENTRY_JOURNAL_EMPRESS_LEFT_0_10	Confesso di avere qualche inquietudine riguardo al villaggio fantasma che ci siamo ritrovati a visitare. Nonostante le varie necessità di una compagnia come la nostra sono state soddisfatte dalla stessa varietà di mercanti e artigiani che è possibile trovare in ogni insediamento della Valle, la gente del posto sembra avere qualcosa di strano. Per la maggior parte si tratta di quaidiani, ed esprimono un tale quieto fervore che mi ritrovo segretamente a cercare delle possibili vie di fuga ogni qualvolta vengo interpellata da uno di loro.<N><N>[knight_hero], in particolar modo, sembra agitato. Ha parlato molto poco dei suoi giorni in guerra, ma mi accorgo che il loro modo di parlare e di vestire gli riporta alla mente delle brutte memorie. Non scherza più come suo solito, e passeggia avanti e indietro, giocherellando per tenere la mano lontana dall'elsa della sua spada.<N><N>Persino i cacciatori e gli altri mercenari che lavorano qui per quel poco che il villaggio riesce a pagargli sembrano diffidenti nei confronti dei loro protetti.
$ENTRY_JOURNAL_EMPRESS_LEFT_1_00	schiacciandosi l'un l'altro pur di farsi avanti e afferrarle il vestito. Ho visto un anziano piangere come un bambino mentre si rotolava nella polvere, stringendo al petto una ciocca di capelli d'oro.<N><N>Ho cercato di farmi strada fino a lei, ma la folla mi ha respinto. Per un fugace momento, i miei occhi hanno incrociato quelli di [mage_hero]. Contenevano uno sguardo di puro terrore come non ne avevo mai visto prima. Scomparve fra le avide mani della folla. Gli uomini tenevano in alto i brandelli che erano riusciti a strappare al suo mantello.<N><N>Stavo raccogliendo le forze per trascinarla via con me nel mondo di mezzo, quando un ordine scosse l'intera folla. La plebaglia si è azzittita. Molti di loro tremavano.<N><N>[mage_hero] era in cima al tetto di uno dei tuguri del villaggio. I suoi capelli ondeggiavano selvaggiamente al vento. I brandelli del suo mantello si gonfiavano come la vela di una nave da guerra. Un piccolo rivolo di sangue le scorreva giù per la fronte.
$ENTRY_JOURNAL_EMPRESS_RIGHT_0_00	Dappertutto si trovano grandi scorte di cristalli esplosivi. Nonostante queste numerose riserve, la popolazione quaidiana continua a scavare, ansiosa di alimentare una macchina bellica che non esiste più.<N><N>Tutto questo era già abbastanza inquietante, ma poi [mage_hero] è entrata nel villaggio.<N><N>La figlia della Fiamma Cosmica, ultima della stirpe reale. Dovunque andava, occhi bramosi la seguivano. In pochi istanti, l'intero villaggio si era silenziosamente raccolto, accalcato agli usci, famelico di ogni briciola di speranza che lei potesse dargli.<N><N>D'improvviso, un uomo si separò dal resto della folla. Era coperto di stracci, e la bava gli costellava l'incolta barba bionda. Con un verso che era per metà un grido e per metà una risata, si gettò ai piedi di lei, strisciando nel fango, e si aggrappò al lembo del suo mantello.<N><N>È stato come se avesse infranto una barriera invisibile. Tutti insieme, i paesani si sono avventati su [mage_hero],
$ENTRY_JOURNAL_EMPRESS_RIGHT_1_00	Con una voce più forte di quanto credevo possibile per il suo piccolo corpo, ruggì in lingua quaidiana. La gente si prostrò ai suoi piedi. Ebbi l'impressione che un intero esercito si fosse unito alle sue parole.
$ENTRY_JOURNAL_EMPRESS_RIGHT_1_10	<LQ>Io sono [mage_hero] Lan Laxmi! Sono la fiamma che si leva dalle ceneri!<RQ>
$ENTRY_JOURNAL_EMPRESS_RIGHT_1_20	Tuonò in lingua quaidiana, ashiana e nomade. La folla indietreggiò, prostrandosi, non osando voltare la schiena alla loro imperatrice. Lentamente, gli uomini si fecero avanti per lasciare ai suoi piedi dei doni, asce e coltelli, abiti artigianali, il meglio dei loro miseri averi. Il tutto è continuato fino al tramonto.<N><N>Le scorte di cristalli sono quasi raddoppiate dal nostro arrivo.
$ENTRY_JOURNAL_EMPRESS_TITLE
$ENTRY_JOURNAL_END	END
$ENTRY_JOURNAL_EPILOGUE_LEFT_3_00	Addendum
$ENTRY_JOURNAL_EPILOGUE_LEFT_3_10	Nei mesi successivi la nostra strana e travagliata vittoria, ho avuto un'unico sogno – un eco, immagino, degli oscuri poteri che una volta regnavano sulla mia mente assopita.<N><N> Ero coperta di polvere per il lungo viaggio, il mio piccolo corpo emaciato dalla terribile traversata.<N><N>Sono passata per i grandi cancelli blu della mia casa, per finire nell'abbraccio di qualcuno che mi assomigliava.<N><N>Sussurrai la terribile notizia all'orecchio di lui.<N><N>Mamma è tornata a casa.<N><N>Stringevo il suo cuore essiccato nella mia mano da bambina.
$ENTRY_JOURNAL_EVILINSIDE_LEFT_0_00	27º giorno - Il male interiore
$ENTRY_JOURNAL_EVILINSIDE_LEFT_0_10	Selinadt ha scritto nella sua Seconda Lettera a Re Vekalimon che <LQ>Quando gli uomini abbracciano il male che alberga nei loro cuori, non possono esserci vincitori<RQ>.<N><N> Vedersi rinfacciare i propri fallimenti è una lezione amara. Mi sono sempre creduta una vera e devota seguace di Selinadt (un orgoglio che ora vedo come un grave difetto.) Certamente, mi dicevo, qualcuno come me – versata nelle scritture fin dall'infanzia e frequentatrice assidua del Tempio – non può che considerarsi sulla retta via? Nonostante ciò, per tutta la mia vita ho segretamente coltivato l'illusione che il male fosse qualcosa di puramente esterno. Prima si è trattato del Quaid, artefice di tutto il dolore e la miseria che vidi nella mia infanzia. E mentre leggevo giornalmente sul male insito nel mio stesso cuore, mi dicevo segretamente che niente di tutto ciò poteva essere equiparato alla malvagità delle armate d'Oriente, assassini e predoni, uomini scesi al livello di animali. Le lacrime delle vedove, il pianto degli orfani, i lamenti dei feriti di guerra, il dolore della città tutt'intorno a me sono stati trasformati dalla mia mente egoistica in parole di conferma.
$ENTRY_JOURNAL_EVILINSIDE_LEFT_1_00	la verità è esattamente il contrario.<N><N>Voi ricorderete, senza dubbio, di quando il nemico arrivò alla città di Terna. Intenzionati a sottomettere il resto di Ash con il terrore, giurarono che non avrebbero avuto alcuna pietà dei difensori assediati. Nel giorno nero in cui la città cadde, la promessa venne mantenuta. Ma il nemico non si accontentò del massacro della guarnigione, e rivolse la sua furia sulla popolazione inerme, incuranti di età, condizione e sesso. Alla fine della giornata, trentamila uomini, donne, e bambini erano stati massacrati. Terna non era altro che cenere, popolata da una manciata di sopravvissuti appena sufficienti a lasciare testimonianza dell'orrore che vi occorse.<N>Per questa ragione ho ordinato che un prigioniero su dieci sia arso vivo. Finchè trentamila uomini non saranno spirati per mia mano, le immolazioni continueranno, sia per educare gli altri prigionieri che per il raggiungimento del giusto equilibrio. Questo è stato il mio solenne giuramento davanti all'oro della stessa Fontana, e nemmeno le minaccie di un ecclesiastico fuorviato mi impediranno di onorarlo.<N><N>–  Il Generale Keznimon Kalredos
$ENTRY_JOURNAL_EVILINSIDE_RIGHT_0_00	<LQ>Nessun male dentro di me,<RQ> dicevo in cuor mio, <LQ>può essere paragonato a questo<RQ>.<N><N>Anche nella mia attuale avventura, che pure ha contribuito a disilludermi da molti preconcetti, ho mantenuto questa sorta di fantasia sulla mia purezza. Non importa quali pensieri segreti ospitassi nel mio cuore, potevo puntare il dito verso Ozimal o Zelemir e dire <LQ>quello è il vero male<RQ>.<N><N>La via di Selinadt, come di consueto in maniera tortuosa, mi ha mostrato la grave follia delle mie convinzioni. Quaggiù nel ventre di questa città morta, stretta nella mano di quello che una volta era stato un cavaliere di Ash, ho trovato una pergamena. Nell'elegante calligrafia di un'abile mano vi si erano scritte le seguenti parole:
$ENTRY_JOURNAL_EVILINSIDE_RIGHT_0_10	<N>Mio carissimo Maestro Anziano,<N><N>In risposta alla vostra scomunica, vorrei mettere in luce che ho sempre e soltanto agito nel totale rispetto dei princìpi della nostra fede. Voi affermate che la decimazione dei prigionieri sotto la mia responsabilità viola la responsabilità della mia posizione ed il mio dovere verso l'Immobile Motore, ma vi assicuro che
$ENTRY_JOURNAL_EVILINSIDE_RIGHT_1_00	Conoscevo quest'uomo. Io... io inizio a intravedere, come schiarita da un fulmine, la grande oscurità che sta in agguato dentro ogni anima. Più di tutto, la scorgo nella mia. Come sarebbe facile abbandonarsi alla corruzione invece di combatterla. Ha questo dolce e familiare sapore, difficile da descrivere – ho forse convissuto così al lungo con l'odio da aver iniziato ad amarlo? Leggendo l'orrore della pagina davanti a me vedo il più ignobile dei peccati. Ma quanto dev'essere stato facile commetterlo. Quanto dev'essere dolce abbeverarsi a quella segreta fonte nel mio cuore, infliggere dolore e lutto, sentire la mia anima danzare nell'oscura gioia della vendetta. Penso a [mage_hero] che piangeva nella sua tenda – la mia crudeltà, inflitta dai miei modesti mezzi. Cosa avrei fatto con il vero potere?<N><N>Quando gli uomini abbracciano il male nel loro cuore, non possono esistere vincitori.
$ENTRY_JOURNAL_EVILINSIDE_TITLE
$ENTRY_JOURNAL_EVNI_LEFT_0_00	36º giorno - Evni
$ENTRY_JOURNAL_EVNI_LEFT_0_10	Contro ogni logica e buon senso, ho comprato a [berserker_hero] il suo <LQ>vero amore<RQ>. Non me lo perdonerò mai.<N><N>C'è da dire una cosa su [berserker_hero]: non è uno di quegli uomini capricciosi che, una volta ottenuto l'oggetto del loro desiderio, se ne stancano immediatamente.<N><N>Evni è diventata un membro a tutti gli effetti della nostra compagnia. <LQ>Lei<RQ> ha un posto riservato a tavola. E un posto a sedere nelle nostre riunioni. Ed una marea di opinioni, prontamente tradotte da [berserker_hero], che <LQ>parla fluentemente lo spadese<RQ>.<N><N>Ha anche – e giuro sulla memoria dei miei genitori che non me lo sto inventando – un letto tutto per sè e [berserker_hero] le rimbocca le coperte ogni notte, per poi – ripeto, non sto esagerando – cantarle rassicuranti ninnenanne (la decapitazione ne è uno dei temi più ricorrenti).<N><N>
$ENTRY_JOURNAL_EVNI_LEFT_1_00	Mi sono schiarita la gola e [ranger_hero] è schizzata in piedi. I suoi occhi erano sgranati come piatti d'argento. Il viso aveva raggiunto una tonalità purpurea che avrei creduto impossibile per qualunque creatura vivente.<N><N>Ha balbettato per un istante, e poi, incapace di trovare un insulto sufficientemente efficace con cui distrarmi, si è coperta la faccia col mantello ed è scappata.<N><N>Considero quel momento come una delle più grandi vittorie della mia vita.
$ENTRY_JOURNAL_EVNI_RIGHT_0_00	[ranger_hero], dal canto suo, è diventata più scontrosa del solito. Durante il nostro pasto di mezzogiorno, [berserker_hero] si è temporaneamente distratto nel cercare di acchiappare un insetto volante con i suoi <LQ>pettorali della morte<RQ>. [ranger_hero], seduta lì appresso e credendosi inosservata, ha allungato la mano e rovesciando la scodella di zuppa di [berserker_hero] sopra la spada. [berserker_hero] ha lanciato un lamento battendosi il petto (con cui era riuscito, nel frattempo, a schiacciare l'insetto), credendo di aver causato lui stesso la sventura di Evni con la sua goffagine. Ho incrociato lo sguardo di [ranger_hero] sostenendolo il tanto che bastava per farle intendere che la sua perfidia non è passata inosservata. Lei ha risposto mostrandomi i denti.<N><N>ADDENDUM:<N><N> Ho accidentalmente avuto modo di ottenere una strana vendetta, credo, più tardi nello stesso giorno. Evni riposava all'ombra mentre [berserker_hero] stava raccogliendo fiori con cui costruirle una pergola per il suo <LQ>sonnellino pomeridiano<RQ>. Mentre camminavo oltre, mi sono imbattuta in [ranger_hero]. Stava china sopra la spada. Nell'avvicinarmi, ho iniziato a capire le parole che le stava sussurrando sottovoce: <LQ>Tu non sei niente per lui. Finirà per dimenticarti. E quando tu sarai sparita io –<RQ>
$ENTRY_JOURNAL_EVNI_TITLE
$ENTRY_JOURNAL_FEARSOME_WORDS_LEFT_0_00	16º giorno – Parole terribili su labbra sfregiate
$ENTRY_JOURNAL_FEARSOME_WORDS_LEFT_0_10	Nel viaggiare con un'esponente della famiglia reale del Quaid ho trovato che, nel bene o nel male, la curiosità supera la mia naturale apprensione. [mage_hero], dal canto suo, è lieta di rispondere alla maggior parte delle mie domande. Queste vengono da me poste sempre con qualche trepidazione – non c'è modo di sapere quali domande verranno accolte da un sorriso fanciullesco e quali invece scateneranno il suo terrificante ardore.<N><N>I suoi stati d'animo sono molteplici e il passaggio dall'uno all'altro imprevedibile. Anche con diversi anni di pratica, dubito che sarei mai in grado di anticipare ciò che avviene dietro a quegli occhi color tempesta. Di tanto in tanto osservo il suo giovane viso, e la mia mente fatica ad associarlo alle litanie delle atrocità commesse dal suo popolo. Altre volte, posso leggere nella smorfia delle sue labbra sfregiate il fanatico desiderio di perpetuare quegli stessi orrori e anche più.<N><N>Nella confusione e nel panico che hanno preceduto la nostra ultima battaglia – mentre mi preparavo al salto verso il mondo di mezzo – la mia mente 
$ENTRY_JOURNAL_FEARSOME_WORDS_LEFT_1_00	Sul finire delle ultime parole stava letteralmente tremando. Lei ha compreso il mio sguardo e si è scusata timidamente, spiegando di essere stata di nuovo colta dalla <LQ>Sacra Furia<RQ>.<N><N> Continuo a ritornare con la mente all'immagine di lei in preda agli spasmi della <LQ>Sacra Furia,<RQ> parole terribili sulle sue labbra sfregiate. Cosa accadrà quando varcheremo la soglia di quelle rovine quaidiane? Stento a immaginare l'entità della tempesta che potrebbe risvegliarsi nella mente di [mage_hero], trovandosi a camminare sulle ossa del suo defunto Impero.
$ENTRY_JOURNAL_FEARSOME_WORDS_RIGHT_0_00	agitata è stata rapita da una singola, penetrante immagine. [mage_hero] stava con la testa piegata, le mani strette al suo bastone così intensamente da far risaltare le nocche sbiancate sul pallido avorio della sua carnagione. Teneva gli occhi chiusi con l'intensità di chi crede che attraverso la propria forza di volontà si possa far cessare di esistere il mondo esterno. Le sue labbra pronunciavano strane parole in lingua quaidiana, ripetendole e ripetendole fino a che il loro ritmo l'ha circondata come flutti tumultuosi. Stava tremando. La visione è durata solo una frazione di secondo, ma mi è sembrata uno scorcio d'eternità, come se quella strana, pallida ragazza fosse in grado di sussurrare la sua furia fino ai confini del mondo e oltre.<N><N>Dopo la battaglia, le ho chiesto che cosa avesse detto. Si è presa un momento, e poi ha tradotto le parole in lingua Ashiana con una fluenza sorprendente:
$ENTRY_JOURNAL_FEARSOME_WORDS_RIGHT_0_10	Guidami, o Fiamma!<N>Consumami, o Fiamma!<N>Rendi cenere il mio fragile cuore<N>E sostituiscilo col tuo volere!
$ENTRY_JOURNAL_FEARSOME_WORDS_TITLE
$ENTRY_JOURNAL_FEARSOME_WORDS_TITLE
$ENTRY_JOURNAL_GIBBERISH_LEFT_0_00	25º giorno - Vaneggiamenti
$ENTRY_JOURNAL_GIBBERISH_LEFT_0_10	Oggi sono stata svegliata da [knight_hero]. Ci eravamo fermati temporaneamente per consumare un pasto frugale ed io, affaticata dalla lunga marcia, mi sono sdraiata sotto al fresco arco di pietra che avevamo appena passato. Il sonno, con cui di recente ho avuto qualche problema, per una volta è arrivato facilmente, ma non dev'essere durato che pochi istanti. Ho aperto gli occhi trovando [knight_hero] dinanzi a me. Mi ha informato che dovevamo proseguire, e poi, incamminandosi per il passaggio, ha aggiunto che stavo farfugliando parole senza senso.<N><N>Sebbene per lui possano essere state senza senso, io ne percepivo ancora il significato rimasto incagliato ai margini della mia mente semisveglia. Ho sfoderato il mio diario, e con la fretta di chi non osa fermarsi a rileggere per timore di perdere il filo del discorso, ho annotato quel che ricordavo.
$ENTRY_JOURNAL_GIBBERISH_RIGHT_0_00	Com'eri bella com'eri bella com'eri bella<N>ed io ti ho rovinata<N>rendendoti come me<N><N>e ora e ora e ora<N>sono sia il prigioniero che il pazzo<N>che divora la sua mente<N>perchè non può divorare il mondo
$ENTRY_JOURNAL_GIBBERISH_TITLE
$ENTRY_JOURNAL_JOURNEYS_LEFT_0_00	9º giorno - In marcia
$ENTRY_JOURNAL_JOURNEYS_LEFT_0_10	Sto sviluppando una certa maestria nello scrivere e camminare contemporaneamente. Non vi è in effetti molto altro da fare mentre viaggiamo, se non ascoltare l'incessante blaterare dei miei compagni, o riflettere sul terrificante mistero del nemico che ci dà la caccia – entrambe attività da cui sono ben lieta di distrarmi. E quindi, eccomi qui a scrivere questo diario.<N><N>Non mi sono mai stata una viaggiatrice; ho trascorso tutti i miei 23 anni di vita nella capitale e nei suoi prossimi dintorni. Il mio fanciullesco desiderio di vedere il mondo è stato saziato dai libri e dalle parole scritte.<N><N>Nei momenti di ozio, in cui fantasticavo ad occhi aperti su come sarebbe stato viaggiare, ho sempre immaginato di visitare i nostri fratelli in Occidente. Come dev'essere interessante seguire i pellegrini del Tempio nel loro viaggio verso casa, uomini delle montagne scuri come nomadi, e gente del mare, dalla pelle ancora più scura, tutti accomunati dagli insegnamenti di Selinadt. Sette regni uniti dalla verità della Fontana.
$ENTRY_JOURNAL_JOURNEYS_RIGHT_0_00	Quando desideravo provare la paura e l'eccitazione dei territori pagani, mi bastava guardare la grande mappa dei viaggi di Kezmir Zentbar, appesa al muro settentrionale della biblioteca. Da lì, I miei bramosi occhi potevano viaggiare verso Nord, nel regno dei Carcassiani, di cui noi parliamo come se fossero un singolo popolo, ma in realtà sono suddivisi in così tante etnie e culture diverse da spingere Gozal il Saggio ad affermare che si prendessero a caso tre delle loro maggiori città stato, esse risulterebbero tanto diverse fra loro almeno quanto lo sono Ash, il Quaid, e i nomadi. E al di là di essi, i pagani dei pagani, i fantastici orrori delle coste inesplorate, e la grande montagna sulla quale Kezmir incise la leggenda <LQ>Qui vivono i divoratori della luna<RQ>.<N><N>Quale misero paragone è al confronto il mio viaggio, qui ai confini di Ash, dove tutto ciò che mi è familiare diventa sinistro e terribile.
$ENTRY_JOURNAL_JOURNEYS_TITLE
$ENTRY_JOURNAL_MANUSCRIPT_LEFT_0_00	11º giorno – Un manoscritto carcassiano
$ENTRY_JOURNAL_MANUSCRIPT_LEFT_0_10	<N>Liberato da ogni pericolo, il fiume antestante la Casa Capitolare di [healer_hero] ci ha regalato la sua abbondanza. ([berserker_hero], una volta finiti i revenant, ha dedicato il resto della giornata al selvaggio spopolamento dell'acqua dal resto dei suoi abitanti.) E mentre la mia pancia è stata molto piacevolmente riempita dal banchetto di pesci alla griglia che ne è derivato, è il corpo di uno dei revenant che occupa la mia mente.<N><N>Fra l'ignobile orda di mostri da cui abbiamo liberato il fiume, una carcassa in particolare si distingueva dalle altre. Una volta doveva essere stato un messaggero di non poca importanza, a giudicare dalla qualità del suo completo, e gli strani motivi ed il taglio del suo abito mi hanno indotto a pensare che con tutta probabilità proveniva da una delle tante città stato del lontano Nord. Mentre la maggior parte del suo equipaggiamento si è dimostrato troppo deteriorato dall'acqua per essere ancora utilizzabile, alla cintura portava una capsula impermeabile di cuoio cerato. Al suo interno, vi ho trovato un pezzo di pergamena ancora leggibile.
$ENTRY_JOURNAL_MANUSCRIPT_LEFT_1_00	letterale. La disposizione del testo che li circonda mi fa pensare che potrebbe trattarsi di un nome, forse l'autore del manoscritto, o forse il suo destinatario.<N><N>Questo è tutto ciò che sono stata in grado di scoprire per conto mio. Potrei domandare aiuto di [healer_hero], che a quanto ho sentito ha un certo livello di abilità in diversi linguaggi Carcassiani.<N><N>ADDENDUM:<N><N>[healer_hero] ha davvero l'abilità attribuitagli dai suoi compagni monaci. A dispetto della misteriosità del dialetto è stato in grado, in solo una manciata di secondi, di presentarmi la traduzione della prima frase del testo:<N><N><LQ>Torna da me, amore mio,<RQ> Ogni ulteriore passo in avanti ha richiesto notevolmente più tempo e la risultante interpretazione è ben lontana dall'essere completa, ma una strano scenario ha comunque iniziato ad emergere. La seconda frase, <LQ>e dai nostri figli in lacrime,<RQ> indica che la relazione tra lo scrittore e il destinatario era ben più profonda di una fugace avventura.
$ENTRY_JOURNAL_MANUSCRIPT_LEFT_2_00	nel cercare di far ritornare questa ribelle donna dai molti talismani. Se poi lei abbia ascoltato le suppliche di suo marito e dei suoi figli, o anche solo ricevuto il messaggio, questo è un mistero che dubito qualcuno riuscirà mai a risolvere.
$ENTRY_JOURNAL_MANUSCRIPT_RIGHT_0_00	Il suo contenuto convalida la mia teoria sulle origini dell'uomo. Il testo appare scritto in uno dei tanti linguaggi del Nord con cui sono purtroppo poco familiare (essendo specializzata in lingua Ashiana antica e moderna, e nei dialetti delle popolazioni locali, specialmente quelli dei nostri fratelli occidentali.)<N><N>È forse a causa di qualche grande difetto morale che la mia mente, circondata da così tanto sangue e dolore, gioisce ancora a questi enigmi. È un grande conforto per me, anche se altrettanto egoistico, tagliar fuori il cupo e sanguinoso mondo che è diventato la mia vita, e dedicare senza riserve le mie energie al decifrare qualche misterioso manoscritto. Se chiudo gli occhi, posso quasi sentirmi di nuovo nella Biblioteca.<N><N>Sono già riuscita, per conto mio, a tirarne fuori alcuni dettagli, nonostante la mia ignoranza della lingua. Ho trovato, ripetuto molte volte, ciò che sembra essere un gruppo di glifi presi in prestito dal linguaggio nomade (una lingua con cui, a rischio di sembrare immodesta, confesso di avere una certa dimestichezza). Si traducono grossomodo in <LQ>donna ingioiellata,<RQ> o <LQ>Regina<RQ> (come ho notato in alcuni testi), anche se forse <LQ>Donna dai Molti Simboli<RQ> dovrebbe essere più vicino al loro significato
$ENTRY_JOURNAL_MANUSCRIPT_RIGHT_1_00	Per [healer_hero] il linguaggio diventa sempre più difficile da qui in poi, e le poche parole che riesce a capire sembrano così insensate che inizio a dubitare della sua accuratezza. <LQ>Che voce ho per sfidare quella che senti ora?<RQ> è l'unica altra affermazione completa che [healer_hero] è in grado di produrre. Il resto del testo è un mistero che non riusciamo a penetrare, eccetto per una parola che [healer_hero] ritiene possa significare o <LQ>grigio<RQ> o <LQ>polvere,<RQ> diverse ripetizioni della frase <LQ>tu ritorni al sangue,<RQ> e numerosi usi del nome che ho precedentemente scoperto.<N><N>Sentendomi pronunciare il nome ad alta voce, [ranger_hero] ha corretto la mia interpretazione dei caratteri nomadi. Nel nordest (dove sembra che il manoscritto abbia avuto origine), la parola per <LQ>simbolo<RQ> ha delle connotazioni in qualche modo differenti. Secondo [ranger_hero], una traduzione più accurata della frase sarebbe <LQ>Donna dai Molti Talismani<RQ>. Le capacità magiche della donna, purtroppo, non mi hanno fornito nessuna ulteriore comprensione del testo. Tutto ciò che posso dire è che lei, per lo meno, deve aver stregato il cuore dell'autore del testo. A giudicare dalla vistosa ricchezza del suo messaggero, questo Re Carcassiano (immagino) non ha badato a spese
$ENTRY_JOURNAL_MANUSCRIPT_TITLE
$ENTRY_JOURNAL_MARKOSSTORY_LEFT_0_00	27º giorno - La storia di [knight_hero]
$ENTRY_JOURNAL_MARKOSSTORY_LEFT_0_10	<N>A Lady [mcguffin_hero] Livbar da [knight_hero] Kashantir, Cavaliere della Compagnia di Ash.<N><N>Mi avete domandato, tempo addietro, di come possa aver previsto il pericolo nascosto all'interno della strana armatura da voi trovata. Come avete correttamente intuito, ho avuto precedenti esperienze con un assassino similmente equipaggiato. Nonostante allora abbia respinto la vostra curiosità, ho avuto qualche giorno per riflettere sulla faccenda, e ho deciso di raccontarvi la mia esperienza.<N>Non è una storia che condivido di frequente, e neppure, se possibile, rievoco.<N><N>Erano tempi cupi. La piaga non sarebbe arrivata prima di altri due anni. In quei giorni, sembrava, niente poteva fermare la macchina bellica del Quaid. Le Province Orientali erano macchiate di rosso dal sangue della loro gente, e le incursioni avevano iniziato a spingersi persino nel cuore stesso di Ash.
$ENTRY_JOURNAL_MARKOSSTORY_LEFT_1_00	ad assoldare un pugno di mercenari. Trovò un uomo.<N><N>Avevo sentito parlare di quel genere di Carcassiani, assassini che hanno avuto origine da secoli di guerre fra le città stato settentrionali, uomini che apprezzavano di più l'omicidio che l'oro che gli veniva pagato per commetterlo. Li avevo sempre considerati soltanto racconti dei soldati.<N><N>Guardando quell'uomo, iniziai a chiedermi se non fossi in errore nel mio giudizio.<N><N>Per quanto potessi vedere non aveva peli né capelli, né sul viso, né sulla testa, né sul dorso delle mani o le sopracciglia. Non avevo mai visto un essere vivente così immobile. Non parlava, ma occasionalmente, senza motivo, rideva, e quando lo faceva i denti scoperti erano tutti neri come la notte. Gli uomini lo chiamavano il Bevitore d'ombre.<N><N>I nostri ordini erano semplici: portare il carcassiano al campo nemico, e fornirgli ogni supporto necessario allo svolgimento del suo incarico.<N><N>Il tempo era contro di noi. Una densa nebbia era discesa durante la notte, e ci siamo presto smarriti 
$ENTRY_JOURNAL_MARKOSSTORY_LEFT_2_00	davanti a noi. Sull'apertura era ricamato lo stemma imperiale del Quaid. La sua guardia era già morta.<N><N>Ancora tenendo il mio braccio, il carcassiano entrò nella tenda del generale, trascinandomi con lui. Il generale giaceva su una branda nel lato opposto, circondato da mappe e pergamene ed altri strumenti di comando. Anche se era disteso, potevo accorgermi che era un gigante di uomo, testa e spalle più alte di me, e altresì più larghe del magro carcassiano. Lasciandomi, il Beviombre sgattaiolò ai piedi del generale. Da qualche fodero invisibile produsse un piccolo coltello. Lo tenne sopra la sua testa per un momento, e mi sembrò che il tempo si fosse fermato. Con uno scatto improvviso, conficcò il pugnale nel quaidiano dormiente.<N><N>Il generale schizzò in piedi con un gemito. Con il pugnale ancora sporgente nelle sue costole, prese il carcassiano per le spalle e lo lanciò attraverso la tenda. Prendendo la sua spada lasciata vicino alla branda, il quaidiano colmò la distanza tra loro due in un sol balzo. Temendo per la vita del mio compagno, sfoderai la spada e mi preparai a colpire il gigante che avanzava. Ma il mio colpo venne tenuto a freno dallo strano suono della risata del carcassiano.
$ENTRY_JOURNAL_MARKOSSTORY_LEFT_3_00	Poi, con un sorriso quasi paterno, mi diede il suo coltello. Sul cuoio rovinato del manico erano incisi degli strani caratteri. Alzai lo sguardo, e lo vidi affiancato da altre quattro figure, vestiti e sorridenti allo stesso suo modo. Come una cosa sola, si mossero, indietreggiarono nella nebbia e scomparendo alla mia vista.<N><N>Il nostro comandante morì soffocato nel sonno diverse settimane dopo, e corse voce tra gli uomini che fosse stato il Beviombre, tornato a reclamare il suo pagamento.<N><N>Anni dopo, incontrai un altro soldato che aveva studiato alcuni dei linguaggi dei carcassiani. Gli mostrai il pugnale, e lui tradusse i caratteri per me. Dicevano <LQ>Ti auguro molte vite, ragazzo.<RQ>
$ENTRY_JOURNAL_MARKOSSTORY_RIGHT_0_00	Mio padre era morto. I miei fratelli erano morti. Essendo il maschio più anziano ancora in vita della casata Kashantir, mi feci avanti, per combattere. Ce n'erano molti come me, ragazzi di nobile nascita che avevano trascorso la loro intera vita ad allenarsi ma non avevano mai versato sangue umano. Sotto di noi c'erano ragazzi ancora più giovani: gente comune, ambulanti, figli di contadini appena arrivati dai campi, tutti chiamati a dare la vita per il regno di Ash.<N><N>Era un segno della disperazione del regno, suppongo, che un così delicato incarico fosse assegnato a noi.<N><N>Le spie ci avevano informato che un generale quaidiano si stava accampando con la sua avanguardia nelle vicinanze, il punto più avanzato in cui l'artiglio degli adoratori del fuoco aveva penetrato, proprio nel cuore di Ash. Le sue guardie erano poche, riferivano le spie, il momento per colpire era quello.<N><N>Il nostro comandante era impreparato a tale azione. La maggior parte delle sue truppe erano reclute inesperte, non più grandi di me, e gli ausiliari nomadi disertavano a ritmo costante. Non aveva riserve, nessun veterano su cui contare, e a malapena oro sufficiente
$ENTRY_JOURNAL_MARKOSSTORY_RIGHT_1_00	nell'oscurità precedente l'alba. Non volendo gridare, per non tradire la nostra posizione al nemico, il nostro piccolo gruppo si trovò presto separato. Con angoscia crescente, mi resi conto di essere solo nella nebbia.<N><N>Vagai per lungo tempo, incespicando come un cieco, nel terrore che ogni passo avrebbe potuto rivelarmi al nemico. Ad un certo punto mi imbattei in una sagoma nella nebbia. Era una guardia quaidiana, morta, coperta dal suo stesso sangue. Non aveva le palpebre.<N><N>Ero finito nel campo nemico, e non ero solo.<N><N>Davanti a me, inchinata tra due tende, c'era un'altra figura. Non potevo distinguerne i connotati, ma a giudicare dalla sua postura, ho dedotto che anche lui doveva essere un intruso. Strisciando verso la posizione dell'uomo, allungai la mano per sfiorargli la spalla e avvertirlo della mia presenza. Senza voltarsi, mi afferrò il braccio.<N><N>Facendomi un sogghigno talmente largo da far sembrare che la faccia gli si aprisse in due, il Beviombre mi indicò la tenda
$ENTRY_JOURNAL_MARKOSSTORY_RIGHT_2_00	Stava lì, disteso dove il generale l'aveva lanciato, i denti splendenti con grottesca allegria. L'atteggiamento del gigante era cambiato. La spada gli sfuggì dalle mani tremanti. Come una torre cadente egli rovinò a terra, il corpo enorme sconvolto dalle convulsioni.<N><N>Il carcassiano gli fu addosso con un grido inarticolato, mettendosi a cavalcioni sopra di lui mentre estraeva il suo coltello. Guardai impaurito mentre l'assassino tese entrambe le mani e iniziò a fare abluzioni con gli ultimi, flebili respiri del quaidiano, raccogliendoli e portandoli sopra la sua testa per poi versarli come se fossero acqua.<N><N>Quando i rantoli del generale sfociarono nel silenzio, il carcassiano terminò il suo rituale. Si girò e mi vide immobile, mentre ancora trattenevo il mio attacco. Mi fece un altro sogghigno e tirò il vestito scoprendosi la spalla, rivelando una fila di aghi, tutti colmi del veleno che aveva colto la vita della sua vittima.<N><N>Afferrandomi di nuovo il polso, mi guidò fuori dalla tenda, verso il bordo del campo. Si fermò un momento, accucciato nella nebbia e l'oscurità, lo sentii graffiare qualcosa.
$ENTRY_JOURNAL_MARKOSSTORY_TITLE
$ENTRY_JOURNAL_PEACE_LEFT_0_00	38º giorno - Pace?
$ENTRY_JOURNAL_PEACE_LEFT_0_10	Che strana ed esotica sensazione è il non essere più braccata dai nemici; l'unica cosa che ora ci spinge ad affrettare il passo é solamente il desiderio di raggiungere l'uscita.<N><N>Ed ora che anche l'ultimo nemico è caduto, io rimango l'unico essere mortale ad aver mai conosciuto il segreto del fuoco di drago. [mage_hero] mi guarda con una strana invidia. Lei porta la maledizione dell'inferno. Ora io, ai suoi occhi, ho ricevuto un dono del paradiso.<N><N> Concludo questa nota con una mesta constatazione:<N>Per la prima volta dalla genesi dei miei poteri, sono in grado di eseguire la popolare richiesta di <LQ>squagliare la faccia di qualcuno<RQ>.
$ENTRY_JOURNAL_PEACE_LEFT_0_20	<N><N><N>LA MIA FACCIA SI È SCIOLTA TANTI ANNI FA È PER QUESTO CHE MI SONO FATTO CRESCERE QUESTI ORRIBILI BAFFI PER NASCONDERE LA MIA VERGOGNA OVVIAMENTE IO SONO
$ENTRY_JOURNAL_PEACE_RIGHT_0_00	<N><N><N><N><N><N><N>Mancanza di nemici non significa necessariamente mancanza di violenza.
$ENTRY_JOURNAL_PEACE_RIGHT_0_00_A	[knight_hero_up] E LA FACCIA SOTTO I MIEI BAFFI SEMBRA UN SEDERE MA NON UN INCREDIBILE BASTIONE DI GLORIA E POTERE COME KHAN E KARISSA MA PIUTTOSTO UNA ROBA VECCHIA E MOLLICC_
$ENTRY_JOURNAL_PEACE_TITLE
$ENTRY_JOURNAL_SLEEP_AND_MADNESS_LEFT_0_00	30º giorno - Sonno e follia
$ENTRY_JOURNAL_SLEEP_AND_MADNESS_LEFT_0_10	Questa volta mi sono svegliata da sola, tale era l'intensità con cui parlavo nel sonno. Il suono delle parole è sfuggito alla mia mente, ma il loro significato permane, più strano e più forte di ogni esperienza precedente:
$ENTRY_JOURNAL_SLEEP_AND_MADNESS_LEFT_0_20	Eppure, eppure, eppure<N>nonostante il grande pegno cremisi<N>mi hai lasciato<N>cercando un'altra vita in un altro luogo<N>come se potessi smettere di essere dea<N><N>Io ero solo<N>ero sia il prigioniero che il pazzo<N>e tu la Regina della polvere<N>la Regina dei diavoli<N>che avrebbero potuto essere dei<N><N>O così credevo<N>mentre seduto mangiavo la mia mente
$ENTRY_JOURNAL_SLEEP_AND_MADNESS_TITLE
$ENTRY_JOURNAL_SPEECH_LEFT_0_00	23º giorno – Il discorso
$ENTRY_JOURNAL_SPEECH_LEFT_0_10	Quest'oggi, mentre assecondavo i capricci di una grassa, stupida, terrificante e fortunatamente analfabeta lucertola, mi sono imbattuta in una raccolta di pergamene. Molte erano invecchiate e ammuffite tanto da essere irriconoscibili, ma una era ancora leggibile. Sono rimasta di stucco nel riconoscervi il Discorso d'Insediamento del Signore Reggente:
$ENTRY_JOURNAL_SPEECH_LEFT_0_20	È con grande solennità e il più profondo cordoglio che mi accingo ad assumere il manto e l'autorità di Signore Reggente. Siamo un popolo due volte in lutto. Abbiamo appena iniziato a piangere il defunto Re Zenimal, che subito ci ha colpito la notizia della morte del Principe Ereditario Zelemir sul campo di battaglia.<N><N>Ma anche se la rotta è burrascosa e la destinazione ignota, vi assicuro, un nuovo giorno risplende all'orizzonte.<N>Vi chiedo di accettare la mia guida fino a quando il primogenito della Fontana, sangue degli Ashantimon, potrà prendere il comando e guidare il suo popolo alla pace.
$ENTRY_JOURNAL_SPEECH_RIGHT_0_00	Sembrano passate delle vite intere da quando mi trovavo nella capitale ad ascoltare quelle stesse parole dalla bocca del Signore Reggente in persona. Quale abisso mi separa da quella ragazzina che piangeva nella Piazza del Tempio, domandandosi come il sole avrebbe potuto sorgere ancora senza un re ad Ash.
$ENTRY_JOURNAL_SPEECH_TITLE
$ENTRY_JOURNAL_STAHP_LEFT_0_00	34º giorno - stai lontano dal mio diario
$ENTRY_JOURNAL_STAHP_LEFT_0_10	Mentre cammino in queste rovine recentemente riesumate, reliquie di un passato malignamente trascinato nel presente, non posso fare a meno di pensare a
$ENTRY_JOURNAL_STAHP_LEFT_0_20	L'INCREDIBILE SENSUALITÀ DEI MUSCOLI DI [berserker_hero_up].<N><N>KAHN E KARISSA RIEMPIONO LA MIA MENTE, IL LORO RITMICO ONDEGGIARE ASSILLA I MIEI SOGNI.<N><N>MI CREDEVO RAPITA DAI BAFFI DI [knight_hero_up], MA ORA MI ACCORGO CHE LA SUA DEBOLE, CORAZZATA FIGURA IMPALLIDISCE DAVANTI AI LUCCICANTI ADDOMINALI DI UN VERO UOMO.<N><N>STARE CON [berserker_hero_up] NELLA STESSA STANZA E ANNUSARE LA SUA VIRILE FRAGRANZA MI FA IMPAZZIRE.
$ENTRY_JOURNAL_STAHP_RIGHT_0_00	SI CHIAMA 'FEBBRE DA [berserker_hero_up]'.<N><N>NON ESISTE NESSUNA CURA.<N><N>INFATTI, OGNI NOTTE PENSO ALLE PENE DEL MIO TORMENTO E
$ENTRY_JOURNAL_STAHP_RIGHT_0_10	mi chedo come diamine ha fatto [berserker_hero] a diventare così bravo a scrivere così velocemente.<N><N>Mi chedo anche come farò a far tornare il mestolo alla sua forma originaria.
$ENTRY_JOURNAL_SUPERSHEEP_LEFT_0_00	24º Giorno - La morte di una superpecora
$ENTRY_JOURNAL_SUPERSHEEP_LEFT_0_10	L'Axxima Vatta Muttanaxxor giace sconfitta per mia mano.<N><N>Questa, stando alle gaie vanterie di [dragon_hero], è un'impresa che verrà ricordata per generazioni. Naturalmente, lei sembra anche credere di aver compiuto questa impresa tutta da sola e con una zampa dietro la schiena, quindi forse la sua opinione non è da prendere troppo sul serio.<N><N> Ammetto però di aver goduto dei festeggiamenti. Nel profondo delle viscere di una città morta, inseguiti da pazzi e da revenant, circondati dal caos, è bello avere un momento per apprezzare qualcosa, anche se si tratta di una festa ospitata da una lucertola troppo cresciuta con deliri di onnipotenza e l'abitudine di minacciarti di immolarti alla minima offesa. Com'è strano vederla giocare con i suoi cuccioli davanti al falò. Sembra felice, in mancanza di un vocabolo migliore, sempre che sia possibile attribuire ad un mostro questa emozione. Non avrei mai creduto che l'allegria di una tale creatura potesse essere contagiosa, ma mi ritrovo a iniziare a provare qualcosa di simile all'esuberanza della 
$ENTRY_JOURNAL_SUPERSHEEP_LEFT_1_00	la combinazione di temperatura e impulsi gravitazionali... è come se i fulmini fossero fatti di cuoio e fango –<N><N>Il mio stivale è vuoto. Bisognerà rimediare.<N><N>È successo di nuovo! Lo stivale con quella cosa non rimane lì quando lo bevi tutto… Dove se ne và? Perchè non rimane pieno? Perchè fa... Soluzione! Nuovo stivale.<N><N>Il quinto stivale è il più stivaloso di tutti gli stivali. I suoi stivali hanno stivali. Aspetto: stupendo. Sapore: al di là delle parole. Stanza: vorticante.<N><N>Ho appena mangiato un po' della pecora<N><N>Non l'ho nemmeno cotta sul fuoco<N><N>L'ho mangiata cruda e basta<N><N>Era squisita<N><N>È come se... va bene: basette.<N><N>Sono
$ENTRY_JOURNAL_SUPERSHEEP_RIGHT_0_00	 nostra ospite. Ho sconfitto una creatura leggendaria! Mi sono cibata della sua carne! Ho ingerito una quantità non indifferente di ciò che [berserker_hero] chiama <LQ>vino da stivale!<RQ><N><N>Per rispetto di coloro che tra i futuri lettori che potrebbero essere deboli di cuore, non starò qui a spiegare l'origine della denominazione di questa sostanza, ma dirò che sono al mio secondo stivale, e anche se il mio palato potrebbe non riprendersi mai dagli orrori subiti, la mia pancia è incredibilmente calda, ed il mondo esterno pulsa e ondeggia in una maniera molto gradevole.<N><N>L'ideatore di questa rara annata al momento se ne sta a quattro zampe, zampettando vicino alle fiamme con i nostri amici rettiliani e urlando <LQ>Questo è il mio ruggito di drago!<RQ> Non parlerò oltre del suono che è seguito, né dell'orifizio da cui ha avuto origine, ma sia il volume che la sua regolarità sono stati decisamente notevoli.<N><N>Al terzo stivale, ho trovato che la mie iniziali impressioni negative sulla creazione di [berserker_hero] sono state forse un po' troppo precipitose. Il sapore è un sistema di riferimento totalmente sbagliato per giudicare questa sostanza. L'aspetto, la viscosità, 
$ENTRY_JOURNAL_SUPERSHEEP_RIGHT_1_00	È strano voler?<N><N>voglio solo infilarmi nelle basette e rannicchiarmi e fare un sonnellino<N><N>come una piccola amaca<N><N>solo rannicchiarmi e<N><N>scommetto che ha un buon odore<N><N>è una cosa strana? potrebbe essere.<N><N>forse sto male... forse sto
$ENTRY_JOURNAL_SUPERSHEEP_RIGHT_1_10	25º mattina - Addendum
$ENTRY_JOURNAL_SUPERSHEEP_RIGHT_1_20	Mai più<N><N>Maipiùmaipiùmaipiùmaipiùmaipiùmaipiùmaipiùmaipiùmaipiùmai<N><N>Più.
$ENTRY_JOURNAL_SUPERSHEEP_TITLE
$ENTRY_JOURNAL_THE_FOX_LEFT_0_00	17º notte - La volpe
$ENTRY_JOURNAL_THE_FOX_LEFT_0_10	Quand'ero bambina, una volta trovai una volpe morente nei giardini circonstanti la Biblioteca Reale. Come abbia fatto una creatura così selvaggia a raggiungere il centro della città è per me rimasto un mistero, ma la sua presenza aveva spinto i tranquilli visitatori abituali ad abbandonare le proprie meditazioni e attaccare la bestiola con pietre e bastoni, trasformando i giardini in una sorta di armeria. Pesta e insanguinata, la volpe riuscì a trascinarsi in un'alcova per morire. Mi accorsi dei suoi sospiri agonizzanti dal vialetto in cui stavo camminando con mia madre. Schizzai via, intrufolandomi nell'entrata dell'alcova. Alla mia comparsa, la volpe si pietrificò. La sua bocca rossa cessò di guaire. Mi affrontò con un silenzio più carico di rabbia e dolore di quanto un ringhio di avvertimento avrebbe mai potuto esprimere. I suoi occhi continuarono a fissare i miei mentre mia madre mi trascinò indietro, sottraendomi a quella vista.<N><N>Mi sono ricordata di quel momento mentre siedo qui, attendendo invano un sonno che non arriva. Mi aspettavo quasi una tempesta da lei, ma [mage_hero] ha camminato per tutto il giorno nelle rovine di queste sale in totale distacco, apparentemente incurante dei segni della morte intorno a lei.
$ENTRY_JOURNAL_THE_FOX_LEFT_1_00	Forse volevo semplicemente veder soffrire una di loro dello stesso dolore che ci hanno inflitto così di sovente. Forse è stata la sua calma a irritarmi. O forse ero invidiosa della sua forza ed ho voluto incrinarla. Non saprei dirlo.<N><N>Qualunque fosse la ragione, ho preso il pezzo di pergamena e l'ho dato a [mage_hero]. È svanita nella sua tenda ritornando qualche tempo dopo con della cartapecora inchiostrata di fresco con la sua traduzione. Diceva:
$ENTRY_JOURNAL_THE_FOX_LEFT_1_10	<N>Questa, la nostra Grande Tomba...<N>...ultimo dei...<N>Gioiello del deserto.<N>Nessuno piangerà... il più grande...<N>Una storia penosa, causata... figli degli uomini...<N>Moriamo...<N>... una finalità che nemmeno l'onore...<N>... disgraziati...<N>Nessuna grandezza...<N>... ceneri dimenticate...<N>... penoso...<N>... malvagio...
$ENTRY_JOURNAL_THE_FOX_LEFT_2_00	ADDENDUM:<N><N>ANCH'IO HO UNA POESIA PER TE:
$ENTRY_JOURNAL_THE_FOX_LEFT_2_10	MUSCOLI...<N>... TROPPI PER CONTARLI...<N>SEXY... COSÌ SEXY...<N>KHAN... KARISSA...<N>BASTIONI DI GLORIA E POTERE.<N>UNA MERAVIGLIA FRUTTO DI...<N>GLI ADDOMINALI DI [berserker_hero_up]<N>QUANTA GRANDEZZA...<N>... GLUTEI IPNOTIZZANTI...<N>... POTENTI...<N>... SCINTILLANTI...<N><N>
$ENTRY_JOURNAL_THE_FOX_LEFT_2_20	LE PAROLE CHE MANCANO SONO DOVUTE AL FATTO CHE OGNI VOLTA CHE MOSTRO I MUSCOLI IL TESSUTO DELLA REALTÀ SI INFRANGE.
$ENTRY_JOURNAL_THE_FOX_RIGHT_0_00	Ho continuato ad attendere lo scoppio della tempesta, ma quando è arrivata, non è stato nel modo che avevo anticipato.<N><N>Mentre cercavo nelle sale e nei corridoi di queste rovine qualche indizio sulla nostra locazione, mi sono imbattuta in un piccolo frammento di pergamena, coperto di macchie di violenza e bruciature. Una buona metà del testo era distrutta – come se gli orrori della battaglia fossero stati così intensi che neanche le parole riuscirono a sfuggirgli. Ciò che ne rimaneva sembrava un Quaid elegante ma scritto frettolosamente. L'ho mostrato a [healer_hero], ma lui ha affermato che il testo non aveva alcuna pertinenza con la nostra missione. Sembrava impaziente di rimuoverlo dalla sua vista.<N><N>Non so perchè poi abbia fatto ciò che ho fatto.
$ENTRY_JOURNAL_THE_FOX_RIGHT_0_10	Il sogno mi ha lasciato insicura sulle mie stesse intenzioni.
$ENTRY_JOURNAL_THE_FOX_RIGHT_0_20	<N><N>Vorrei poter dire di essermi rivolta a lei spinta da un desiderio di amicizia, o anche solo per semplice curiosità, ma temo che le mie azioni siano nate dalla brama di avventarmi sull'unico bersaglio che avevo a disposizione per tutto il mio odio e le mie paure. Il Quaid è stato l'invisibile fonte di ogni angoscia per tutta la mia vita.
$ENTRY_JOURNAL_THE_FOX_RIGHT_1_00	Si trattava ovviamente delle parole di uno dei difensori quaidiani, condannato a morire nell'assedio. La sua eloquenza di fronte alla morte - invero, la morte di tutto ciò che conosceva – mi ha lasciata senza parole. Mentre restavo lì in piedi a riflettere su quei rovinati lamenti, sono rimasta sconcertata nell'accorgermi che la fine della pagina era bagnata di lacrime.<N><N>Ho aperto la tenda di [mage_hero] ma prima di poter parlare mi sono bloccata. Era raggomitolata sul lato opposto, il viso seminascosto da spente ciocche di capelli color paglia. I suoi occhi da volpe, arrossati da sofferenze che non potrò mai conoscere, hanno incontrato i miei. Era lo stesso silenzio di tanti anni fa, più pregno di dolore e rabbia di qualunque parola.<N><N>Sono subito andata via, ma l'immagine continua a tornarmi in mente. Questa volta, sono stata io a scagliare le pietre.
$ENTRY_JOURNAL_THE_FOX_TITLE
$ENTRY_JOURNAL_WRENNASTORY_LEFT_0_00	26º giorno – La storia di [mage_hero]
$ENTRY_JOURNAL_WRENNASTORY_LEFT_0_10	<N>Continuo a scoprire grandi divari tra il mondo che mi circonda, così com'è, e la sua variopinta interpretazione che risiede nella mia mente. Sembra che abbia trascorso la maggior parte della mia vita a giudicare non le cose in se stesse, ma le idee che mi sono creata di esse.<N><N>Stanotte, mentre sedevamo attorno al falò, [mage_hero] ha iniziato a raccontare una storia. Mi sono preparata, aspettandomi un tuffo nel triste e nel macabro: racconti di occasionali omicidi in tenera età, o manifestazioni di violento fanatismo.<N>Invece, ci ha narrato un aneddoto sulla sua sorellina più piccola.<N>Questa bambina, sette anni più giovane di [mage_hero], ne invidiava l'atleticità. E così grande era questo senso di inadeguatezza, che prese l'abitudine – nei momenti più inaspettati – di arrampicarsi sulla schiena di [mage_hero], in modo da assumere parassitariamente l'altezza e l'atleticità che desiderava tanto. [mage_hero] divenne presto abile a liberarsi dalla sua incomoda passeggera, con grande frustrazione della bambina.
$ENTRY_JOURNAL_WRENNASTORY_RIGHT_0_00	Tutto questo continuò per qualche tempo, con la piccina che continuava ad attaccarsi ripetutamente alla sorella, solo per ritrovarsi immediatamente spodestata. Un giorno [mage_hero] si svegliò trovando sua sorella appollaiata sulla testata del letto, laboriosamente intenta a cospargersi del contenuto di un vasetto di miele rubato, sperando, con quella colla improvvisata, di unirsi permanentemente alla sua designata cavalcatura.<N><N>[mage_hero] ha qui concluso la storia e mi ha guardata con un sogghigno pieno di aspettative. Ho impiegato qualche istante ad accorgermi che stava aspettando che io ridessi.<N>Che strana e inedita reazione è stata questa, per me. La [mage_hero] nella mia mente suscitava solo paura o pietà. E il suo profilo era solo o quello di una cupa e terribile condottiera, dotata di un umorismo macabro anche nei momenti migliori ed espresso da risate fanatiche, oppure quello di una fanciulla sofferente e traumatizzata, un oggetto impotente su cui riversare tutta la mia ipocrita pietà.<N>Quanto sono grandi i miei pregiudizi, che cercano di ridurre l'anima ad un semplice oggetto, la cui importanza è circoscritta al suo rapporto con me.
$ENTRY_JOURNAL_WRENNASTORY_TITLE
