flag	Content
$ENTRY_JOURNAL_INDEX_TITLE	目錄
$ENTRY_JOURNAL2_INDEX_TITLE	秘密
$ENTRY_JOURNAL_INDEX_LEFT_00	引言
$ENTRY_JOURNAL_INDEX_LEFT_10	第1天: @我在哪?@
$ENTRY_JOURNAL_INDEX_LEFT_20	第1夜: @[berserker_hero]@
$ENTRY_JOURNAL_INDEX_LEFT_30	第3天: @附錄@
$ENTRY_JOURNAL_INDEX_LEFT_40	第3夜: @附錄@
$ENTRY_JOURNAL_INDEX_LEFT_50	第3天: @監獄@
$ENTRY_JOURNAL_INDEX_LEFT_60	第4天: @中途世界@
$ENTRY_JOURNAL_INDEX_LEFT_61	第4天: @一個教訓@
$ENTRY_JOURNAL_INDEX_LEFT_62	第4天: @會計簿記@
$ENTRY_JOURNAL_INDEX_LEFT_70	第5天: @[ranger_hero]@
$ENTRY_JOURNAL_INDEX_LEFT_80	第8天 @附錄@
$ENTRY_JOURNAL_INDEX_LEFT_90	第7夜: @卡爾斯克大火@
$ENTRY_JOURNAL_INDEX_LEFT_100	第8天: @勒薩斯@
$ENTRY_JOURNAL_INDEX_LEFT_101	第9天: @旅程@
$ENTRY_JOURNAL_INDEX_LEFT_110	第10天: @[mcguffin_hero]@
$ENTRY_JOURNAL_INDEX_LEFT_120	第10天: @奧斯蒙之死@
$ENTRY_JOURNAL_INDEX_LEFT_130	第10夜: @修道院@
$ENTRY_JOURNAL_INDEX_LEFT_140	第11天: @[healer_hero]@
$ENTRY_JOURNAL_INDEX_LEFT_141	第11天: @卡革斯手稿@
$ENTRY_JOURNAL_INDEX_LEFT_150	第13天: @[mage_hero]@
$ENTRY_JOURNAL_INDEX_LEFT_160	第14天: @諾曼@
$ENTRY_JOURNAL_INDEX_LEFT_170	第15天: @奇怪的夢@
$ENTRY_JOURNAL_INDEX_LEFT_171	第15夜: @奇怪的字@
$ENTRY_JOURNAL_INDEX_RIGHT_01	第16天: @帶傷疤的嘴唇吐出可怕的字@
$ENTRY_JOURNAL_INDEX_RIGHT_00	第17天: @沙漠之寶@
$ENTRY_JOURNAL_INDEX_RIGHT_02	第17夜: @狐狸@
$ENTRY_JOURNAL_INDEX_RIGHT_10	第18天: @[knight_hero]@
$ENTRY_JOURNAL_INDEX_RIGHT_20	第19天: @來自[knight_hero]的信@
$ENTRY_JOURNAL_INDEX_RIGHT_30	第19夜: @我的回復: 草稿1@
$ENTRY_JOURNAL_INDEX_RIGHT_40	第20天: @[knight_hero_pos] 回復@
$ENTRY_JOURNAL_INDEX_RIGHT_50	第21天: @來自 <LQ>[knight_hero_up]<RQ>的信@
$ENTRY_JOURNAL_INDEX_RIGHT_60	第21夜: @請轉交: [berserker_hero]@
$ENTRY_JOURNAL_INDEX_RIGHT_70	第22夜: @[dragon_hero]@
$ENTRY_JOURNAL_INDEX_RIGHT_71	第23天: @演講@
$ENTRY_JOURNAL_INDEX_RIGHT_72	第24天: @刺客@
$ENTRY_JOURNAL_INDEX_RIGHT_73	第24天: @超級羊之死@
$ENTRY_JOURNAL_INDEX_RIGHT_80	第24天: @附錄@
$ENTRY_JOURNAL_INDEX_RIGHT_81	第25天: @胡言亂語@
$ENTRY_JOURNAL_INDEX_RIGHT_90	第25天: @第二個夢@
$ENTRY_JOURNAL_INDEX_RIGHT_91	第26天: @[mage_hero_pos] 故事@
$ENTRY_JOURNAL_INDEX_RIGHT_92	第27天: @心中的惡魔@
$ENTRY_JOURNAL_INDEX_RIGHT_93	第27天: @[knight_hero_pos] 故事@
$ENTRY_JOURNAL_INDEX_RIGHT_100	第28天: @身穿紅衣的人之死@
$ENTRY_JOURNAL_INDEX_RIGHT_110	第29天: @第三個夢@
$ENTRY_JOURNAL_INDEX_RIGHT_117	第30天: @睡夢與瘋狂@
$ENTRY_JOURNAL_INDEX_RIGHT_111	第32天: @女皇@
$ENTRY_JOURNAL_INDEX_RIGHT_112	第33天: @黑袍@
$ENTRY_JOURNAL_INDEX_RIGHT_113	第33天: @第四個夢@
$ENTRY_JOURNAL_INDEX_RIGHT_114	第34天: @離我的日記遠一點！@
$ENTRY_JOURNAL_INDEX_RIGHT_115	第34天: @第五個夢@
$ENTRY_JOURNAL_INDEX_RIGHT_116	第35天: @第六個夢@
$ENTRY_JOURNAL_INDEX_RIGHT_120	第35天: @以斯理的繼承人@
$ENTRY_JOURNAL_INDEX_RIGHT_121	第36天: @依芙麗@
$ENTRY_JOURNAL_INDEX_RIGHT_130	第37天: @泰都-米期理@
$ENTRY_JOURNAL_INDEX_RIGHT_131	第38天: @和平?@
$ENTRY_JOURNAL_INDEX_RIGHT_132	第38天: @分離之夢@
$ENTRY_JOURNAL_INDEX_RIGHT_140	第39天: @選擇@
$ENTRY_JOURNAL_INDEX_RIGHT_150	第40天: @跟隨舍裡米爾@
$ENTRY_JOURNAL_INDEX_RIGHT_160	@結語@
$ENTRY_JOURNAL_INDEX_RIGHT_170	@附錄@
$ENTRY_JOURNAL_INTRO_TITLE	
$ENTRY_JOURNAL_INTRO_LEFT_00	第1天 - 我在哪?
$ENTRY_JOURNAL_INTRO_LEFT_10	我可能是瘋了但是我無論如何也會嘗試記錄<N>在我面前發生的事。閱讀的人可以隨便下結論，<N>但我只會記錄我發熱腦袋所知道的所見所聞。<N><N>我確實知道我感染了正在我們美麗首都肆虐的瘟疫。<N>我也知道，就像先前的病人一樣，我被趕出城，<N>丟到墓坑中去。從那裡開始，一連串奇怪又恐怖的<N>事情發生，令我一直不知道是否還在夢中。<N><N>當高熱再次襲來，我發現自己身處黑暗中，<N>另一位病人站在我的眼前。
$ENTRY_JOURNAL_INTRO_RIGHT_00	<N><N>在華麗無雙的皇座上，一名我從未見過的男子站立在前，<N>他全身散發金光。我本以為他是一座雕像，直到他開口發佈命令。<N>他的聲音振聾發聵，我無法從世上的語言找到可比擬的，<N>即使是艾殊圖書館也沒有記錄。我匍匐地上，血液像野馬般奔騰。只要回想起來，<N>我的心像要衝破胸口向他奔去一樣！<N><N>-[mcguffin_hero] 利佛巴
$ENTRY_JOURNAL_SLAK_TITLE	
$ENTRY_JOURNAL_SLAK_LEFT_0_00	第1夜 - [berserker_hero]
$ENTRY_JOURNAL_SLAK_LEFT_0_10	當我決定寫有關[berserker_hero]的事時, 我發現我必須放棄<N>首都文縐縐的語言，改為用更生動的方言<N>來切合這個話題。<N><N>[berserker_hero]是個蠢貨！他是一個大笨蛋！<N><N>他的體臭彌補了智慧的部分。想想兩堆糞便交配然後生出腐敗不堪的孩子，然後他在[berserker_hero]毫無遮掩的<N>腋窩中賓士出來！<N>所以那些跟蹤我們的僵屍與他相比，簡直是有高級香水的味道！<N><N>但是 [berserker_hero]可不是空有其表，<N>他的性格可是無人可及的，我只能說他是<LQ>把褲子穿頭上的瘋子。<RQ><N><N>昨天他與砸到他腳趾的一顆石頭爭論了15分鐘，然後他輸了。
$ENTRY_JOURNAL_SLAK_RIGHT_0_00	說真的，有這樣的旅伴，夫複何求。
$ENTRY_JOURNAL_SLAK_RIGHT_0_10	第3天 - 附錄
$ENTRY_JOURNAL_SLAK_RIGHT_0_20	公平一點來說，我必須承認他是我見過最勇敢的人。<N>他身上的傷疤星羅密佈，即使我曾因為他拒絕穿任何衣服和護甲而鄙視過他一下。<N>我覺得底線是這樣的，他既是一個無法忍受的小丑，<N>也是一個出色的戰士！我非常高興他是我的隊友。
$ENTRY_JOURNAL_SLAK_RIGHT_0_30	啊～～我也愛你啊！麽麽的！<N><N><N><N><N><N><N>我不睡覺的！我不過是躺下來伸展一下我的屁股！
$ENTRY_JOURNAL_SLAK_RIGHT_0_40	噢！看起來這個人能讀也能寫。<N>到底這天殺的嗜血殺手在哪裡接受教育的？！<N><N>P.S. 如果你再嘗試偷我的日記，我就會在你睡著時拿石頭砸破你的腦袋！
$ENTRY_JOURNAL_SLAK_LEFT_1_00	第3夜- 附錄2
$ENTRY_JOURNAL_SLAK_LEFT_1_10	好的，純屬記錄， [berserker_hero]是裸睡的。<N>從今天起，所有報復的行動會在白天發生。<N><N>他的疤痕可不止在背上啊！<N><N><N><N><N><N><N><N>我討厭你！
$ENTRY_JOURNAL_SLAK_LEFT_1_20	<N><N>什麼！難道你認為可汗和卡麗斯不會吵架嗎？
$ENTRY_JOURNAL_PRISON_TITLE	
$ENTRY_JOURNAL_PRISON_LEFT_0_00	第3天- 監獄
$ENTRY_JOURNAL_PRISON_LEFT_0_10	三天前，我以為這個墓坑是一座監獄，但是我現在發現情況更糟糕了！<N><N>把我們囚禁於此的人名叫奧斯蒙‧卡茲，他是一個冷酷卑鄙的<N>可憐蟲！同胞發生如此扭曲的悲劇超越了我的理解範圍。<N>我以為只有奎德，這個在過去20年不斷折磨東部省份的民族會有這樣的德性。<N> 即使是最無情的諾曼族首領，也會比這傢伙的懂得<N>控制自己的嗜血欲望。<N><N>“收都“可怕的口音！這只怪物一直在神廟的陰影中生存！
$ENTRY_JOURNAL_PRISON_RIGHT_0_00	我和其他被囚於此的人一起，無分男女老幼，無分種族職業，<N>都在等候死亡的降臨。白天與黑夜都會傳來亡者的<N>呻吟聲，偶爾會傳來一陣震耳欲聾的喧鬧聲，<N>那是受害者垂死的尖叫。<N><N>現在我在這裡，對所有事都無能為力。如果我不過是<N>
$ENTRY_JOURNAL_PRISON_RIGHT_0_10	與這幫不幸的人在鬥獸場之中，他們或許有<N>垂死一搏的機會。即使花光所有決心，奧斯蒙似似乎也很猶豫是否要再次 <LQ>處決<RQ>我。<N> 或許他害怕失去更多的亡者吧，它們可不是很容易<N>就抓得到，也不容易保存。他這小小的王國還是需要<N>它們來維持的。
$ENTRY_JOURNAL_PRISON_LEFT_1_00	我神秘的僕人所說的話經常在我的腦海迴響。<N>奧斯蒙希望我可以向 一位<LQ>身穿紅衣的人<RQ>來展示能力。<N>他是誰呢？那個神秘的陌生人為什麼想要救我呢？<N>我到底有什麼重要呢？在這些所有問題的折騰中，<N>我領略到一件事：我是唯一用暴力對抗死亡之人。<N>但只要讓我可以對上奧斯蒙，這樣的規矩可得改！
$ENTRY_JOURNAL_HALFWAY_WORLD_TITLE	
$ENTRY_JOURNAL_HALFWAY_WORLD_LEFT_0_00	第4 天-中途世界
$ENTRY_JOURNAL_HALFWAY_WORLD_LEFT_0_10	<LQ>中途世界<RQ>是我用盡苦思出來的字眼才想出來的，
$ENTRY_JOURNAL_HALFWAY_WORLD_LEFT_0_20	用來描述這個我和其他人身處的世界。<N><N>有一次，當我還是很年輕的時候，我在卡浮的淺水處，差一點淹死。這個是我 唯一一次可與之相比的經歷。<N>同樣的驚恐，同樣的透不過氣，心好像要從胸口蹦出來一樣。<N>但是這次父親的手可不是要把我拖向安全之地呢。<N>沒有任何可以攀附的地方，只有死亡欲把人拖向死亡。<N><N>我如何來到這裡實在超越了我的認知，我只知道<N>當我需要來到時，我就能來到。我可以感受到我的同伴，不是靠眼睛，<N>而是好像感覺到自己四肢一樣。 我混身乏力，必須用盡<N>所有的力氣來移動他們。這股力量很微小，我就像<N>小嬰兒一樣笨拙地移動，但這足以救我了。即使<N>我總會抱怨前往中途世界的可怕經歷，但這總比<N>現實的命運來得好。
$ENTRY_JOURNAL_HALFWAY_WORLD_RIGHT_0_00	
$ENTRY_JOURNAL_AN_EDUCATION_TITLE	
$ENTRY_JOURNAL_AN_EDUCATION_LEFT_0_00	第4天 - 一個教訓
$ENTRY_JOURNAL_AN_EDUCATION_LEFT_0_10	今天，當我的思維還陶醉在上一次的勝利時，<N>我的眼睛不經意的看到了地上的卷軸。渴望補充我那少得可憐的物品，我撿起這東西，<N>我立即詫異於它的品質。它的邊緣與皺痕透露了它來到墓坑的旅程，<N>但是它乾乾淨淨，手感扎實，<N>奶油色的紙質暴露了它高貴的身份。這可不是管工的發薪草稿紙。<N><N>直到現在我才見到列根大人的印鑒。我的眼睛饑渴地瞄去第一行字：
$ENTRY_JOURNAL_AN_EDUCATION_LEFT_0_20	<LQ>你這成事不足又獐頭鼠目的流氓根本就不堪稱為我的兒子,<RQ>
$ENTRY_JOURNAL_AN_EDUCATION_LEFT_0_30	內心懷著大智者禪理滿所說的<LQ>“幸災樂禍”<RQ>，我制止不住我的好奇心，羞愧地讀下去：
$ENTRY_JOURNAL_AN_EDUCATION_LEFT_0_40	<LQ>我的憤怒筆墨不足以形容。華殊塔在到到達卡革斯之地時報告給我，他
$ENTRY_JOURNAL_AN_EDUCATION_RIGHT_0_00	發現你並未在大學就讀。<N>我曾命令你要好好學習，不要惹事，但他發現在大學中頂著你的名字學習的，<N>是一個髒兮兮諾曼人！<N>那個野蠻人透露他得到了一筆為數不少的錢，來代替你學習，<N>因為你要去，你以為我不知道！曠野裡找那該死的-<RQ>
$ENTRY_JOURNAL_AN_EDUCATION_RIGHT_0_10	其他的文字已經不能知道了，當我讀得正興起時，<N> [berserker_hero]從我手中一把搶過那張紙，揉成一團，<N>然後大口吞下，對著我尖叫著 <LQ>它嘗起了像謊言和死羊！<N>但大部分都是謊言的味道!<RQ> 他的口氣說有多臭就有多臭！
$ENTRY_JOURNAL_AN_EDUCATION_RIGHT_0_20	他接下來又向 [ranger_hero]丟石頭, 這兩個活寶互相扇巴掌扇了近半個小時。
$ENTRY_JOURNAL_BOOKKEEPING_TITLE	
$ENTRY_JOURNAL_BOOKKEEPING_LEFT_0_00	第5天 -  會計簿記
$ENTRY_JOURNAL_BOOKKEEPING_LEFT_0_10	自從將最後一個被囚的人由奧斯蒙可憐的洞穴中釋放出來後，<N>我必須承認我從掠奪那壞蛋的閣樓中獲得可恥的快感。<N>他的殘部自看見我們打敗他們訓練出來的亡者大軍後，<N>四散逃命，留下這個小暴君的房間任人魚肉。<N>我們從他的小廚房中大拿特拿，香腸，油和大量的起司，<N>讓我們在旅途上有足夠的糧食。<N>我原本想放火把餘下的東西都燒掉，但我怕濃煙會暴露我們的位置，<N>引來敵人的追擊。好像知道我的挫敗感一樣，[berserker_hero] 用自己的身體去 <LQ>褻瀆<RQ>餘下的食物。<N>他繼續去褻瀆那張床，地板還有牆。<N>這可不是我所認可的行為，但是一想到當奧斯蒙回來後<N>被這尿騷味嗆到的樣子，我的嘴角忍不住翹起了。<N><N>[berserker_hero] 肯定是水做的！
$ENTRY_JOURNAL_BOOKKEEPING_RIGHT_0_00	可悲的是，歡樂的時光特別短暫。在奧斯蒙的書桌上，<N>我發現 (就在 <LQ>褻瀆<RQ>事件以前)幾卷羊皮卷，記錄著他地下王國的開銷。<N>看過以後，我見到了實在的數字，被徵召的人， 施加的處罰， <N>還有奴隸的數量， 他寫這些人命時，<N>好像這些都是排在他的小廚房中的煙熏火腿一樣，他就像一個繁忙的商人。.<N><N>有一段記錄，吸引了我的目光。
$ENTRY_JOURNAL_BOOKKEEPING_RIGHT_0_10	<LQ>要採購：<N><N>紅衣收藏者- 有不尋常外表或能力的倖存者。<N><N>奎德人- 年輕的女人，奎德族，金髮，面上有疤，<N>帶著瑟連裡。最好是死的。要有證明。<N><N>人口販子- 諾曼少女，外表漂亮。<N>年輕的價錢會高一點。
$ENTRY_JOURNAL_BOOKKEEPING_LEFT_1_00	艾殊人-監獄長的死亡證明。<N><N>大學哲學家- 帶肉的，受感染的頭骨護身符，<N>保存狀況良好，與相關的符文石。<N><N>身穿黑袍的人-阿薩尼的倖存者，最好是新鮮的。<N><N>來自卡革斯的人- 男孩，諾曼族外表，<N>白色頭髮，如果自帶跟他一模一樣的人更好。希望是死的。要有證明。<RQ>
$ENTRY_JOURNAL_BOOKKEEPING_LEFT_1_10	為了看見自己的命運，在這個可苦中作樂的時間，<N>壞人名單中的一項，似乎是一個清醒的經歷。 我曾以為我的疼苦是一個特例，<N>但現在我發現不過是奧斯蒙惡劣企業的日常運作的一部分。<N><N>我覺得最可悲的是，這些罪惡<N>都是根據坑外各方的要求而進行的。<N>到底這個悲慘的地方可以為外邊的世界 帶來什麼呢?
$ENTRY_JOURNAL_BOOKKEEPING_RIGHT_1_00	當人要搜索地獄來找新魔鬼的時候，<N>這確實是個嚴峻的時刻。
$ENTRY_JOURNAL_KETTA_TITLE	
$ENTRY_JOURNAL_KETTA_LEFT_0_00	第五天 - [ranger_hero]
$ENTRY_JOURNAL_KETTA_LEFT_0_10	我認為我最喜歡 [ranger_hero]的地方是她聞起來像山羊。<N><N>我指這是一個艱難的決定，在所有的優秀性格相比下，<N>包括猖獗的不成熟，不斷貶低的評論，愚蠢的諷刺，<N>小偷的傾向和可怕的飲食習慣，當你要與一個人分享帳篷時，聞起來像山羊比起什麼都好。
$ENTRY_JOURNAL_KETTA_LEFT_0_20	有些夜晚，一陣風從男人那邊的帳篷吹過來，<N>夾雜著[berserker_hero] 腋下的汗臭味，這些混合的味道可難聞之極。<N>這些夜晚可是我有最好睡眠的夜晚，因為<N>對衝擊嗅覺的強烈味道，我的身體是選擇失去意識。
$ENTRY_JOURNAL_KETTA_RIGHT_0_00	第8天 - 附錄
$ENTRY_JOURNAL_KETTA_RIGHT_0_10	昨晚 [ranger_hero]用諾曼語尖叫著把我吵醒。剛開始時，我以為<N>她夢到我們最近目擊的一宗破壞（景像至今還是歷歷在目）。<N>不過當我用僅有的諾曼語來理解時，發現她的大叫意思是 <N><LQ>不知廉恥的女人，他是我的！<RQ><N>一邊大聲叫嚷的同時，她一把扯下我的頭髮，塞進<N>枕頭底下，然後再次入睡。<N><N>[ranger_hero] 一直感到不好意思，甚至想叫我綁馬尾來掩蓋<N>住我頭頂禿了的一塊。她說不知道夢中發生什麼事了，<N>不過我對此表示懷疑。
$ENTRY_JOURNAL_AZRA_BY_SLAK_TITLE	
$ENTRY_JOURNAL_AZRA_BY_SLAK_LEFT_0_00	第10天 - [mcguffin_hero] 是大混蛋！
$ENTRY_JOURNAL_AZRA_BY_SLAK_LEFT_0_10	所以你以為我不會你那些做作的語言，<N>我就不會發現你一直寫我嗎？<N><N>哼,混蛋！我們也會開始寫你的！<N><N>到底我應該如何寫 [mcguffin_hero_up]? <N>她的臉扁得像魚?還有她的脖子太太太長了！<N><N>她的耳朵就像幹掉的李子一樣！<N>她的頭髮又傻又亂！她的個人衛生也沒有她想的那麼好。
$ENTRY_JOURNAL_AZRA_BY_SLAK_RIGHT_0_00	現在怎樣了?混蛋! 我現在知道誰才是我真正的朋友！<N><N><N><N>真誠地說，<N><N>[ranger_hero_up] 喜歡吃粑粑！哎！
$ENTRY_JOURNAL_AZRA_BY_SLAK_RIGHT_0_10	[berserker_hero_up]為什麼我的名字那麼難寫？
$ENTRY_JOURNAL_KARSK_BURNED_TITLE	
$ENTRY_JOURNAL_KARSK_BURNED_LEFT_0_00	第7夜- 卡爾斯克大火
$ENTRY_JOURNAL_KARSK_BURNED_LEFT_0_10	我對死亡毫不陌生。在首都肆虐了9個月的瘟疫<N>將我所有對我個人地位的愚昧，都帶走了。<N>就算是神廟大閘外那場燒屍體的大火，<N>都無法與之相比。<N><N>我都無語了，<N><N>我大約知道了敵人的本性了。
$ENTRY_JOURNAL_LAKSOS_TITLE	
$ENTRY_JOURNAL_LAKSOS_LEFT_0_00	第8天 - 勒薩斯
$ENTRY_JOURNAL_LAKSOS_LEFT_0_10	我們在勒薩斯的時候見過一個古怪的儀式。一個新生兒<N>被帶到卡拉特的酋長面前，卡拉特是<N>目前依然存在的小部落。新生兒的父母<N>把嬰兒放在兩個木頭偶像面前。<N><N>酋長將一塊塊小木頭分別放在木像和嬰兒頭上，然後他<N>拿出一把小刀來雕塑那塊木頭，讓那些木屑掉落<N>在嬰兒的臉上。完成了他的活以後,他把<N>一個動物腱子放在嬰兒的脖子上。<N><N>在一聲宏亮的哭聲後，那些參加者開始唱歌跳舞，<N>用諾曼族露天慶典的方式來慶祝。我從未見到到底他雕刻了什麼呢。
$ENTRY_JOURNAL_LAKSOS_RIGHT_0_00	接下來，我問[ranger_hero]這個儀式的意義，然後她把掛在她脖子上的木狐狸給我看。她說她的靈魂是她部落大神的僕人，在<N>她出生時就成為她的守護神，然後在她死亡的時候隨她埋葬，<N>保護她可以順利到達天堂。據部落起源記載，我們的部落大神也是造物主派出的，<N>所以每個人出生時也會接受一個靈魂。<N><N>我問[ranger_hero]如果自己的雕塑不見了的話，會否對個人來了什麼可怕的結果，就像部落失去了他們的雕塑一樣。<N>她笑一笑後，把她從敵人身上取得的七個木偶像，解釋他們的靈魂會花上<N>很長的時間來尋找天堂。我問她這樣對她的人民<N>如此做是否會讓她不安，她困惑的看著我問，我那耳朵<N>會否對我的臉來說太大了，然後一邊唱著吃羊舌的歌<N>一邊走開。總有一天，我會拿石頭砸她的頭！
$ENTRY_JOURNAL_JOURNEYS_TITLE	
$ENTRY_JOURNAL_JOURNEYS_LEFT_0_00	第9天 -旅程
$ENTRY_JOURNAL_JOURNEYS_LEFT_0_10	我越來越熟練，邊走邊寫了。在旅途上，我們可以做的事很少，<N>除了聽我的同伴無休止的囉嗦，或是想像正在追殺我們的敵人可怕的秘辛，<N>這兩件事我都恨不得有人來分散我的注意力。<N>於是，這個日記是我作為旅行者的樸實記錄，<N>記錄了我23年來的時間在首都和周圍的小鎮的事，<N>也把我所有的幼稚想法都用字記錄下來。<N><N>那些發白日夢的閒暇時光中，我在想像旅程的精彩時，<N>我覺得我們都像西部的兄弟一樣。跟隨著廟宇的朝聖者回家，<N>來自山上的人，像諾曼人一樣黑， 還有來自海上的人，<N>全部都因為瑟連裡而聚集起來。七國都因為泉水的真相而聚合在一起。23年來的時間在首都和周圍的小鎮的事，<N>也把我所有的幼稚想法都用字記錄下來。<N><N>那些發白日夢的閒暇時光中，我在想像旅程的精彩時，<N>我覺得我們都像西部的兄弟一樣。跟隨著廟宇的朝聖者回家，<N>來自山上的人，像諾曼人一樣黑， 還有來自海上的人，<N>全部都因為瑟連裡而聚集起來。七國都因為泉水的真相而聚合在一起。
$ENTRY_JOURNAL_JOURNEYS_RIGHT_0_00	如果我要追求異教徒的恐懼和興奮，我只需要看看掛在圖書館<N>北面牆上的卡茲麥爾-贊巴的旅行大地圖，我的眼睛追隨至卡革斯王國，<N>作為一個多元文化之地，長老高賽爾曾說他們的城市中可以充分感受到<N>艾殊，奎德和諾曼的風情。除了這些以外，還有異教徒，不知名海岸的恐怖，<N>那連卡茲麥爾形容為傳奇的高山峻嶺， <LQ>那裡有食月者。<RQ><N><N>我的旅程與之相比，實在令人沮喪，在艾殊的門前，<N>一切熟悉的都變得可悲又可怕。
$ENTRY_JOURNAL_OZIMAL_DEAD_TITLE	
$ENTRY_JOURNAL_OZIMAL_DEAD_LEFT_0_00	第10天- 奧斯蒙之死
$ENTRY_JOURNAL_OZIMAL_DEAD_LEFT_0_10	我以為在知道奧斯蒙的死訊後，我會有一點安慰，但並非如我所想。<N><N>他不過是另一具眼神空洞的死屍，聽命我們敵人，在死亡之前作為一隻棋子。<N><N><N>這個世界從不缺邪惡與冷酷的人。在墓坑中的事，有誰會留意到呢？
$ENTRY_JOURNAL_MONASTERY_TITLE	
$ENTRY_JOURNAL_MONASTERY_LEFT_0_00	第10夜 - 修道院
$ENTRY_JOURNAL_MONASTERY_LEFT_0_10	我認為把墓坑跟家相比的話，是一件很愚蠢的事，但是<N>我看到瑟連裡的修道院後，還是有點震驚的。這是一個<N>宏偉的，不祥的結構，比寺廟更像堡壘。<N><N>我明白了這些預防措施的必要性，但是和我從小認識的寺廟<N>噴泉格格不入，那裡甚至守衛都需要攜帶鈍器，<N>免得他們在和諧的發源地播下混亂和破壞。<N>我與其他信徒一樣站在同一個地方，把手伸入泉水之中，<N>精神上一直連結到瑟連達本人，這是令我安心的事。<N>在這裡，我是一個謙卑的僕人，與國王和先知的分別只在於時間。<N> <N> <LQ>正如山谷上的水一樣，上升成霧，<N>落在山上成雪，進入河流沖向大海，<N>所以每個人的本質是一樣的，必須服務
$ENTRY_JOURNAL_MONASTERY_RIGHT_0_00	於他的時代與位置中的不同角色，為了讓神聖的機器和諧的發揮作用。<RQ><N><N>我不禁好奇到底在這個法律蕩然無存的可怕地方，<N>和諧與智慧實在離我們的希望很遠的地方，我的角色是什麼呢？<N><N>在這座堡壘廟宇之中，我覺得，我找到一點安慰。<N>難道這些僧人不是為他們存在的目的服務嗎？ <N>這些強大的牆壁和戰爭的防禦只不過是使瑟連達的精神<N>在這個無法無天的地方得到適應。<N> <N>正如偉人說的那樣，<LQ>事實依然是真相，不管它哪種語言書寫。<N><RQ><N>這些防禦只不過是墓坑的語言;內在的真相仍然是真的。
$ENTRY_JOURNAL_BAKAL_TITLE	
$ENTRY_JOURNAL_BAKAL_LEFT_0_00	第11天 - 長老 [healer_hero]
$ENTRY_JOURNAL_BAKAL_LEFT_0_10	牧師長老[healer_hero] 是這個混亂世界的理性綠洲。<N>縱然我們只在很短時間中有過少得可憐的交流，那些片言隻語<N>都對我的靈魂得到大大的提升。
$ENTRY_JOURNAL_BAKAL_LEFT_0_20	我希望我也可以為他提供同樣的感受吧。他似乎正被內心的痛苦<N>折磨著，我可以從他那僧侶般平靜的臉上可見他的煎熬。
$ENTRY_JOURNAL_BAKAL_LEFT_0_30	<N>很明顯，他曾是個士兵：那些傷疤，那風度和言行舉止，都是一個戰士才有的。 <N><N>我發現在寺廟中即使每個人都叫他做牧師長老，<N>但是他其實不是一個牧師。他既沒有權力，也沒有任何官方的位置，<N>但他的同僚都定期尋求他的意見，好像他就是領袖一樣。<N>亞伯特大公似乎不只是一個親近的門徒。
$ENTRY_JOURNAL_BAKAL_RIGHT_0_00	目前的冒險看起來對[healer_hero]起到激勵與鼓舞的作用,就像
$ENTRY_JOURNAL_BAKAL_RIGHT_0_10	他的靈魂近乎平衡的狀態一樣。我知道為什麼[ranger_hero] 會怕他, <N>因為在他眼中的決心就像追殺我們的人一樣。
$ENTRY_JOURNAL_BAKAL_RIGHT_0_20	<N>我只好祈禱[healer_hero]終有一天可以獲得平靜，就像他給到其他人一樣的。
$ENTRY_JOURNAL_MANUSCRIPT_TITLE	
$ENTRY_JOURNAL_MANUSCRIPT_LEFT_0_00	第11天 – 卡革斯卷軸
$ENTRY_JOURNAL_MANUSCRIPT_LEFT_0_10	<N>清理所有威脅後，[healer_hero_pos] 小房子外的河流產生了大量價值。
$ENTRY_JOURNAL_MANUSCRIPT_LEFT_0_20	([berserker_hero],在殺光那些往者後，<N>再剩下的一整天都野蠻地向其他居民潑水）。<N>享用過一頓烤魚大餐後，我心滿意足，我的腦海還是想著一個亡者的屍體。<N><N>在河裡清除的可怕東西之中，<N>有一具屍體比其他的讓我更在意。以他的衣服的品質來判斷，他曾經是一個重要的人，他的衣服的奇怪版型和剪裁讓我相信，<N>他在北方其中一個的國家舉足輕重。雖然其餘的裝備太爛了，沒有任何用處，<N>但他的腰帶上有一層防水物料。裡面，我發現一塊仍然清晰的羊皮紙。<N> <N>內容驗證了我對於人類起源的理論。文字似乎是其中一個
$ENTRY_JOURNAL_MANUSCRIPT_RIGHT_0_00	我完全不熟悉的北地語言 （我懂得艾殊語，無論是現代還是古文，<N>還有我們西部世界兄弟們的方言)
$ENTRY_JOURNAL_MANUSCRIPT_RIGHT_0_10	可能我心靈有巨大的道德缺陷，<N>被屠殺和悲傷包圍，依然對謎團著迷。這對我來說是莫大的安慰，<N>聽起來好像很自私， 
$ENTRY_JOURNAL_MANUSCRIPT_RIGHT_0_20	全心全意地致力於破譯一些神秘的手稿，<N>是我逃避黑暗和血腥的世界的方法。當我閉上雙眼，我幾乎感覺到自己就在圖書館內。
$ENTRY_JOURNAL_MANUSCRIPT_RIGHT_0_30	儘管我對這種語言的無知，我自己一個人已經能夠挑出幾個細節。<N>我看到，反復多次，似乎是從諾曼族借來的一組字形（一種古語，冒著你們說我誇大我的語言能力的風險，我承認我懂一點）。它大致翻譯成 <LQ>盛裝的女人,<RQ> 或是 <LQ>女王<RQ> (我見過有人這樣用), <N>又或是 <LQ>帶著很多符號的女人<RQ>，這會更接近字面意思。旁邊文字的排列
$ENTRY_JOURNAL_MANUSCRIPT_LEFT_1_00	令我懷疑諾曼借過來的文字可能是一個合適的名字，<N>可能他就是手稿的作者，或是手稿就是給他的。
$ENTRY_JOURNAL_MANUSCRIPT_LEFT_1_10	這就是我所發現的，我或許會叫上[healer_hero]來幫忙，<N>我從別人那裡得知他對於卡革斯語和方言非常精通。
$ENTRY_JOURNAL_MANUSCRIPT_LEFT_1_20	附錄:<N><N>[healer_hero]確實擁有僧侶所認可能力。
$ENTRY_JOURNAL_MANUSCRIPT_LEFT_1_30	儘管方言晦澀，他能在短短的時間內,向我發送文本的開頭的翻譯： <N><N><LQ>回到我身邊，我心愛的人,<RQ> 進步進展相當慢，結果解釋非常完整，但奇怪的情況已經開始出現。<N>第二行, <LQ>對於我們哭泣的孩子，<RQ> 表示作者和收件人之間的關係遠遠超過一個乾澀的戀情。
$ENTRY_JOURNAL_MANUSCRIPT_RIGHT_1_00	從這裡開始, [healer_hero]告訴那些文字明顯變得更難理解，有部分字眼就像胡言亂語一樣，讓他也懷疑自己的準確性。<LQ>我到底用什麼聲音才可以挑戰到你現在聽到的那一把呢？<RQ>是另一句[healer_hero] 可以翻譯好的。其餘的文字就像謎一樣，我們不能刺探透，好像一個字 [healer_hero]說可以解釋為<LQ>灰色<RQ> 或是 <LQ>灰塵,<RQ>同一句句子不斷重複 <LQ>你要回歸到血中,<RQ>  還有我早前發現的很多專屬名字。<N><N>當聽到我說出那個名字時，<N> [ranger_hero] 糾正我對諾曼文借字的認知。在東北部（這份手稿似乎是來自於此）,  <LQ>符號<RQ>一字其實有很多含義。<N>據 [ranger_hero]所說, 更準確的翻譯應該是 <LQ>一個有神秘魅力的女人。<RQ>這個女人有的魔法力量，很不幸，沒有給我對這些文字新的想法。<N>我只能保守的說她對作者的心下咒了。<N>評估了一下他的傳信人的財富，這個卡革斯王 (我猜的)不遺餘力地
$ENTRY_JOURNAL_MANUSCRIPT_LEFT_2_00	尋求他那神秘魅力的女人的回歸。<N>她是否注意到她丈夫和孩子的請求，甚至是否收到了這個資訊，這是一個謎。
$ENTRY_JOURNAL_WRENNA_TITLE	
$ENTRY_JOURNAL_WRENNA_LEFT_0_00	第13天- [mage_hero_fu]
$ENTRY_JOURNAL_WRENNA_LEFT_0_10	薄利蒙對奎德族的王族的描述並不誇張。<N>[mage_hero] 實在是 <LQ>比月亮蒼白，也比它遙遠。<N><RQ> 如果我需要模仿古語，我會補充<LQ>比水星遙遠<RQ> <N>我從來沒有見過任何人可以在這樣短的時間內，<N>經歷瘋狂的那麼多層次。就算是 [berserker_hero]，也是穩定地傻。<N> [mage_hero]是如怒海一樣，這一秒她好像非常邪惡，<N>下一秒她又像無可救藥的天真。她的行為經常給人一種很好玩的感覺，<N>但是我的懷疑得到確認，她會像小孩一樣不講理性，瘋狂得不像常人。<N><N>有時我覺得我能看透這個女孩的瘋狂其實很像我：恐懼，孤獨，<N>同時擁有可怕的能力。我不知道她是否這樣看待自己。
$ENTRY_JOURNAL_NOMADS_TITLE	
$ENTRY_JOURNAL_NOMADS_LEFT_0_00	第14天 - 諾曼族
$ENTRY_JOURNAL_NOMADS_LEFT_0_10	跟諾曼族接觸的第一手經驗非常有意思。這些原住民占<N>領了艾殊城市和奎德帝國之間的山谷峻嶺。在卡提門·薄利蒙的東方遠行之旅中，
$ENTRY_JOURNAL_NOMADS_LEFT_0_20	<N>有超過100個部落被 記錄下來， 但我相信經過戰火的洗禮，<N>留下來的已經不多。在墓坑中，我遇到來自27^個部落的人，<N>在外面世界生活的人的數量是不可估計的。
$ENTRY_JOURNAL_NOMADS_LEFT_0_30	就像名字所說，這些部落逐水草而居,在山嶺中飼養山羊和馬。<N>少部分生活習慣也帶來了墓坑，這種守衛永遠是必須品的地方。<N><N>^少於一半還是一個健存的部落。
$ENTRY_JOURNAL_NOMADS_RIGHT_0_00	健存的部落會像卡革斯一樣來建築村落，依賴山羊和簡單的農業來生活。 <N><N>離散的諾曼族（那些家園被破壞或是一直分散在外的）會在一些比較現代的都市，好像勒薩斯一類的，尋找棲身之所, <N>或是成為遊俠-傳達資訊，並守護墓坑村莊之間的貿易。
$ENTRY_JOURNAL_DREAM1_TITLE	
$ENTRY_JOURNAL_DREAM1_LEFT_0_00	第15天 -奇怪的夢
$ENTRY_JOURNAL_DREAM1_LEFT_0_10	已經有一段時間我沒有做夢了。 中途世界的可怕感覺似乎主宰了我的精神，<N>即使在睡眠中，我也只感到無所適從。然而，昨天晚上，自從我先前生病發燒以來，我第一次做夢了。<N> <N>這是一個非常激烈的夢想，我所看到的一切恐懼統統都驅走。<N>事實上，我23年來的所有經歷似乎都在消失。我站在一個高高的陽臺上。我不是我自己，我的胳膊是黑色和結實的，<N>覆蓋著奇怪的符號和金手鐲。我的衣服佈滿寶石，好像整個國家的財富都不足以做我衣服的下擺。
$ENTRY_JOURNAL_DREAM1_RIGHT_0_00	巨大而火紅的月亮低懸於空中，我幾乎可以伸出手指來觸碰它。<N> <N>一個聲音呼喚我，我轉身。在陽臺上有一個男人站在我旁邊。他很高，<N>比我見過的任何一個人都要高。他的頭髮和鬍鬚黑如午夜，長而且裝飾著金環。他的存在使世界變得朦朧和渺小。<N> <N>他用瑪瑙色的眼睛看著我，我明白我們是一個人。<N>我把火焰的月亮拖下來，把它分為兩半，我們一人一半。我顫抖著醒來，<N>我的手抓住我的胸口，好像我的心就是那那個紅色的月亮。我沉沒在巨大的渴望之中，<N>我哭了。在那個醒來的時刻，我會做任何事情來重返那個夢。
$ENTRY_JOURNAL_DREAM1A_TITLE	
$ENTRY_JOURNAL_DREAM1A_LEFT_0_00	第15夜 - 奇怪的文字
$ENTRY_JOURNAL_DREAM1A_LEFT_0_10	即使經過忙碌的一天，[ranger_hero] 依然保持著令人討厭和自我中心。
$ENTRY_JOURNAL_DREAM1A_LEFT_0_20	我們裝作什麼事都沒有發生，帶著晚餐回到醫院提供給我們的小房間。或許只有我當時是這樣想吧。 半夜時，我被人奇怪地弄醒了。 [ranger_hero] 用手蓋住我的口。
$ENTRY_JOURNAL_DREAM1A_LEFT_0_30	<N><LQ>你在說夢話,<RQ>她回到自己都位置時解釋 。<N>但當我問她我說了什麼時，她只是搖搖頭。<LQ>我並不明白，<RQ> 她補充道。
$ENTRY_JOURNAL_DREAM1A_LEFT_0_40	可是她眼中的恐懼背叛了她，這可是我從未見過的。<N>沉默良久，她相信我再一次睡著的時候，她開始喃喃自語。<N>我隱若聽到一點，但是只有一句諾曼語的句子我可以聽懂。那大約意思為 <LQ>從那些被逐之人中保護我。<RQ><N><N>當她停下時，我知道她睡著了，於是我拿出我的日記，就著微弱的燈火開始寫這一段記錄。
$ENTRY_JOURNAL_DREAM1A_RIGHT_0_00	我對於意識模糊時說出的字，那些短促，古怪又陌生的字，只有依稀的印象。<N>當我努力會想醒來前的狀態時，突然靈光一閃，不是記起那些音節，而是它們的意義。<N><N>我開始忘我地寫下來，因為我怕當我停止理解我的思想時，它們就會消失。<N><N>我完成了記錄後，我知道我不應該再想什麼。
$ENTRY_JOURNAL_DREAM1A_RIGHT_0_10	我是風暴<N><N>正被困住而備受折磨<N><N>死亡的權利也被剝奪h<N><N>我裡面的神劃傷了
$ENTRY_JOURNAL_FEARSOME_WORDS_TITLE	
$ENTRY_JOURNAL_FEARSOME_WORDS_LEFT_0_00	第16 天 – 帶傷疤的嘴唇吐出可怕的字
$ENTRY_JOURNAL_FEARSOME_WORDS_LEFT_0_10	與奎德王族上路時，我無法制止自動的好奇心，無論<N>是好還是壞，我都想知道。對於[mage_hero] 來說，她也樂意解答我的問題。
$ENTRY_JOURNAL_FEARSOME_WORDS_LEFT_0_20	不過我總是戰戰兢兢，因為你無法得知到底<N>哪一個問題會讓她嫣然一笑，哪一個會讓她雷霆震怒。
$ENTRY_JOURNAL_FEARSOME_WORDS_LEFT_0_30	她的情緒就像浪潮一樣起伏不定，<N>即使我花上多年時間也無法自信預估灰色眼眸中的情緒。
$ENTRY_JOURNAL_FEARSOME_WORDS_LEFT_0_40	有時候，我看著她年輕的面容，<N>就會掙扎想起她的民族殘酷的所作所為。
$ENTRY_JOURNAL_FEARSOME_WORDS_LEFT_0_50	其他時間我可以從她帶著傷疤的嘴唇，感受到那股屠殺的狂熱。<N>就在我們上一場戰役的混亂與恐懼中，我抱住自己進入了中途
$ENTRY_JOURNAL_FEARSOME_WORDS_RIGHT_0_00	世界-我淩亂的思緒被一個扎眼的畫面震撼，[mage_hero]
$ENTRY_JOURNAL_FEARSOME_WORDS_RIGHT_0_10	微微垂下頭，<N>雙手緊緊抓住一個下屬，發白的指關節顯得她的皮膚更為雪白。
$ENTRY_JOURNAL_FEARSOME_WORDS_RIGHT_0_20	<N>她緊閉雙眼，好想依靠意志力把外面的世界拒諸門外。<N>她的嘴唇一遍又一遍地吐出了奇怪的奎德語，節奏就像動盪的洪水一樣，<N>她在抖震。在我看到她的一小段時間，似乎是一瞥永恆，<N>就好像這個奇怪的蒼白的女孩會站起來，將自己的憤怒向末日傾吐。
$ENTRY_JOURNAL_FEARSOME_WORDS_RIGHT_0_30	<N><N><N><N><N><N>戰鬥過後，我問她在說什麼，她用了一些時間，將那些字翻譯為艾殊語：
$ENTRY_JOURNAL_FEARSOME_WORDS_RIGHT_0_40	<N><N><N><N><N><N><N>火焰啊！<N>火焰燃燒我！ <N>燒盡我渺小的心！ <N>用你的意志來取代吧！
$ENTRY_JOURNAL_FEARSOME_WORDS_LEFT_1_00	當她吐出了最後一個字，她在顫抖，她見到我直直地看著她那搖晃的火焰，<N>弱弱地道歉，解釋道<LQ> <RQ>剛剛神聖之怒在她身上發生。<N><N>她在<LQ>神聖之怒<RQ>的痛苦中顫抖著身體，<N>這深深印在我的腦海中……<RQ>那帶傷疤的嘴唇，呢喃著可怕的話。當我們進入這些奎德廢墟時<N>會發生什麼事呢？我不敢想像[mage_hero_pos] 穿過她那已經不復存在的帝國時，<N>內心會翻起怎麼樣的風暴。
$ENTRY_JOURNAL_FEARSOME_WORDS_TITLE	
$ENTRY_JOURNAL_DESERT_FORTRESS_TITLE	
$ENTRY_JOURNAL_DESERT_FORTRESS_LEFT_0_00	第17天: 沙漠之寶
$ENTRY_JOURNAL_DESERT_FORTRESS_LEFT_0_10	我曾經常常會想像我們最大敵人的家園，在遙遠的東方是什麼的樣子。<N>這戰爭似乎對首都來說是種無形的恐怖，只有透過日常的傷亡報導，與許多殘障退伍軍人在街上乞討的哀悼聲中傳達。<N> <N><N>即使生活在無形的恐懼中，實際看到奎德市的景象是一種奇怪的經歷。<N>我被設計的美麗和聰明才智所震撼，但更令我震驚的是，我對它的熟悉。<N><N> 我看到了所有標誌著城市生活的細節：用細碎鵝卵石鋪成的路，被年輕人惡作劇破壞的紀念碑，市場攤位就像其他城市一樣。
$ENTRY_JOURNAL_DESERT_FORTRESS_RIGHT_0_00	我幾乎可以看到我的父親坐在街角，<N>與這個城市的其他老人一起，笑著，詛咒著和閒聊著。<N><N>但是這個地方的人民卻破壞了泰爾納，殺死了<N>所有居民，每一個男人，女人和孩子。
$ENTRY_JOURNAL_THE_FOX_TITLE	
$ENTRY_JOURNAL_THE_FOX_LEFT_0_00	第17夜: @狐狸@
$ENTRY_JOURNAL_THE_FOX_LEFT_0_10	當我還是個小孩時，我曾在皇家圖書館附近的花園發現一隻垂死的狐狸。<N>到底這只野生動物如何來的城市的中心仍是個謎團，但是他的出現令那些本來還在昏昏欲睡的<N>守衛犧牲了冥想時間，紛紛拿起石頭和樹枝來攻擊這可憐的小動物。<N>他們的憤怒將花園變成戰場。渾身浴血，狐狸已經把自己拖入一個壁龕裡去靜靜等待死亡。<N>我與媽媽經過時，聽到微小的呼吸聲。我跳了出來，<N>悄悄滑進了壁龕的門口。狐狸看見我的出現時，時間好像凍住了。<N><N>他遇上我時，那沉默比任何警告咆哮都有更多的痛苦和憤怒。<N>他定定地看著我，直至我的媽媽把我拉回去，直至我看不到他為止。<N><N><N>當我等待著入睡時，我的腦海不時浮現這一幕。<N>我早就預備好迎接一場暴風雨，但是[mage_hero] 一整天都在這些廢墟中游走，看起來<N>並未有受身邊這些死亡的蹤影所影響。
$ENTRY_JOURNAL_THE_FOX_RIGHT_0_00	我一直等待風暴的爆發，但當它真正降臨時，卻非我所預料的。<N><N>那時，我正在搜索廢墟中的大廳和隧道，想想我們身在何方，<N>我踢到灰燼瓦礫蓋住的一小卷羊皮紙。當中大約有一半的文字都被破壞了，<N>好像那場戰爭的威力強大到連文字都不能躲開。<N>留下來的文字以奎德語草草書寫，但也顯得優雅。我拿給[healer_hero]看，<N>但他說餘下的文字跟我們的任務毫無關聯。他好像很努力<N>把他的目光從上面移開。 <N><N>我並不知道我為什麼做了，或是我做了什麼。
$ENTRY_JOURNAL_THE_FOX_RIGHT_0_10	我的夢令我不再明白我自己的動機。
$ENTRY_JOURNAL_THE_FOX_RIGHT_0_20	為了跟她交朋友，或是出於無聊的好奇心，我想跟她說話，<N>但是我怕我的行動會帶著不良的動機，為了傷害我害怕與憎恨的唯一物件。<N>我的一生中，奎德一直都是疼苦的無形根源。或許，<N>我只是想要看看一個人承受一下，那些施加於我們身上的苦楚。<N>或是她的平靜刺痛了我。又或者，我嫉妒她的堅強與
$ENTRY_JOURNAL_THE_FOX_LEFT_1_00	想撕開她的面具。我不知道。<N><N>無論是何原因，我拿了那片羊皮紙，給了[mage_hero]。<N>她消失在她的帳篷中，一會兒後出來時，帶著一片新羊皮，<N>上面有翻譯。它寫道：
$ENTRY_JOURNAL_THE_FOX_LEFT_1_10	這是，我們偉大的墳墓…<N>...僅存的...<N>沙漠之寶。<N>沒有人會哀嚎…最偉大的… <N>一個可悲的事情，鍛造了...的男人... <N>我們死了... <N> ...終極沒有榮譽... <N> ...可惡的人... <N>沒有偉大... <N> ...放棄灰燼... <N> ...可悲... <N> ...邪惡...

$ENTRY_JOURNAL_THE_FOX_RIGHT_1_00	這明顯來自於一個奎德的戰士，他註定要在圍困中死亡。<N>他面對死亡時的口才，或是一切他所認知的消亡，都讓我無言以對。<N>我思考著那被毀的挽歌，當我發現那頁紙底部的淚痕時，我非常驚訝。<N><N>我掀起[mage_hero_pos]帳篷的簾子，但在說話前停下了。<N>她捲縮在遠遠的一角，亞麻色的髮絲垂在臉上。她像狐狸的眼睛，<N>忍受著我永遠不知道的痛苦，我們想對而視。<N>那一刻就像多年前的沉默一樣，比起任何疼苦與憤怒的言語都來的沉重。<N><N>我立即離開，但是那影像還是糾纏著我。<N>這次，我就是那加害者。
$ENTRY_JOURNAL_THE_FOX_LEFT_2_00	附錄:<N><N>我為你帶來一首詩:
$ENTRY_JOURNAL_THE_FOX_LEFT_2_10	肌肉...<N>...多不勝數...<N>性感... 得過分...<N>大汗... 卡麗斯...<N>B權力和榮耀的基礎。<N>令人驚歎的，懷疑... <N>喇叭花的腹肌<N>所有的偉大...<N>...冶煉<N> 臀部...<N>... 閃亮的...<N>... 有力量的...<N><N>
$ENTRY_JOURNAL_THE_FOX_LEFT_2_20	那些缺失的字是因為我在拉筋是，現實的布被扯破了。
$ENTRY_JOURNAL_MARKOS_TITLE	
$ENTRY_JOURNAL_MARKOS_LEFT_0_00	第18天- [knight_hero]
$ENTRY_JOURNAL_MARKOS_LEFT_0_10	我是否已經習慣與喜怒無常為伍，而非相信理性？ <N><N>[knight_hero]勇敢，聰明，善良，甚至幽默- 該死的，他還非常注重個人衛生！<N>而我則等待壞事的發生。<N><N>他一定有問題！有些怪癖，有些小性子，有些不理性。<N>如果我在這段旅程當中學到一件事的話，那就是在墓坑之中並未有正常。<N><N>那是小鬍子，對不？他一定把所有瘋狂藏在小鬍子之後。
$ENTRY_JOURNAL_LETTER_MARKOS_1_TITLE	
$ENTRY_JOURNAL_LETTER_MARKOS_1_LEFT_0_00	第19天
$ENTRY_JOURNAL_LETTER_MARKOS_1_LEFT_0_10	利佛巴女士尊鑒，艾殊騎士加山提亞謹啟：<N><N>女士，本人非常敬重您擔任我方指揮官一職，<N>但想表示對您選擇的同行者有所保留。也就是說，只要我們繼續與[mage_hero_fu]（蘭·蘭世彌）同行<N>，本人不能保證您的安全，甚至整個計畫的安全。<N><N>您或想說服我她<LQ>沒那麼不堪<RQ>，而且奎德的戰役已經結束；<N>但本人向您保證，對她來說絕對還是未罷戰息兵。<N>她狂熱地專注於一些已不存在的東西，<N>根本沒有指令體制可控制她的瘋狂。如果[mage_hero_fu]認為奎德的光榮<N>是需要我們頸上頭顱來成就的，那我們便沒有一人可以醒來看見黎明。
$ENTRY_JOURNAL_LETTER_MARKOS_1_RIGHT_0_00	本人建議您儘快而巧妙地與她斷絕關係。<N><N>您恭謹的僕人，<N><N>[knight_hero_fu] 加山提亞
$ENTRY_JOURNAL_LETTER_MARKOS_2_TITLE	
$ENTRY_JOURNAL_LETTER_MARKOS_2_LEFT_0_00	第19夜 – 給[knight_hero_fu]的信，草稿1號
$ENTRY_JOURNAL_LETTER_MARKOS_2_LEFT_0_10	親愛的[knight_hero_fu]：<N><N>為了回應你的來信，我想提出三點：<N><N>第一，為何我們只相距十尺之遙，但你卻特意寫信給我？<N>難道是我的個人衛生使人難以靠近？大家有為此背地裡取笑我嗎？<N><N>第二，請不要再叫我女士了。<N><N>最後，請不要打擾[mage_hero]，不然……我也說不準，或會燒掉你的腮邊的鬢胡之類。
$ENTRY_JOURNAL_LETTER_MARKOS_2_RIGHT_0_00	附筆：關於你的鬢胡，我只是開玩笑，我永不會把那燒掉，<N>因為這樣會令你的樣子看起來怪誕，這又使我忍不住在背後叫你另一個新的綽號，要知原來「美髯先生」的名號已夠響亮了（的光環已夠大了）。<N>不管怎樣，我要說的是[mage_hero_fu]已經歷一段非常艱難的時期，<N>所以為什麼不挑另一個更堪調侃的呢？例如[berserker_hero_up]，他似乎認為我不知道他在背後探頭探腦。<N>要知他是個用口呼吸的白癡，聞起來像兩堆……
$ENTRY_JOURNAL_LETTER_MARKOS_2_RIGHT_0_10	<N><N>我愛你[knight_hero_up]我甚麼想嫁至給你的鬍子，<N>更何況你比[berserker_hero_up]更棒，也穿裙子……嘿嘿﹐我們結婚吧！
$ENTRY_JOURNAL_LETTER_MARKOS_3_TITLE	
$ENTRY_JOURNAL_LETTER_MARKOS_3_LEFT_0_00	第20天
$ENTRY_JOURNAL_LETTER_MARKOS_3_LEFT_0_10	[mcguffin_hero_fu]女士,<N><N>我並未有想過會收到你的來信，看見由曾經被你用湯勺子追打至逃出營地的 [berserker_hero_fu] 帶來， <N><N>我只會將整封信完封不動地退回。<N>另外，麻煩你記得要把湯勺子洗過才好再用。謝謝！  <N><N>P.S. - 美髯先生？真的嗎？這是你能想到最好的嗎？<N><N>-[knight_hero_fu]加山提亞
$ENTRY_JOURNAL_LETTER_MARKOS_SLAK_TITLE	
$ENTRY_JOURNAL_LETTER_MARKOS_SLAK_LEFT_0_00	第21天
$ENTRY_JOURNAL_LETTER_MARKOS_SLAK_LEFT_0_10	嘿，[mcguffin_hero_up]，我是[knight_hero_up]我想和你生孩子因為我是一個淑女<N>這就是我穿裙子的原因還有[berserker_hero_up]實在是太棒了<N><N>來自<N><N>一定是[knight_hero_up]
$ENTRY_JOURNAL_LETTER_AZRA_SLAK_TITLE	
$ENTRY_JOURNAL_LETTER_AZRA_SLAK_LEFT_0_00	第21夜
$ENTRY_JOURNAL_LETTER_AZRA_SLAK_LEFT_0_10	親愛的[berserker_hero_fu],<N><N>如果你讀到這裡，這代表你再次潛入我的帳篷，<N>去褻瀆我的日記或是很差勁地模仿他人。這次不會再忍了。<N>你看見帳篷的簾子嗎？猜猜有什麼在後面呢？<N><N>我給你一個提示吧：湯勺子可不太喜歡你啊。
$ENTRY_JOURNAL_LETTER_AZRA_SLAK_LEFT_0_20	哈哈我幾乎有一秒的時間相信你<N>還有我的名字是[knight_hero_up]我喜歡穿漂亮裙子和
$ENTRY_JOURNAL_NIRU_TITLE	
$ENTRY_JOURNAL_NIRU_LEFT_0_00	第22夜 - [dragon_hero]
$ENTRY_JOURNAL_NIRU_LEFT_0_10	我聽過很多關於龍的事。牠們是我表姐的童年追求，<N>她如饑似渴地搜索著有關於龍的一切傳說，有薄利蒙的科學假設到諾曼族的傳說。<N>這些故事隨後都以兒童的套路灌輸給我：落後，淩亂和緊湊。<N>先別說這個課堂的品質，我的腦海中還是儲備了很多資料。<N>現在我和一條活生生的龍作伴時，我童年的回憶都湧現了。<N>在這次冒險的過程中，與這生物面對面時，我的先入之見大部分都不準確。<N>然而，在這種情況下，我重要的發現是：[dragon_hero]是一個肥胖，貪婪，自私，傲慢的大蜥蜴，<N>被人過度渲染那妄想的神性。
$ENTRY_JOURNAL_NIRU_RIGHT_0_00	這強大的生物實際是非常危險的。她完全沒有顧慮，<N>可以把我們隊伍中的任何一人吃掉，或是殺死任何輕微惹怒她的生物，還有把所有<LQ>非永生者<RQ>視為低她一等。<N><N>自視過高通常是無知的根源。[dragon_hero]擁有一件珍寶， <LQ>龍尺寸的酒杯。<RQ>如果她不是對艾殊文字不以為然的話，<N>她就會知道那段刻文上的意思是<LQ>維達蒙領主的廚鍋<RQ>. 每當我被她的氣焰激怒時，<N>我只需要想想她歡樂地用這個<LQ>酒杯。<RQ>
$ENTRY_JOURNAL_NIRU_LEFT_1_00	第24夜 - 附錄
$ENTRY_JOURNAL_NIRU_LEFT_1_10	即使她對於任何外界的東西都毫不在意， [dragon_hero] 是一個非常關心孩子的母親。<N><N>每當我看見她為自己的孩子而煩惱時，我都不禁想起我的母親。<N>這可是一種奇怪的感覺，因為那可是一個巨大的怪獸，近乎每天都威脅著要把你吃掉，<N>不過這就是我的感受。 <N><N>我知道這種同理心會讓我被殺掉，但是我猜想不到她的孩子被亡者帶走時的疼苦。這宗悲劇會觸動我們之中最強大和最冷靜的人。
$ENTRY_JOURNAL_SPEECH_TITLE	
$ENTRY_JOURNAL_SPEECH_LEFT_0_00	第23日-演說
$ENTRY_JOURNAL_SPEECH_LEFT_0_10	今天當我要處理那只肥胖又可怕，幸好不是文盲的蜥蜴的抱怨時，<N>我找到一些卷軸。 大多是又舊又難以辨識的，但只要一卷清晰可讀。我感到震驚地意識到，那是攝政王的就職演說：
$ENTRY_JOURNAL_SPEECH_LEFT_0_20	我懷著嚴肅與深切的哀悼，承擔起攝政王的位置。我們失去了君父，<N>更要承擔雙重的悲痛。不久以前，我們偉大的君王瑟裡默奔天，但哀傷還未過去之時，<N>死亡又給予我們沉重的打擊，我們的太子舍裡米爾殿下在戰場上壯烈犧牲。<N><N>儘管前路茫茫又波濤洶湧，我保證，黎明即將降臨。<N><N>我懇請你在阿述緹蒙的後裔出現繼承大統，領導我們邁向和平以前，接受我的帶領。
$ENTRY_JOURNAL_SPEECH_RIGHT_0_00	好像一輩子前這麼遙遠，我站在首都之中聽著這番來自攝政王口中的話。<N>我與一個年輕的女孩被悲傷淹沒，在神廟廣場悄然落淚，擔心失去艾殊王的帶領，太陽是否還會升起。
$ENTRY_JOURNAL_ASSASSIN_TITLE	
$ENTRY_JOURNAL_ASSASSIN_LEFT_0_00	第24-天-刺客
$ENTRY_JOURNAL_ASSASSIN_LEFT_0_10	我今天有一個奇怪的發現，在奮戰過後那好奇和興奮的時刻，<N>我們都在篩選戰敗敵人的遺物，看看有沒有什麼裝備可以拿過來用，我忽然看見一個奇怪的東西。<N><N>它好像鎖子甲，或是剩下的鎖子甲，還有一層穿在下方的襯裡。<N>那些甲片更小，做工更為細緻，我從來沒有在我們奎德德軍隊中見過類似的東西。這精緻的設計，<N>還有夾雜在中間的布料，讓我相信這是穿著在日常衣物之下的。這種保密的企圖讓我懷疑這並不是來自軍隊，而是來自民間。<N><N>我對這件鎖子甲的疑惑在於，那明顯的傷口。那大約一巴掌大小，位於心臟位置的缺口。
$ENTRY_JOURNAL_ASSASSIN_RIGHT_0_00	缺口位置周圍的甲片都已經扭曲和變黑，就像受害者承受了可怕的熱浪和暴力。<N><N>我對這種破壞並不陌生，我曾見過無數亡者的屍體都有這些痕跡，那是我用自己雷擊之術的痕跡。但這可不是我的傑作。
$ENTRY_JOURNAL_ASSASSIN_RIGHT_0_10	最令人不安的是，這些破壞了的甲片都是往外翻的，好像那可怕的熱力和壓力來自於盔甲內。
$ENTRY_JOURNAL_ASSASSIN_RIGHT_0_20	我不禁想問，到底是誰會穿這樣的衣服，更重要的是，怎樣的方法才會出現如此慘烈的死亡呢？
$ENTRY_JOURNAL_ASSASSIN_RIGHT_0_30	附錄： <N><N>當我寫下這些時，我依然在顫抖，剛剛發生的事，讓我知道我千鈞一髮之際逃過死亡。
$ENTRY_JOURNAL_ASSASSIN_RIGHT_0_40	那時，我剛開始拆卸先前描述的銅片，嘗試把金屬皮從絲線中扯出，想要
$ENTRY_JOURNAL_ASSASSIN_LEFT_1_00	將有用的物料拆出來賣點錢。那時我正要扯下襯衣店袖子，<N>[knight_hero]抓住我的手。他一面緊握著我的手腕，一面拿出小刀鎅開縫線。<N>裡面是一排針，他繼續沿袖子鎅開，我們發現更多隱藏的倒鉤。一共有32只，每一隻都被塗上毒藥，<N>秘密地縫在布的外面。當有人想要抓住攻擊者的手臂時，就會被刺到。<N><N>當 [knight_hero]繼續他的調查，我們發現一個小口袋，<N>縫在手腕的位置，裡面有一小片卷起來的羊皮紙。羊皮紙的外族圖案並不像我從前在艾殊大圖書館所見過的。<N>即使受到了嚴重破壞，圖案依然清晰：一個纖瘦的女人坐在王座上。<N>她的面孔焦燒的痕跡遮蔽，但長長的白頭發落在她的肩上，<N>與她脖子上的珠寶交織在一起。<N>在她的腳旁坐了兩個黑皮膚和金色的眼睛男孩。<N>女人把手放在男孩的頭上，他們的頭髮像她一樣，是白色的。
$ENTRY_JOURNAL_ASSASSIN_RIGHT_1_00	羊皮紙的邊緣都並不整齊，就像它是從更大的一張紙，<N>用刀切下來的。它的背面佈滿了用黑色墨水描畫的符號。<N><N>對[knight_hero]來說，他嘗試解釋整件事。他說，那些倒鉤，很可能因為放了很久的關係，<N>毒藥都不再致命。他向我保證，<N>他不過是不想我的手指鬥無謂地受傷而已，但是他眼中的擔憂背叛了他。<N><N>到底他是如何知道這些暗器的存在，<N>如何知道這件鎖子甲的主人是個刺客，這些我都無法從他口中得知答案。
$ENTRY_JOURNAL_SUPERSHEEP_TITLE	
$ENTRY_JOURNAL_SUPERSHEEP_LEFT_0_00	第24天-超級羊之死
$ENTRY_JOURNAL_SUPERSHEEP_LEFT_0_10	阿舍麻維特羊那瑟薩在我的手中一動也不動。<N><N>這，根據[dragon_hero_pos]的歡呼,<N>是一項可以被傳頌千古的成就。當然，她看上去是認為她是獨自一手（一爪？）完成這行動的，<N>所以她的意見做不得准。<N><N>我必須承認我很享受慶祝活動。在城市深處，被瘋子和亡者追逐，<N>被混亂包圍，有一刻可以享受一些東西，那實在是太好了，即使那是由一隻自戀又常常作威作福的大蜥蜴所舉辦的<N>。看到她與孩子一起隊長篝火尖叫，實在是很奇怪。除了快樂，我並不能找出形容詞，<N>如果這可以用了形容怪獸的話。我沒有想過這怪獸情緒的感染力會是這麼強的，但我發現我開始感受到主人的
$ENTRY_JOURNAL_SUPERSHEEP_RIGHT_0_00	興奮。我已經殺了一個傳奇的生物！我已經吃了牠的肉！我已經吸收了很多 [berserker_hero]稱為<LQ>靴酒<RQ>的東西！
$ENTRY_JOURNAL_SUPERSHEEP_RIGHT_0_10	為了保護將來讀者那弱小的心臟，<N>我不會解釋這個物質命名的起源，但當我第二杯滿上的時候，我的味蕾可能永遠都不會從恐怖的驚嚇中恢復，<N>我的內心是熾熱的，外面的世界以最愉快的方式躍動和旋轉。
$ENTRY_JOURNAL_SUPERSHEEP_RIGHT_0_20	這種罕見的佳釀的祖先目前正四肢著地，一邊圍著我們爬蟲類主人的火焰跳舞，一邊尖叫起來，<N>尖叫著<LQ>這是我的龍吼！<RQ>我們不會再進一步討論那聲音，也不要討論發出聲音的那張嘴，但是兩者的規律和音量都令人印象深刻的。
$ENTRY_JOURNAL_SUPERSHEEP_RIGHT_0_30	在第三杯時，我發現我對[berserker_hero_pos]的創作最初的負面印象可能太倉促了。風味完全是判斷這種物質的錯誤參照。質感，粘度，一種
$ENTRY_JOURNAL_SUPERSHEEP_LEFT_1_00	混合了溫度和重力脈衝... ...如果閃電是由皮革和泥漿製成的- <N> <N>我的靴子是空的。這必須糾正。<N> <N>再發生了！當你喝完所有的東西，靴子不會留在那裡...哪裡去？為什麼靴子不能保持充滿？<N>為什麼...解決方案！新靴子。<N> <N>靴子五是迄今為止最厲害的。<N>它的靴子有靴酒。質感：驚人。風味：超越言語。後勁：旋轉。<N> <N>我剛吃了一點羊<N> <N>我甚至沒有在火上烤熟牠<N> <N>我生吃了<N> 這是驚人的<N> <N>這就像...好吧：鬍鬚。<N> <N>我是不是
$ENTRY_JOURNAL_SUPERSHEEP_RIGHT_1_00	是不是很奇怪？<N><N>我只想爬入鬍子中，小睡一會兒N <N>像睡在小吊床上<N> <N>卷起身體，<N> < N>我敢打賭他們聞起來都很好<N> <N>我有病嗎？可能是。<N> <N>我可能有病...我可能會
$ENTRY_JOURNAL_SUPERSHEEP_RIGHT_1_10	第25天早晨 - 附錄
$ENTRY_JOURNAL_SUPERSHEEP_RIGHT_1_20	不要<N><N>不要不要不要不要不要不要不要<N><N>不要不要<N>不要再來一次。
$ENTRY_JOURNAL_DREAM2_TITLE	
$ENTRY_JOURNAL_DREAM2_LEFT_0_00	第25天-第二個夢
$ENTRY_JOURNAL_DREAM2_LEFT_0_10	昨夜，那個夢再次來臨。這次的形式有點不同，但是我知道時同一個夢，或是最少我知道我是那個做夢的人。<N><N>我站在大殿之上，它的牆往上延伸，<N>直達天空，雲朵是天花板。每一面牆都是金光閃閃的，我所看見的地方都鋪滿了名貴的珠寶。<N>我的手中有一個用最珍貴的物料所做的聖杯，杯中的酒顏色很深，很冷。<N><N>儘管身邊都是珍寶，但我重視手上的酒杯勝過一切，<N>我小心翼翼地不讓一滴酒灑出。忽然間大殿變暗，骯髒的暴民湧入了它。他們毆打我，<N>虐待我，從我手中搶過酒杯。我尖叫起來，從我的長袍上拿出一把尖銳的匕首，<N>向他們砸了出，向他們猛刺，直到大廳都被血染黑。
$ENTRY_JOURNAL_DREAM2_RIGHT_0_00	儘管他們損失了不少人，依然有巨大的力量壓迫我，直到我被迫離開大廳，<N>被推進了一個昏暗的前廳。我反擊，但是那些暴民都一直打回來，直到我體無完膚。<N>我崩潰了，那些暴民匆忙沖過來，急切地從牆上拆下了明亮的寶石。我躺下很久，相信自己已經死了。<N>當我終於可以站起時，大廳是空的。牆被拆毀，一切都被煙灰玷污。我四處一看，都沒有發現我的聖杯。<N>我在大廳裡漫無止境地遊蕩，哭泣，只有我一個人。杯子從我手上被奪走，我坐在廢墟裡哭泣。
$ENTRY_JOURNAL_ZELEMIR_DEAD_TITLE	
$ENTRY_JOURNAL_ZELEMIR_DEAD_LEFT_0_00	第28天-紅衣男人之死
$ENTRY_JOURNAL_ZELEMIR_DEAD_LEFT_0_10	我依稀記得，我還是個孩童時遇見他，<N>即使我的腦海對眼前這個已經死亡的男人沒有任何印象。
$ENTRY_JOURNAL_ZELEMIR_DEAD_LEFT_0_20	他那時留著東方村落的長髮，大部分的臉都被繃帶纏著，只露出一隻眼睛。<N>事實上，只在媽媽那種尊敬讓我知道他與其他在神廟之泉旁的退伍軍人有所不同。
$ENTRY_JOURNAL_ZELEMIR_DEAD_LEFT_0_30	我記得他用右邊的身體，勉強抬起一個扶拐杖士兵，讓他能喝到泉水。我記得他一直站著，看著那個男人一拐一拐地離去。我記得他的眼淚一直掉下，直至進入純潔的泉水中。 而現在他死了，被我殺死的。
$ENTRY_JOURNAL_ZELEMIR_DEAD_LEFT_0_40	
成為一個殺手是一件苦澀的事，但是這是唯一合理的事情，我告訴自己，我的身上還留著艾殊族的皇家血。<N>他已經偏離了他的目的，以致危及生命的整個秩序。不過，那感覺依然困擾著我。這是我第一次殺死一個有血有肉的人。<N> 
$ENTRY_JOURNAL_ZELEMIR_DEAD_RIGHT_0_00	[mage_hero]在歡樂和憤怒之間搖擺，詛咒他的名字，好像這可以再一次殺死他。據我們過去幾星期的行動來說，<N>我認為這不是一個完全徒勞的願望。<N> <N>讓我最感害怕的是亡者仍然在獵殺我們。<N>他們的領導和創造者都死了。但他為什麼還可以驅使他們呢？<N> <N>這個問題我已經知道答案了，雖然我不想承認。<N>這不是他的意志。這是另一種感覺，有另一隻手引導他們。<N> <N>我能感受到舍裡米爾所說的奇怪的力量，<N>被犧牲的血液封住的邪惡。 以斯裡·特諾奇
$ENTRY_JOURNAL_GIBBERISH_TITLE	
$ENTRY_JOURNAL_GIBBERISH_LEFT_0_00	第25天-胡言亂語
$ENTRY_JOURNAL_GIBBERISH_LEFT_0_10	今天[knight_hero]把我叫醒。我們草草吃過一點東西，<N>我被長長的旅程折騰得疲憊不堪，在剛剛經過的冰涼石頭拱門上斜倚著。我最近都睡得不太好，難得睡意來襲。<N>我的睡眠不能持續超過一段時間。當我睜開眼睛，找到站在我面前的[騎士]。他告訴我，我們要繼續推進，<N>當他走在我前面時，補充說，我在睡覺時一直在說話。<N><N>雖然他聽起來都是無意義的東西，但我感覺到意義是在我<N>半夢半醒之間的心靈狀態。我急不及待拿出我的日記，以免丟失我的獵物，記下了我有印象的。
$ENTRY_JOURNAL_GIBBERISH_RIGHT_0_00	好美好美好美你真的好美<N>我終於把它破壞<N>將你弄得跟我一樣<N><N>我是囚犯和瘋子<N>以自己的思想為食物<N> <N>因為他不可以吃掉世界
$ENTRY_JOURNAL_WRENNASTORY_TITLE	
$ENTRY_JOURNAL_WRENNASTORY_LEFT_0_00	第 26天 – [mage_hero_pos] 的故事
$ENTRY_JOURNAL_WRENNASTORY_LEFT_0_10	我繼續發現現實和我有巨大的鴻溝，因為它客觀的存在，<N>而我則在腦海中塑造的它，為它賦予解釋。看起來我一直花時間去衡量的，並非事物本身，而是我創造出來的認知。
$ENTRY_JOURNAL_WRENNASTORY_LEFT_0_20	當我們一起圍著營火坐下， [mage_hero] 開始說一個故事。我抱住自己，期待著一個艱難的旅程：<N>是年輕時的肆意殺戮，還是狂野的激情呢？
$ENTRY_JOURNAL_WRENNASTORY_LEFT_0_30	<N><N><N>都不是，她說了一個有關她最小的妹妹的故事。
$ENTRY_JOURNAL_WRENNASTORY_LEFT_0_40	<N><N><N>這個孩子，比[mage_hero_pos]小七年，非常羡慕其他姐姐可以自由自在。她一直都不滿足，所以總是出其不意地爬上[mage_hero_pos] 的背上，<N>假裝有一樣的身高和一樣的靈活。但是讓小女孩沮喪的是，[mage_hero] 很快就變得很迅速地移除這個小麻煩。這
$ENTRY_JOURNAL_WRENNASTORY_RIGHT_0_00	持續了一段時間，最小的老是想爬上老大的背，但每次都被人立刻扳下來。
$ENTRY_JOURNAL_WRENNASTORY_RIGHT_0_10	有一天[mage_hero]醒來時發現她的妹妹就在她的床頭，費力地將一罐蜂蜜往自己身上塗，<N>想用一個臨時的方法來把自己永遠地粘在可憐的姐姐身上。[mage_hero]說完後期待地看著我，帶著一絲少女的微笑。我忽然發現她在等我笑出來。
$ENTRY_JOURNAL_WRENNASTORY_RIGHT_0_20	這對我來說是又新又奇怪的反應。在我的印象中，[mage_hero]
$ENTRY_JOURNAL_WRENNASTORY_RIGHT_0_30	是充滿悲傷或恐懼的人。<N>她的形象一直是嚴肅又可怕的軍人，即使在私底下她都表現得嗜血，<N>連笑也是帶著瘋狂，其他時間她就像個疼苦又無助的孩子，讓我的正義感湧出。我的誤解是多麼的嚴重，<N>它試圖將人的靈魂凝聚成一個簡單的物件，只在與我的關係中才有意義。
$ENTRY_JOURNAL_EVILINSIDE_TITLE	
$ENTRY_JOURNAL_EVILINSIDE_LEFT_0_00	第27天 – 裡面的惡魔
$ENTRY_JOURNAL_EVILINSIDE_LEFT_0_10	瑟連達在他第二封寫給維卡利蒙王的信中提到, <LQ>當然擁抱在心內的惡魔時，勝利者並不存在。<RQ>
$ENTRY_JOURNAL_EVILINSIDE_LEFT_0_20	被別人重提自己的失敗是苦澀的一課。我相信自己是瑟連達<N>真正又熱心的追隨者（我現在看到那時的驕傲是一個嚴重的錯誤）。
$ENTRY_JOURNAL_EVILINSIDE_LEFT_0_30	但我肯定的說，像我這種自小已經熟讀經文，定期前往神廟的人來說，<N>這是否就代表走在正義的路上？儘管如此，我這輩子總是暗暗掩飾了<N>邪惡不過是純外在的東西。首先是奎德族，我早年生活<N>所有痛苦和苦難的根源。當我每天內省自己心中的邪惡時，<N>我秘密地告訴自己，沒有一個可以與來自東方的邪惡軍隊相比，他們是兇手和掠奪者，<N>比禽獸還不如。在我周圍，寡婦的哀悼，孤兒的哭泣，癱瘓老軍的哭泣，<N>對城市的所有執著都是來自我自私的想法，一再對我自己強調。
$ENTRY_JOURNAL_EVILINSIDE_RIGHT_0_00	<LQ>我沒有惡，<RQ>我對內心如此說。<LQ>可與之相比。<RQ> 就算是目前的冒險對我的誤解有很多的啟發，但是我還是維持著對純潔的幻想。
$ENTRY_JOURNAL_EVILINSIDE_RIGHT_0_10	
$ENTRY_JOURNAL_EVILINSIDE_RIGHT_0_20	無論我的內心有多少秘密，我可以指著奧斯蒙和舍裡米爾說，<LQ>這才是真正的惡魔、<RQ><N>瑟連達的態度迂回地指出，我秘密的信仰可是非常可笑愚蠢。在這個死城的中心，握住了一隻手，這只手的主人曾經是艾殊騎士，我發現了一個卷軸。有人用熟練的草書寫下了以下的字：
$ENTRY_JOURNAL_EVILINSIDE_RIGHT_0_30	我最親愛的長老大人為了回應你在崇拜時的教導，我想澄清我一直都是依從信仰的教導來行動。<N>你指控我屠殺我管控的囚犯是違背了我崗位的職責，還有違背了偉大造物者交付我的責任，但我能保證
$ENTRY_JOURNAL_EVILINSIDE_LEFT_1_00	我做的恰好是正確的。<N><N>你一定記得，當敵人兵臨泰爾納城的時候，為了恐嚇守護軍投降，<N>他們發誓如果不投降，他們會殺盡所有的反抗者。<N>那一天，城池淪陷的一天，那誓言成真了。可是敵人但將他們瘋狂的烈怒發洩在軍人身上，也發洩在平民百姓之上，不論男女老幼都受到波及。<N>那天日落時，一共有三萬名平民被屠殺。泰爾納城成為廢墟，<N>只有寥寥可數的人劫後餘生，來告訴我們那可怕的經歷。<N><N>因為這個原因，我的囚犯中每逢是第十個的，必會被燒死。<N>在我殺夠三萬人以前，為了教化囚犯和實現真正的平衡，這中獻祭會繼續。<N>這是我對泉水中每一塊金子所立下的鄭重誓言，<N>即使是一個自以為是的神職人員也不會讓我改變初衷。<N><N>–哥革尼曼·卡若多斯將軍
$ENTRY_JOURNAL_EVILINSIDE_RIGHT_1_00	我知道這個人- 我看到，仿佛被閃電照亮，每一個靈魂中潛伏的無比黑暗。<N>比起其他人，我看到它在我自己身上。擁抱腐敗而不去抵抗它<N>是多麼容易。有一個甜美和熟悉的味道很難描述– 
$ENTRY_JOURNAL_EVILINSIDE_RIGHT_1_10	是否因為我已經仇恨太久而愛上仇恨？我看著眼前寫著的恐怖事件，
$ENTRY_JOURNAL_EVILINSIDE_RIGHT_1_20	我看到最骯髒的罪惡。但是，這樣做是多麼容易。<N>我內心深處，享受著施加疼苦的甜蜜<N>，我的靈魂與復仇的喜悅共舞。我想到[mage_hero]在帳篷裡啜泣 - 我用溫和的手段釋放我的罪惡。<N>我有什麼真正的力量？
$ENTRY_JOURNAL_EVILINSIDE_RIGHT_1_30	當人擁抱自己內心的邪惡時，沒有勝利者。
$ENTRY_JOURNAL_MARKOSSTORY_TITLE	
$ENTRY_JOURNAL_MARKOSSTORY_LEFT_0_00	第27天 - [knight_hero_pos]的故事 
$ENTRY_JOURNAL_MARKOSSTORY_LEFT_0_10	致[mcguffin_hero] 利佛巴女士，來自艾殊騎士團的[knight_hero] 加山提亞。<N><N>不久以前，你曾問我，我是如何知道那件裝備中隱藏著危險。<N>正如你所料，我曾經和一個穿著類似裝備的刺客接觸。當我應付過你的好奇心後，<N>我用了些時間來思考這件事，然後決定告訴你我個人的經歷。<N><N>我並不常提及這個故事，更不想想起它。<N><N>那是悲慘的時代, 大約是瘟疫肆虐的兩年前。<N>那時，奎德大軍是無可阻擋的。東部的村落都經歷了大規模的<N>屠殺，連艾殊的心臟區域也受到了入侵。
$ENTRY_JOURNAL_MARKOSSTORY_RIGHT_0_00	我的父親死了，我的兄弟也死了。<N>作為加山提亞家族中最年長的男人，我肩負了作戰的義務。有很多貴族子弟跟我一樣，一生總是在訓練，<N>但是卻從未殺過人。我們之下還有其他更年輕的男孩：平民，小商販，農民的兒子，<N>全部都被徵召來為艾殊效力。
$ENTRY_JOURNAL_MARKOSSTORY_RIGHT_0_10	我想，將這樣的重任交給我們，這也是國王絕望的一個跡象吧。
$ENTRY_JOURNAL_MARKOSSTORY_RIGHT_0_20	探子帶來一個消息，奎德的將軍會與他的先頭部隊一起紮營，<N>那些拜火的人正密謀直接將爪子伸向艾殊的心臟地帶。探子說他的守衛很少，現在正是突擊的時候。<N>我們的指揮官對這樣的一個行動措手不及，他的部隊大部分是未經測試的新兵，
$ENTRY_JOURNAL_MARKOSSTORY_RIGHT_0_30	大約是我的年齡或更小，他的諾曼支援部隊也慢慢散亂。<N>他沒有軍餉，沒有老兵可用，幾乎沒有足夠的金子可以支付給雇傭兵。
$ENTRY_JOURNAL_MARKOSSTORY_LEFT_1_00	他只找了一個人。<N><N>我曾經聽說過有關卡革斯人的故事，他們是北方城市久經戰爭後出現的刺客一族，<N>他們視謀殺一事比起雇主支付的酬金還重要。我以前都以為不過是士兵之間的傳說，對此不以為然。<N><N>看做那個男人，我不禁懷疑我是不是判斷錯誤了。<N><N>他沒有任何毛髮，就我所見，面上沒有，頭頂沒有，手背也沒有。我從未見過任何生物可以一動也不動那麼久。<N>他不說話，但偶爾，他會突然笑起來，他的牙齒是黑色的。那男人自稱飲影者。<N><N>我們的命令很簡單：把那個卡革斯人帶到敵人的營寨中，<N>提供任何他需要完成任務的支援。<N><N>天氣對我們很不利，晚上的時候，濃濃的霧氣降臨，在黎明前的漆黑之中，我們
$ENTRY_JOURNAL_MARKOSSTORY_RIGHT_1_00	很快失去方向。因為不想暴露行蹤，我們一小群人很快分散了。<N>獨自身處濃霧之中，我越來越恐懼。
$ENTRY_JOURNAL_MARKOSSTORY_RIGHT_1_10	我蹣跚地在黑暗中遊蕩，生怕我的腳步會令敵人發現我的行蹤。<N>然後，我踩到一件物體，那是奎德守衛的屍體，他渾身浴血，眼皮都不見了。
$ENTRY_JOURNAL_MARKOSSTORY_RIGHT_1_20	我終於闖進了敵人的營寨，不過我發現我並非孤身一人。
$ENTRY_JOURNAL_MARKOSSTORY_RIGHT_1_30	在我前面，兩個帳篷中間，有一個人蹲著。即使我不能判斷他的身份，<N>但他的舉止告訴我他也是入侵者。我攝手攝腳爬到他身旁，正想拍拍他的肩膀來提醒他我在附近。<N>怎料，他頭也不回地抓住我的手。
$ENTRY_JOURNAL_MARKOSSTORY_RIGHT_1_40	他咧嘴而笑，笑容展示著他的黑齒，幾乎把他的臉分成兩半。飲影者指了指我們前面的
$ENTRY_JOURNAL_MARKOSSTORY_LEFT_2_00	帳篷。它的布幕繡著奎德族的皇冠。它的守衛全部都已經被殺。<N><N>他進入將軍的帳篷時，依然抓住我的手臂，我只好被他拖進去。將軍睡在帳篷的另一邊，<N>身邊全是地圖，卷軸和不同的軍令。即使他躺下了，我還是能判斷他是個高大的男人，他的個子比我還壯，比起那個瘦弱的卡革斯人更顯得像巨人一樣。<N>飲影者終於放開我，攝手攝腳地爬到將軍的腳旁。他從貼身的鞘中，拔出一把小刀。他高舉過頭一會兒，<N>好像時間都靜止不動。猛地一跳，他把刀刺入熟睡的將軍的身體。<N><N>將軍喘著氣站起，那把刀的刀柄還在他的肋骨中間。<N>他抓住那個卡革斯人的肩膀，一把把他扔出，抄起床邊的劍，大步向他的方向邁出。<N>我害怕同伴的生命受威脅，於是我也抓起我的劍，準備刺向那巨人。我的攻擊硬生生被那卡革斯人奇怪的笑聲中斷。
$ENTRY_JOURNAL_MARKOSSTORY_RIGHT_2_00	他躺在地上，就是剛剛那將軍把他扔出的地方，他的黑齒閃耀著奇特的歡樂。<N>將軍的行動改變了，他的劍從手中掉下，他的身體像搖搖欲墜的高塔，他抽搐著倒下。<N><N>卡革斯人大喊一聲，一把跨坐在垂死之人的身上，拔出他的刀。我恐懼地看著他伸出雙手，<N>好像淋浴一樣，不斷將那奎德人的最後一口氣像水一樣，往自己的頭和身上潑。<N><N>當那個將軍的喘息靜了下來，卡革斯人的一是也完成了。<N>他轉過頭來，看見我還站在那裡，保持著先前的攻擊姿勢。他再向我一笑，扯下他肩膀衣服上的布，展示上面塗滿毒藥的倒鉤。那人就是命喪於此。<N><N>他抓起我的手腕，帶我走出帳篷，走到營寨的邊緣。他停了一會，蜷縮
$ENTRY_JOURNAL_MARKOSSTORY_LEFT_3_00	在濃霧與黑暗之中，我聽到他好像在刮擦什麼。<N>然後，他帶著一個父親一樣的微笑，他把他的刀給我。在那個破舊的刀鞘上，刻著一下奇怪的文字。我抬起頭時，已經有另外四個人和他一起，他們的服裝是一樣，笑起來也露出黑齒。他們行動一致，<N>往後移動，慢慢在濃霧中消失在我的視線。<N><N>幾個星期後，我們的指揮官在睡夢中被悶死，謠言說飲影者會來討債。<N><N>幾年後，我遇上一個會說一點卡革斯語的士兵，<N>我把那把刀給他看，讓他翻譯。那些字上寫著，<LQ>“少年，願你奪取更多生命。”<RQ>
$ENTRY_JOURNAL_DREAM3_TITLE	
$ENTRY_JOURNAL_DREAM3_LEFT_0_00	第29天-第三個夢
$ENTRY_JOURNAL_DREAM3_LEFT_0_10	我昨晚又一次做夢，.<N><N>我站在荒蕪的地方中。<N>在我的面前，豎立著一個巨大水晶，浮在幾百英尺的半空中。我正在飲泣，淚水緣著我的身體滑下，<N>穿過了金飾和其他裝飾物,掉落在地上，它們偷偷地穿過塵土飛揚的地面，來到水晶的附近。我發現它們並不是淚水而是鮮血。<N><N>在我的腳旁滿是屍體，有男人，女兒和孩子的。<N>我的雙手滿是他們的血塊。我轉過身來，看見我身後的軍隊，跟我一樣，渾身浴血。他們都等著我說話。<N><N>我向天舉起我紅色的手臂，發出如雷的聲音。<N><N>軍隊跟隨著我的呼喊。那是一個我從未聽過的字，但是我立即知道它的意思。那個字是血。那呼喊聲足以振動大地。
$ENTRY_JOURNAL_SLEEP_AND_MADNESS_TITLE	
$ENTRY_JOURNAL_SLEEP_AND_MADNESS_LEFT_0_00	第30天 – 睡眠與瘋狂
$ENTRY_JOURNAL_SLEEP_AND_MADNESS_LEFT_0_10	這次我自己醒來，這樣緊張的夢讓我一直說著夢話。<N>那些字的發音一直在我腦海迴響，但是那些意思依然盤橫，這比起以前的任何經歷都要奇怪和大影響的：
$ENTRY_JOURNAL_SLEEP_AND_MADNESS_LEFT_0_20	
$ENTRY_JOURNAL_SLEEP_AND_MADNESS_LEFT_0_30	不過不過不過<N>為了巨額和腥紅的代價<N>你離開了我<N>選擇了在另一個地方開始新生活<N>好像你可以停成為神一樣<N><N>我孤身一人<N>我是瘋子也是囚犯<N>而你是塵土的女王<N>惡魔的女王<N>是可以選擇成為神的人<N><N>或者只有我這樣想<N>我坐下來苦苦思量
$ENTRY_JOURNAL_EMPRESS_TITLE	
$ENTRY_JOURNAL_EMPRESS_LEFT_0_00	第32天 – 女王
$ENTRY_JOURNAL_EMPRESS_LEFT_0_10	我必須為我們在鬼城有訪客這件事表達一下不冷靜。<N>同一群商人我們都為了必要的交易見過多次，但是這裡的人還是讓人很不舒服。<N>他們大部分都是奎德族人，他們又安靜又熱情，我發現我自己在數著有多少次他們提起我時，我都落荒而逃。<N><N>尤其是[knight_hero],
$ENTRY_JOURNAL_EMPRESS_LEFT_0_20	看起來很激動。他很少說起他的戰爭經歷，<N>但我知道那些人的言論和衣飾都讓他想起那段邪惡的回憶。<N>他不再像平常一樣說笑，反而經常走來走去，按捺自己的雙手不去拔劍。<N><N>就算是遊俠和那些為了錢而工作的雇傭兵，好像對自己的守衛也不太信任。
$ENTRY_JOURNAL_EMPRESS_RIGHT_0_00	這裡滿大街都是會爆炸的水晶。儘管有這麼充裕的礦藏，<N>奎德族人還是一直挖掘，好像為了那早已不復存在的戰爭機器預備。<N><N>這些都是讓人甚為不安，但是 [mage_hero]還是進了村。<N><N>她是最後一個有王族血統，是宇宙之焰的孩子。她所經之處，都有渴望的目光追隨。<N>過了不久，整個村莊的人都靜靜地集合，擠在自家的門口，貪婪地渴求著她的指令。<N><N>突然間，一個男人打破了人群的靜默，他身穿破破爛爛的衣服，髒兮兮又淩亂的金鬍子掛在臉上。<N>他大叫一聲，夾雜著笑聲，撲到她的跟前，在泥濘中念念有詞，<N>抓住她披風的下擺。<N><N>就像一道看不見的牆被打破了一樣，所有人突然間沖往[mage_hero]，
$ENTRY_JOURNAL_EMPRESS_LEFT_1_00	爭先恐後地想抓住她的衣服。我見到一個老人家像兒童一樣卷在上，<N>保護著一小把她的金色頭髮。<N><N>我嘗試走近她，但群眾一直不讓我靠近。有那麼一刻，我和[mage_hero_pos]有眼神接觸。它們載滿了我前所未見的恐懼。她消失在人群高舉的手中，<N>那些人手中都有一片她斗篷的碎片。<N><N>當我正要用我的力量去把她帶往中途世界時，有人大聲地下命令，震動了整個人群。那群暴民安靜下來，很多人在顫抖。<N><N>[mage_hero]站在村莊一間小屋的屋頂上，她的頭髮迎風飄蕩，<N>她支離破碎的斗篷好像是戰艦的旗幟一樣飄搖在風中。她的額前有一道血痕。
$ENTRY_JOURNAL_EMPRESS_RIGHT_1_00	她弱小的身軀發出的聲音遠超我想像，她在一群奎德人中大吼。<N>那些人都非常自豪，好像整個人群都被她的話語折服一樣。
$ENTRY_JOURNAL_EMPRESS_RIGHT_1_10	<LQ>我是[mage_hero]蘭·蘭世彌!我是從死灰中複燃的火焰！<RQ>
$ENTRY_JOURNAL_EMPRESS_RIGHT_1_20	她原本被淹沒在奎德，艾殊和諾曼的人群之中。<N>他們開始後退，鞠躬，不敢背對著他們的女王。慢慢地，人開始上前來在她的跟前擺上他們最好的財產，刀，斧，布匹等等。這持續到傍晚。<N><N>那些水晶近乎是我們剛到達時的一倍。
$ENTRY_JOURNAL_BLACKROBES_TITLE	
$ENTRY_JOURNAL_BLACKROBES_LEFT_0_00	第33天–黑袍
$ENTRY_JOURNAL_BLACKROBES_LEFT_0_10	[berserker_hero]開始收集死亡的異教徒染滿血的袍子，我可不想知道他這樣做的目的。<N>看到那些在面具後扭曲的臉是種奇怪的感覺，他們因為突然變成亡者而扭曲。<N>他們全都帶著傷口，我只能假設這些傷口自殘而來。儘管如此，仍然不難看出他們曾經為人，他們跟諾曼族人並無分別。<N><N>看見他們時，[mage_hero]總帶著奇怪的喜悅，好像她正在和傳奇的祖父對抗的敵人一樣，<N>正在經歷同樣的英雄事蹟。那些異教徒，她告訴我，曾經是奎德帝國最大的威脅。在中央母系的旗幟下，<N>那些瘋子自成一國，為了滿足他們永無止境的生人獻祭，不惜發動大規模的侵略。<N>奎德族世世代代的戰爭都停滯不前，直到[mage_hero_pos]的祖父的時代，整個帝國才有能力發動大規模反擊。他的勝利既迅速又殘酷；顯然，在經歷
$ENTRY_JOURNAL_BLACKROBES_RIGHT_0_00	好幾代的成功後，那些異教徒成為他們自己腐敗的受害者。<N>曾經一度偉大的母系集權終於被沒有制度的大祭司集團取代，<N>每個人都爭權奪利，忽視整體。欠缺了中央集權的統治者<LQ>眾魔之後<RQ> (是奎德對於這個組織的稱謂),那些異教徒不能團結一起發動反抗，在奎德的打擊中一撅不振。
$ENTRY_JOURNAL_BLACKROBES_RIGHT_0_10	直到瘟疫來臨前，[mage_hero]和她的人民一直相信那些血祭異教徒都滅絕了。<N>現在，在這個混亂的時代，這些瘋子似乎都回歸了，帶著新的力量和黑暗回歸。這個時刻絕非偶然。<N>以斯裡-特諾奇找到他的奴才，那些人願意為了他泯滅人性。
$ENTRY_JOURNAL_BLACKROBES_RIGHT_0_20	[ranger_hero]把他們稱作<LQ>部落的憤怒<RQ>這稱呼與他們的外形連結起來，<N>讓我不禁想這些人是否真的跟她一樣曾是諾曼族的一員。到底是什麼說服他們去承擔<N>這樣的生命（或是曾經擁有的生命），我一直百思不得其解。
$ENTRY_JOURNAL_BLACKROBES_LEFT_1_00	[ranger_hero]對這個問題仍然保持沉默。除了剛剛的戰鬥之後，她剛剛發表<N>的幾句話，也沒有再說了。顯然，慶祝勝利是一回事，滿足一個外國人那<LQ>討厭的好奇心<RQ>又是另一回事。<N>也許我的好奇心是隨意猜想而來的，當她認為沒有人看到的時候，我看到[ranger_hero]指著狐狸偶像在她的脖子上，<N>她的眼睛緊張地在我們剛剛死亡的敵人中閃爍。<N> <N>那個革卡和年輕的[ranger_hero]過去曾經與這些瘋子進行了<N>一些不見得光的交往，似乎是已經確定了的事。<N> <N>第一次，我覺得我自己一直草率大意。
$ENTRY_JOURNAL_BLACKROBES_LEFT_1_10	不禁想起[ranger_hero_pos]那為<LQ>死者<RQ>而作的秘密禱告，<N> 還有她對Krast之子近乎不能承受的債務。
$ENTRY_JOURNAL_BLACKROBES_RIGHT_1_00	附錄 – 第33夜
$ENTRY_JOURNAL_BLACKROBES_RIGHT_1_10	我的思緒清明，對於那個嗜血瘋子的黑暗呢喃，實在是熟悉得令人可怕。<N>它們對我來說並不陌生，在深夜時，當我的思緒不屬於我的時候，它們就會來襲。<N><N>這些血腥的呢喃並不是我唯一感到時秘密的知識。在今夜皎潔的月色下，<N>我可以見到白晝不能看見的事物。<N>我認識這些黑袍，這些用血塗成的面具，還有那些穿戴它們的魔鬼。<N><N>我在夢中就是指揮他們的人。
$ENTRY_JOURNAL_DREAM4_TITLE	
$ENTRY_JOURNAL_DREAM4_LEFT_0_00	第33天:第四個夢
$ENTRY_JOURNAL_DREAM4_LEFT_0_10	這些夢，或是說這個夢，只有一個夢，在晚上不斷延伸敘述，<N>現在有越演越烈的跡象。每一晚我都近乎是懼怕的閉上眼睛，因為似乎在睡著時我就不再是我。<N><N>我站在一個漆黑又荒涼的地方，太陽從不升起。我在落淚，急切地求問上天，但在我的內心深處，我知道太陽不毀再次照耀。<N><N>站在我身邊的眾多人民開始嚎哭，獻祭，祈求一些他們不明白的東西。<N>他們不但割傷自己，還彼此割傷，更鞭打著周圍的地方，好像無意識的破壞能喚回已經離他們而去的光明。<N>再黑暗中，他們的眼睛除了暴力，就什麼都看不見了，就像我所教導的一樣。<N><N>我逃離我的創造物，那些瘋狂的呼喊在黑暗的地平線消失。我奔入黑暗，
$ENTRY_JOURNAL_DREAM4_RIGHT_0_00	看起來過了久，等待時間結束。但時間一直沒有結束，它往黑暗延伸，從看不見的地平線往無限延伸。
$ENTRY_JOURNAL_DREAM4_RIGHT_0_10	我不能告訴你多少時間過去-當我想到時，<N>我甚為驚訝一個晚上就可以把無數輩子的事情都經歷了。我將我所失去和我所得到的記憶填滿無限，<N>我的眼淚是毒液,我的思緒是真正的受害人。冰冷的黑暗把我的淚水凝固在體內。我一直跑但是我處可逃，<N>我逃避的其實是我自己。最後，在很久很久以後，我看見- 我不能說它是光吧，畢竟它跟我見過的光無法相比,它只是稀薄了一點的黑暗。<N>但是我在黑暗中太久了，所有的感覺都被剝奪，除了我自身的悲哀以外，那個存在看來是唯一的出路。<N>我轉身看見眼前是一小小的蠟燭，在冰涼的夜風中忽明忽暗。我還在落淚，<N>慢慢往燭火前進，好像它可以溫暖我一樣。
$ENTRY_JOURNAL_DREAM4_RIGHT_0_20	它不是蠟燭，而是一個小小的，灰灰的人，我看著他用塵土飛揚的小玩意來求愛，
$ENTRY_JOURNAL_DREAM4_LEFT_1_00	這可能是那些蜘蛛網中他能拿出的最好的東西來。我看著他，我感受不了任何東西。<N>在那一刻，我心中的空虛是最幸福暖和的-將我內心中的憤怒和仇恨用空虛取代……這是比我所希望的得更好。<N>感受不到任何東西是最美秒的幻想…… 我接受了遺忘。<N><N>遺忘變成苦澀的喜悅，我抽回雙手，發現它們各自拿著一小道火焰。<N><N>我再次落淚，他們的權利都被剝奪，我這小笑的光明。它們應該是星辰。<N><N>那對雙生子是我的兩塊心頭肉，他們跟我一樣白皙的皮膚和星光般金黃的頭髮。<N>我把他們緊緊擁在胸前，他們放聲大哭，為那他們應該存在的父親而哭，為那他們從不認識的父親而哭。在這裡，他們是一個孤獨王國的好奇心，饑餓的孩子。<N><N>黑暗越來越濃。
$ENTRY_JOURNAL_DREAM4_RIGHT_1_00	我一邊哭泣，一邊吹熄蠟燭。<N><N>我醒來時，我的嘴唇呢喃著我不認識的字- 一個我不敢想的名字。
$ENTRY_JOURNAL_DREAM4_TITLE	
$ENTRY_JOURNAL_STAHP_LEFT_0_00	第34天–該死的離我的日記遠一點
$ENTRY_JOURNAL_STAHP_LEFT_0_10	當我走過這些新近被發掘的廢墟時，遺跡被惡意地推至現在，我不禁想
$ENTRY_JOURNAL_STAHP_LEFT_0_20	[berserker_hero_pos_up]那成熟的肌肉組織散發著令人興奮的性感魅力。<N><N>大汗與卡麗斯一直在我的腦海，他們的起伏的節奏一直在我的夢中出現。<N><N>我曾經以為我自己被[knight_hero_pos_up]的小鬍子所誘惑，但是我現在知道他很弱雞，用盔甲來掩飾他的瘦弱，那簡直跟一個真男人那閃閃發亮的腹肌無可比擬。<N><N>與[berserker_hero_up]共處一室,嗅到他迷人的麝香，簡直讓我無法自持。
$ENTRY_JOURNAL_STAHP_RIGHT_0_00	這就是所謂的[berserker_hero_up]狂熱。<N><N>那可是無藥可治的。<N><N>其實，我每夜都和自己的疼苦和
$ENTRY_JOURNAL_STAHP_RIGHT_0_10	想為何[berserker_hero]有能耐一邊跑一邊寫字。<N><N>我又想該如何把湯勺子板回可以用的形狀呢。
$ENTRY_JOURNAL_DREAM5_TITLE	
$ENTRY_JOURNAL_DREAM5_LEFT_0_00	第34天:第5個夢
$ENTRY_JOURNAL_DREAM5_LEFT_0_10	現在每夜醒過來，嘴唇呢喃著奇怪的字，<N>腦海中滿滿時不屬於我的黑暗想法，看來已經定期出現。<N><N>我爬過[ranger_hero],她睡著時，一手會拿著狐狸的雕像，一手會緊握她的匕首。<N>我趕緊拿起筆在羊皮紙上書寫，不知道那是什麼文字，直至它們在紙上出現。
$ENTRY_JOURNAL_DREAM5_LEFT_0_20	
$ENTRY_JOURNAL_DREAM5_LEFT_0_30	我實在期待見到它們<N>這些光明原本是屬於我的<N>對他們的權利無知<N>和我現在想<N>它們到底會是多麼的金黃<N>如果他們只可以試<N>我神族的墮落<N>不過不過不過<N>我體內的光明知道<N>我會成為他們的廢墟<N>因為我是你的
$ENTRY_JOURNAL_DREAM6_TITLE	
$ENTRY_JOURNAL_DREAM6_LEFT_0_00	第35天:第6個夢
$ENTRY_JOURNAL_DREAM6_LEFT_0_10	感覺上我快要被睡眠遺忘了,那少得可憐的睡眠時間都被其他人的生活和思考佔據了。<N>更多的無聲字詞，在糾纏我那疲勞的大腦。
$ENTRY_JOURNAL_DREAM6_LEFT_0_20	那神明的聲音又來了<N>和你拍掉身上的灰塵<N>丟走凡人那些世俗的裝飾<N>回歸我的身邊吧<N>抱住手中的拯救吧<N><N>只要你問我我就會給你<N>和終結這個世界<N>或是終結我自己
$ENTRY_JOURNAL_DREAM6_LEFT_0_30	誰透過我的嘴唇說話？誰活在我的夢中？<N><N>我問了我不想知道答案的問題。
$ENTRY_JOURNAL_THRONE_ROOM_TITLE	
$ENTRY_JOURNAL_THRONE_ROOM_LEFT_0_00	第35天– 以斯裡的寶座
$ENTRY_JOURNAL_THRONE_ROOM_LEFT_0_10	[berserker_hero]隨意地坐在寶座上時，我正在寫字。以斯裡·特諾奇的寶座。<N><N>剛開始時，這種行為令我非常不自在。<N>但是為啥呢？惡魔還需要尊重嗎？這個人無非是借神明之說作威作福罷了。<N>這種邪惡根本上來說是可悲的，他恥笑了世人的自我欺騙。看看這個地方：<N>整個宮殿都是自我創造的形狀，高叫著，看看我，我是力量的真面目！<N>神明以斯裡·特諾奇在他的水晶牢籠中無能為力。.
$ENTRY_JOURNAL_THRONE_ROOM_RIGHT_0_00	不過從另一層面來說，我是理解的。那一個我曾經走過這些大殿，<N>那些所謂的神之大殿。我曾坐在他的位置，對那些暴民評頭品足。我曾體會我們神聖的召喚。<N><N>或許就是這種滋味，在夢中所體會過的，<N>都令我蔑視。我見證過他是什麼還有他認為他自己是什麼。
$ENTRY_JOURNAL_EVNI_TITLE	
$ENTRY_JOURNAL_EVNI_LEFT_0_00	第36 –伊芙麗
$ENTRY_JOURNAL_EVNI_LEFT_0_10	違反了所有理智和邏輯，我為[berserker_hero]買下了他的<LQ>真愛。<N><N><RQ>我永遠不會原諒自己。<N><N>可以這樣形容[berserker_hero]:他不是那種喜新厭舊的男人，在得到想要的東西以後，就立馬厭倦。<N><N>依芙麗成為我們的一分子。<LQ>她<RQ>在吃飯時有自己的位置，在我們的議會也有地位。<N>她提出的一大堆意見，很容易地被[berserker_hero]翻譯好,因為他<LQ>會說流利的劍語。<RQ><N><N>她-我對我的父母發誓我絕對沒有加鹽加醋-有自己的床，每天晚上[berserker_hero]都會抱著她入睡<N>–再一次申明，我對此並無幻想–他會唱著安眠曲去哄她，經常出現的主題是砍頭。<N><N>
$ENTRY_JOURNAL_EVNI_RIGHT_0_00	對於[ranger_hero]來說,變得比平常更為沉穩。<N>在我們吃中午飯的時候，[berserker_hero]為了抓住飛過他<LQ>胸前的夾縫<RQ>小昆蟲有短暫的分心，<RQ>坐在他附近的[ranger_hero]相信沒有人留意到她，<N>就伸出手把[berserker_hero_pos]那一碗黏糊糊的粥倒在那把劍上。[berserker_hero]大哭又垂打自己的胸膛（這成功地把那只小昆蟲打死），<N>以為是自己的粗手粗腳導致伊芙麗遭遇不測。我的眼睛和[ranger_hero_pos]的對上了，我們相對而視，好讓她知道她的惡作劇並無神不知鬼不覺。<N>她對我露齒一笑。<N><N>附錄：<N><N>晚一些的時候，我猜，我好像意外地進行了一場報復。<N>正當伊芙麗在[berserker_hero]用採摘回來的花朵築成的涼亭的陰影中，進行她的<LQ>午睡時<RQ>，我剛好經過。<N>我發現[ranger_hero]趴在地下，對著這把劍說話。當我走近時，<N>我發現她咬牙切齒的喃喃自語：<LQ>你對他來說根本不算是什麼東西，<N>他會忘記你的。只有你不在，那我 -<RQ>
$ENTRY_JOURNAL_EVNI_LEFT_1_00	我清了清喉嚨，[ranger_hero]立即跳起來。她的眼睛瞪得像銀碟子那樣大，<N>滿臉都是可疑的暈紅，那我可從未在其他生物上見過的。<N><N>她的嘴巴張了又合上，重複了好幾次，<N>沒法做完任何可以令人分心的咒駡，只好把她的斗篷蓋住臉逃開了。<N><N>我認為這是我一生中最偉大的成就之一。
$ENTRY_JOURNAL_PEACE_TITLE	
$ENTRY_JOURNAL_PEACE_LEFT_0_00	第38天–和平？
$ENTRY_JOURNAL_PEACE_LEFT_0_10	沒有敵人在追殺的感覺，既然奇怪又美好；<N>加快旅程的方法就是我們對於到達出口的欲望。<N><N>現在我們最後一個敵人都倒下了，我是唯一知道龍火秘密的凡人。[mage_hero]帶著奇怪的妒忌看著我。<N>她肩負著來著地獄的詛咒。現在，我在她的眼中，<N>就是得到來自天堂的禮物。<N><N>我在寫這段日記時有一可恥的認知：<N><N>我第一次發現，自從我在瘟疫中獲得能力以來，<N>我絕對有能耐可以讓人<LQ>融化別人的臉。<RQ>
$ENTRY_JOURNAL_PEACE_LEFT_0_20	我的臉一早就被融化了這是為什麼我就留這可笑的鬍子<N>好讓我的醜可以被掩蓋住還有我是[knight_hero_up]鬍子底下的臉<N>就像屁股一樣絕對不像大汗與卡麗斯的榮耀和力量<N>只不過更像一個又老有多皺紋的
$ENTRY_JOURNAL_PEACE_RIGHT_0_00	缺乏敵人不代表不需要暴力。
$ENTRY_JOURNAL_DREAM7_TITLE	
$ENTRY_JOURNAL_DREAM7_LEFT_0_00	第38天-分離之夢
$ENTRY_JOURNAL_DREAM7_LEFT_0_10	我現在睡得比較容易了，自從珍寶庫中發生的奇怪事件後，<N>我只因為尋常的原因，半夜醒過來一次。<N><N>夜晚是溫和的，我們睡覺時都把帳篷的布幕打開，<N>我醒過來時發現滿月的光輝正透過這個入口照了進來。這道光輝是如此的強烈，我近乎因為它而感到溫暖。<N><N>我所見到的引起了一種難以形容的感覺，好像要去回應一些事一樣。<N>我既疼苦又高興。再那一刻，我又開始說話了，<N><N>我嘴中喃喃自語道古怪外語好像<N>從我的思緒中逃離一樣，但是它們的意義還在徘徊。
$ENTRY_JOURNAL_DREAM7_LEFT_0_20	你來了嗎你來了嗎你來了嗎<N>是否帶著我分裂的心而來<N>去小貓我的黑暗<N>或是釋放它
$ENTRY_JOURNAL_ANTIAZRA_TITLE	
$ENTRY_JOURNAL_ANTIAZRA_LEFT_0_00	第37天- 泰都-米期理
$ENTRY_JOURNAL_ANTIAZRA_LEFT_0_10	實際上，我知道得很少，到底在珍寶庫中發生了什麼事。
$ENTRY_JOURNAL_ANTIAZRA_LEFT_0_20	我見到自己死了；或至少一個自己，泰都-米期理 (那火紅月亮)死了。
$ENTRY_JOURNAL_ANTIAZRA_LEFT_0_30	看著一個人然後對他說<LQ>我曾經是你是一件很古怪的事。<RQ>但是這確實是我的經歷。那股力量，那些失去，那些報復，<N>我都經歷過，最少都體驗過她所做過的事。現在我目睹了催毀她的犧牲。
$ENTRY_JOURNAL_ESCAPE_TITLE	
$ENTRY_JOURNAL_ESCAPE_LEFT_0_00	第39天-逃亡？
$ENTRY_JOURNAL_ESCAPE_LEFT_0_10	舍理米爾回歸了。他帶來一個陰險的提議：<N>用幾千條生命換取我們的自由和世界的救贖,讓洶湧的血海再加入新血。<N><N>[dragon_hero]獨自立於一旁。<N>[mage_hero]的嘴巴張開無語。<N><N>這就是我們的逃亡！<N><N>每一個選擇都是要和危險戰鬥的：<N>為了對抗舍理米爾，我賭上自己的生命，還有那些在以斯裡·特諾奇被釋放後會被殺的生靈。<N>我一定要對抗這個世界的命運！不過為了成全計畫，<N>我必須冒上生命危險。<N><N>我希望一早就在艾殊死去，我希望我可以有這個選擇。
$ENTRY_JOURNAL_FOLLOWING_ZELEMIR_TITLE	
$ENTRY_JOURNAL_FOLLOWING_ZELEMIR_LEFT_0_00	第40天–跟隨舍理米爾
$ENTRY_JOURNAL_FOLLOWING_ZELEMIR_LEFT_0_10	我不再質疑舍理米爾的方法是否瘋狂。<N>一切都有理有據 – 是一個大師級的戰略家去解決可怕詛咒的方法。
$ENTRY_JOURNAL_FOLLOWING_ZELEMIR_LEFT_0_20	這是最可惡的！
$ENTRY_JOURNAL_FOLLOWING_ZELEMIR_LEFT_0_30	對於一個為了與混亂戰鬥而謀殺無辜者性命的人來說<N>，這無疑是背叛了自己的追求。
$ENTRY_JOURNAL_FOLLOWING_ZELEMIR_LEFT_0_40	我曾經與他對抗，我會為了保護這些人一直與他戰鬥下去，直至我死亡為止。
$ENTRY_JOURNAL_EPILOGUE_TITLE	
$ENTRY_JOURNAL_EPILOGUE_LEFT_0_00	結語
$ENTRY_JOURNAL_EPILOGUE_LEFT_0_10	站著說<LQ>現在可沒有人想殺我了吧，<RQ>是一種很奇怪的感覺。<N><N>我現在還是半信半疑。我一直等著兇狠的羊沖入圖書館的大廳，不過我發現那只是一隻老鼠，<N>從保利蒙的植物正確使用法則論文中經過。<N><N>[knight_hero]已經成為圖書館的常客。上個月，<N>他想看幾乎是所有的軍事論文，我能找到的都找給他了，他可能也是索然無味，於是把興趣延伸至任何我可以在書架上取下的書。<N>我想他最後一本拿下的書是有關養豬倉鼠的手冊，我敢說他一定是隨手拿下的，<N>於是他整天都在跟我東拉西扯而不是看書。我就知道他也是悶的發瘋了。
$ENTRY_JOURNAL_EPILOGUE_RIGHT_0_00	不過，在把書上架排列時有人跟你聊天也是件快樂的事。<N>在瘟疫時，整個圖書館都被破壞，很多書都被用在燃料使用，所以當我來到時，這些書架都是空蕩蕩的。<N><N>[knight_hero]從諾曼族商人買來的幾本書，他都捐了出來。<N>我昨天也受到一個神秘的包裹，寫著<LQ>致[mcguffin_hero_up]，那個工作很沉悶遠遠比不上我那可以殺東西的女士<RQ><N><N>包裹中有幾本非常罕見的西方典籍，成書時間大約是3世紀，<N>還有很多粗略畫出的火柴人，上面標記著<LQ>我E<RQ>,每個小人都在殺怪物。<N>這些全都會存放在翻新後的東翼，當它竣工後，我們的後人都可以看到這些記錄。<N><N>我常常在想我這些老朋友的近況。
$ENTRY_JOURNAL_EPILOGUE_LEFT_1_00	不過是兩個月的時間，但是我知道對於[berserker_hero]和[ranger_hero]來說，這足夠完成好幾百次對冒險。<N><N>我很少聽到[mage_hero]的消息,<N>不過不時有來自諾曼的商人提及<LQ>廢墟中的瘋狂女王。<RQ>我這大約可以假設她在重新征服的領土中過得不錯。<N><N>有時候我也會害怕在瘟疫和亡者都消失後，奎德帝國會引來軍閥和野心勃勃的國王，<N>還有北方王國的覬覦。但是若是有誰人可以帶著微笑戰勝世界，<N>我相信會是[mage_hero]。<N><N>[healer_hero]回歸到他的寺廟，我不時會收到他的來信，<N>告訴我墓坑的轉變。商人，旅人和朝聖者慢慢開拓出道路，慢慢把消失的地方
$ENTRY_JOURNAL_EPILOGUE_RIGHT_1_00	重新發現。我有可能應他的邀請在下個月去看看。<N>這座城市正在慢慢重建，隨之而來的繁榮城市生活我都不太感興趣。<N><N>我的眼睛注目在廣闊的土地和遙遠的地平線上，許我也算是個冒險家吧。<N>我毫不懷疑[knight_hero]和他的隨從會陪我一起踏上旅程，令整個旅程更為安全，<N>如果我能夠哄他唱歌，那麼就更不會沉悶了。<N><N>我相信[dragon_hero]永遠離開<LQ>凡人<RQ>的世界，<N>不過我又不太確定。上周在圖書館的屋頂上有一堆金裝書，這可是需要一個熟練的攀爬高手背著很重的書爬到這麼高的位置。<N>我願意相信我們神秘的恩人懂得飛翔，<N>這就代表一個自以為神的生物找到一個可以替她訓練孩子的伴侶。
$ENTRY_JOURNAL_EPILOGUE_LEFT_2_00	我會繼續保持樂觀。<N><N>跟我們小團體以外的人交談是很奇怪的，<N>我開始把他們分為兩類，一種人是嘲笑我的說法，另一類則是被回歸家園的難民誇張故事寵壞了。<N><N>今天早上，我在街上被兩個孩子攔住，他們求我幫他們把那個折磨他們的孩子玩的臉給融化掉。<N>經常都是要融化臉，我一個憤怒的瞪視就可以把他嚇得尿褲子，這比融掉一個人的臉更受觀眾歡迎。<N>我也經常遇到要我治癒腳趾，祝福他的驢子，詛咒他們麻煩的鄰居等等的要求。<N><N>或許這就是為什麼我在圖書館見到[knight_hero]時會那樣高興吧。
$ENTRY_JOURNAL_EPILOGUE_RIGHT_2_00	我們從不談論過往的冒險，但是我們都有一個共識，<N>我不會和自己人以外的人去分享往事。<N><N>我想，何時我們才能再見面呢？<N><N>-[mcguffin_hero]尤姬利發巴
$ENTRY_JOURNAL_EPILOGUE_RIGHT_2_10	我想你何時才會把這本日記收得隱密一點呢<N>哈哈可能你永遠都不會因為我太厲害了<N>還有我的名字是[knight_hero_up]我並不那麼厲害我喜歡戴花<N>又喜歡穿紫色的裙子跳舞唱歌啦啦啦啦啦<N><N>說真的和[knight_hero_up]？我是否要寫出他的名字呢？你實在太
$ENTRY_JOURNAL_EPILOGUE_RIGHT_2_20	我一定要保留我的湯勺子。
$ENTRY_JOURNAL_EPILOGUE_LEFT_3_00	附錄
$ENTRY_JOURNAL_EPILOGUE_LEFT_3_10	在我們古怪又嘈雜的勝利過後的幾個月，我做了一個夢<N>-我猜是那曾佔據我做夢思緒的黑暗力量的迴響。<N><N>我經歷過漫長旅程後滿身塵土，我渺小的身軀從身後可怕的旅程中掙扎而出，<N><N>我穿過我家那道藍色大門，投入一個與我很相像的人的擁抱中。<N><N>我在他耳邊輕聲說出那個憂鬱的消息。<N><N>母親已經回來了。<N><N>我像孩童般的手中拿著她那乾燥的心。
$ENTRY_JOURNAL_INDEX_2_LEFT_10	@<LQ>鋼甲<RQ>@
$ENTRY_JOURNAL_INDEX_2_LEFT_20	@空間筆記@
$ENTRY_JOURNAL_INDEX_2_LEFT_30	@開場白@
$ENTRY_JOURNAL_INDEX_2_LEFT_40	@狂戰士與正確的刀鞘擺放位置@
$ENTRY_JOURNAL_INDEX_2_LEFT_50	@亡者之王@
$ENTRY_JOURNAL_INDEX_2_LEFT_60	@酋長的祭袍和世界樹@
$ENTRY_JOURNAL_INDEX_2_LEFT_70	@裁減的角色：聖騎士與保衛者@
$ENTRY_JOURNAL_INDEX_2_LEFT_80	@火焰之瞳@
$ENTRY_JOURNAL_INDEX_2_LEFT_90	@以斯裡·特諾奇的右手@
$ENTRY_JOURNAL_INDEX_2_LEFT_100	@箭術大師-嘉德蒙·達萊巴@
$ENTRY_JOURNAL_INDEX_2_LEFT_110	@引言@
$ENTRY_JOURNAL_INDEX_2_LEFT_120	@James最喜歡的三明治食譜@
$ENTRY_JOURNAL_INDEX_2_LEFT_130	@監獄長的馬具@
$ENTRY_JOURNAL_INDEX_2_LEFT_140	@馬可斯的鬍子@
$ENTRY_JOURNAL_INDEX_2_LEFT_150	@馬可斯的名字@
$ENTRY_JOURNAL_INDEX_2_LEFT_160	@馬可斯的裙子@
$ENTRY_JOURNAL_INDEX_2_LEFT_170	@馬可斯的咒語與五環書@
$ENTRY_JOURNAL_INDEX_2_LEFT_180	@認識狂戰士:被刪除的情節@
$ENTRY_JOURNAL_INDEX_2_LEFT_190	@名字與語言@
$ENTRY_JOURNAL_INDEX_2_LEFT_200	@魔鬼的命名@
$ENTRY_JOURNAL_INDEX_2_LEFT_210	@諾曼的靈魂崇拜@
$ENTRY_JOURNAL_INDEX_2_LEFT_220	@完@
$ENTRY_JOURNAL_INDEX_2_LEFT_230	@傷疤@
$ENTRY_JOURNAL_INDEX_2_LEFT_240	@圖書館管理員史勒@
$ENTRY_JOURNAL_INDEX_2_LEFT_250	@故事靈感@
$ENTRY_JOURNAL_INDEX_2_LEFT_260	@沃可蘭的力量@
$ENTRY_JOURNAL_INDEX_2_LEFT_270	@狂血部落@
$ENTRY_JOURNAL_INDEX_2_LEFT_280	@北方城邦@
$ENTRY_JOURNAL_INDEX_2_LEFT_290	@奎德王族的拜火教@
$ENTRY_JOURNAL_INDEX_2_LEFT_300	@瑟連裡@
$ENTRY_JOURNAL_INDEX_2_LEFT_310	@艾殊神廟@
$ENTRY_JOURNAL_INDEX_2_LEFT_320	@武僧的習慣@
$ENTRY_JOURNAL_INDEX_2_LEFT_330	@舍裡米爾之名@
$ENTRY_JOURNAL2_INTRODUCTION_TITLE	
$ENTRY_JOURNAL2_INTRODUCTION_LEFT_00	引言
$ENTRY_JOURNAL2_INTRODUCTION_LEFT_10	嘿大家好！這是我們幕後工作人員的秘密日記，這裡有許多酷炫的秘密和幕後資料，好像故事中某部分的靈感(大部分都是<LQ>我上一次見到太陽是什麼時候？<LQ>為什麼狼叔不回我那一封想跟他當好朋友的信呢？<RQ>但有時候有意思的故事讓你可能有興趣知道<LQ>瓦娜面上的傷疤是來自她在戰爭中被抓，為了不受折磨而嘗試自行割斷她的舌頭。<RQ>與及<LQ>我現在是作者，我可以任意使用括弧了！哈哈哈哈哈！<RQ> (認真點來說，就像俄羅斯娃娃一樣))<N><N>噢對了，應該好好介紹一下自己，我是James <LQ>魔鬼般帥氣的文案頭頭<RQ> Cavin.你大約可以從我的中間名中猜到，我就是為Defender's Quest: Valley of the Forgotten創作故事的。我也應該提及
$ENTRY_JOURNAL2_INTRODUCTION_RIGHT_0_00	Lars <LQ>雖然他不如James那樣英俊但是還可以了，我這可是帕拉圖式的稱讚啊。<RQ> Doucet,如果他不忙於程式設計的話，他負責寫部分物品和敵人相關的文案。(天啊，我們的父母在填寫我們的出生證明時，看來對我們前途都規劃的很清晰了。)
$ENTRY_JOURNAL2_INTRODUCTION_RIGHT_0_10	怎麼也好，這本幕後日記有所有酷酷的背景資料，世界觀設定，筆記，否決的想法等等。這就像窺視我們狂野又厲害的創作歷程，除了那些從垃圾桶找東西吃和哭著入睡的夜晚。我們一起經歷這個歷程吧！
$ENTRY_JOURNAL2_INTRODUCTION_RIGHT_0_20	還有，狼叔，如果你看到的話，你是否收到我的生日邀請函？相信我，那些悶蛋不會出現！我所有的毛公仔都會出席呢！
$ENTRY_JOURNAL2_INTRODUCTION_LEFT_1_00	
$ENTRY_JOURNAL2_INTRODUCTION_RIGHT_1_00	
$ENTRY_JOURNAL2_PLATEMAIL_TITLE	
$ENTRY_JOURNAL2_PLATEMAIL_LEFT_00	<LQ>鋼甲<RQ>
$ENTRY_JOURNAL2_PLATEMAIL_LEFT_10	很多人都經常用這個詞<LQ>鎧甲。<RQ>當它出現在Defender's Quest中時，我們把它用在一些重裝上，我立刻停下(瞪著那些德文長劍比劍文案)跳了起來。你看看，<LQ>鋼甲<RQ>是一個愚蠢又重複的詞，它不應該跟任何有價值的東西牽上關係。但是……如果是<LQ>鎖子甲，<RQ>跟鋼甲相比又如何呢？<LQ>鋼甲<RQ>是不是好一點呢?錯!<N><N>那個詞<LQ>甲<RQ> (或是你想花俏一點的話稱為<LQ>盔甲<RQ>),來自中世紀的法語，意思是<LQ>鎖鏈。<RQ>整個詞語<LQ>鎖子甲<RQ>其實是累贅了，它就在19世紀才出現。當<LQ>鎖子甲<RQ>進入了大眾的詞彙,大家都不知道<LQ>甲<RQ>的原本意思是什麼了，或許它就是代表<LQ>保護戰士的裝備吧。<RQ>現在大家動不動就加個甲子在任何原本應該被稱為裝備的東西上。
$ENTRY_JOURNAL2_PLATEMAIL_RIGHT_0_00	當我開始與大家產生距離時，我們要不換個話題？例如為什麼大家都要把所有東西都安上刺呢？那用來幹嘛？抱住一個人，刺死他？如果把你的手臂抬高30度，然後裝在你肩膀的11寸長的刺難道不會刺穿你的腦袋嗎？你真的會穿著隨時可以把你刺死的東西去戰鬥嗎？除非你<LQ>有隨意改變身體結構的技能吧。<RQ>喂喂！<N><N>大家都去哪裡呢？
$ENTRY_JOURNAL2_PLATEMAIL_LEFT_1_00	
$ENTRY_JOURNAL2_PLATEMAIL_RIGHT_1_00	
$ENTRY_JOURNAL2_DIMENSIONS_TITLE	
$ENTRY_JOURNAL2_DIMENSIONS_LEFT_00	空間筆記
$ENTRY_JOURNAL2_DIMENSIONS_LEFT_10	對於想要知道更多<LQ>中途世界<RQ>的朋友，以下就是我們內部的設計文檔，說明不同的空間如何運作：<N><N>現實是多層的狀態。我們所認知的是每一層<LQ>空間<RQ>或是<LQ>領域<RQ>中的一小部分，當中包括顏色，味道，觸感和香味等等，這些全部都是空間的一部分。我們的世界所體驗到的都不過是冰山一角，但是如果一個人能完全集中精神，他就可以分開那些層，完全去體驗那一空間。我們一直在探討的<LQ>領域<RQ>是<LQ>影<RQ>,正如角色所稱呼的一樣。這個影之領域是靈魂的空間-就像帕拉圖的理想狀態，但是每個事物都是存在的。每個生物都是被看不見的能量所激發的，我們很少經歷過這股力量，但是在影之領域這股靈魂的力量是可以充分被體驗和互動的。正如治療師如此說：
$ENTRY_JOURNAL2_DIMENSIONS_RIGHT_0_00	治癒師:你每一個感官都會給你一個細微的提示，有什麼在那裡。<N><N>麥高芬：原來如此。<N><N>治癒師：現實是層層構成的-<N><N>狂戰士:像蛋糕一樣嗎？<N><N>治癒師：是的…...就像蛋糕一樣。這些層是構成我們所經驗的世界-<N><N>狂戰士：什麼口味的蛋糕呢？<N><N>麥高芬：現實口味的！給我閉嘴！<N><N>狂戰士：額……現實口味的蛋糕。<N><N>
$ENTRY_JOURNAL2_DIMENSIONS_LEFT_1_00	
$ENTRY_JOURNAL2_DIMENSIONS_RIGHT_1_00	
$ENTRY_JOURNAL2_ACTQUOTES_TITLE	
$ENTRY_JOURNAL2_ACTQUOTES_LEFT_00	開場白
$ENTRY_JOURNAL2_ACTQUOTES_LEFT_10	我其中最喜歡的就是每段開場時，總會配上一小段字。它們讓我可以帶入其他情景，給讀者窺探一下世界觀的宏大設定。當第七幕開始時，我其實已經預備了3段開場白，不過我最後還是選了我最喜歡的一段，放入遊戲之中。這裡就是沒有選上的兩段：<N><N><LQ>當面對選擇，自私的人衡量結果，務求取得最大利益。衛道之人則會選擇伺奉聖火之道。<RQ><N>-摘錄自荊棘之道的七種智慧書。<N><N><LQ>我看著北方雇傭兵的臉，只看見末路賭徒的不忿與絕望，我們全都要死，但我會為了家國，為了王上，為了神廟而犧牲。他們不過是為了小額的金子而死。<RQ><N>-卡雷多道圍城的不知名守衛者
$ENTRY_JOURNAL2_ACTQUOTES_RIGHT_0_00	最終獲選的是這一段:<N><N><LQ>常言道人都怕死，但根據我的經驗，他們真正懼怕的是死後的未知性。在所有的疼苦中，當死亡是唯一可以想像的結果，我心內感受到前所未有的平靜。那唯一可以生存的機會才是我真正懼怕的。<RQ><N>-摘自箭神哥德蒙達拉巴的回憶錄：伺奉艾殊王的冒險和探險經歷。<N><N>這段引言的靈感是來自Gene Wolfe的著作“Shadow of the Torturer“。當我開始閱讀時，我正好在Defender's Quest的收尾階段(那時我並未發現這段靈感對我的影響，直至我完成整篇為主，我才發現呢)。這是一本很奇怪，令人感到不安的書，我並不建議年輕的讀者去閱讀。但是對於一個成又對體驗新世界時，這本書捕捉了一些作為另一世界的他者的感覺，這是在現代的小說中頗為新穎的。<N><N>說起靈感，每一幕都加上介紹引言的想法
$ENTRY_JOURNAL2_ACTQUOTES_LEFT_1_00	是來自我其中一個最喜歡的遊戲Thief: The Dark Projekt,。我認為這是我玩過的遊戲當中最具想像力,細緻入微又引人入勝的設定。盜賊大師嘉烈德靜靜地穿過影子之城，在冰冷的工業機器與神秘主義的恐怖之中游走，穿越在魔法與理性的戰鬥之中，我相信這是我一輩子不能忘記的。有時候我想到它時，我都要哭出來。雖然這可能跟我小時候吃下的玩具塗料有關……
$ENTRY_JOURNAL2_ACTQUOTES_RIGHT_1_00	
$ENTRY_JOURNAL2_BERSERKERS_TITLE	
$ENTRY_JOURNAL2_BERSERKERS_LEFT_00	狂戰士與正確的刀鞘擺放位置
$ENTRY_JOURNAL2_BERSERKERS_LEFT_10	啊，當一個酷酷的劍士把他的寶劍背在背上，總比像正常人一樣放再腰間要帥多了!沒錯實在是很帥！實際上我原本設計的狂戰士就是這個樣子的。幸好，我那追求歷史真相的強逼症令我不得不面對現實，就好像被人用鋼手套賞了一巴掌一樣的，因為這個想法就像是笨蛋才會這樣做。N><N>但Link!還有嘉烈德！還有忍者！<N><N>我背後的歷史強逼症小天使說：<N><N>你的背是一處好地方讓你帶上東西四處走的，例如：背包。<N><N>但是，如果你想從背上拔出你的武器，這是近乎不可能的！不相信的話，你試試啊，即使是大力士也沒可能
$ENTRY_JOURNAL2_BERSERKERS_RIGHT_0_00	從背上拔出任何東西呢(我記得曾經有個羅馬皇帝，好像是哈德良？曾經在文獻中吹噓說倫敦被征服後，他的軍隊可以背著武器在街上走動。因為……如果你有收襲擊的危險的話……你會希望隨手就可以拿到武器。)<N><N>下一次你看電影時如果看到酷酷的角色把劍（甚至兩把劍）都背在背上時，你不難發現他拔劍的動作都會被剪走。他只會從劍鞘拔出幾寸（或是加入一些金屬的撞擊聲，但是除非你的劍鞘中有碰撞你的劍的東西，否則你是絕對不會聽到這些聲音的）然後，他就帥氣地拿著劍了。這都是因為拔劍是人體結構上不可能的事，你不能從你的背上拔出比你前臂長的東西。除非，你不介意關節錯位吧。<N><N>現在，如果還有人對於從背後拔劍念念不忘，
$ENTRY_JOURNAL2_BERSERKERS_LEFT_1_00	你可能會說他們有一些特殊設計所以就能做到。他們大部分都是一些半劍鞘或是那一類的東西吧，它們都很愚蠢因為只有愚蠢的人會用他們，跟從腰間拔劍相比那簡直是太不方便了。（很多都在頂部帶一些大大的金屬環，所以你可以聽到金屬碰撞的聲音了，同時你的劍也毀了……因為那些環一直在碰撞你的劍刃。）<N><N>怎麼也好，當大家都對看起來<LQ>酷<RQ>的拔劍動作非常沉迷時，即使這是永不可能的，即使你載設計上精心設計過那些配件，但是像正常人一樣拔劍才是真正的目的吧。<N><N>幸好，我及時把錯誤改正過來，我們的狂戰士現在可以用一個正常，人體工學上可行的劍鞘來拔劍了。接下來，我花了兩個小時在YouTube上看德式長劍劍術比賽，邊看邊哭來懺悔我的罪行。
$ENTRY_JOURNAL2_BERSERKERS_RIGHT_1_00	PS:你可能會發現在一些3D遊戲中，角色都把劍背在背上，他們拔劍的時候劍都是從劍鞘的側面出來,而不是從頂部出來的。<N><N>PPS:有些拿破崙或維多利亞軍隊的軍刀都是用金屬的劍鞘，在口中帶有彈簧的，讓刀可以穩在鞘中,當他們拔刀的聲音就是電影最愛的配音了。這種彈簧也會磨損刀鋒，所以你看看現存的軍刀，他們都有明顯磨損的痕跡，因為每一次拔刀那道彈簧都會摩擦刀鋒。所以是的，那些酷炫的拔劍金屬聲確實存在，但非常有限，而且對劍長期來說是非常不好的。現在如果你允許的話，我要去看看有關比劍的文獻和手冊了。
$ENTRY_JOURNAL2_BOSSREVENANT_TITLE	
$ENTRY_JOURNAL2_BOSSREVENANT_LEFT_00	亡者之王
$ENTRY_JOURNAL2_BOSSREVENANT_LEFT_10	對於好奇我們亡者之王設定的朋友，以下就是我們內部設計文檔的解釋：<N><N>有些亡者是會比其他的更為強大，是否那位巫師投放多少靈力到那只操控物上面。再者，有些<LQ>殼<RQ>比起其他傳導性更佳。例如，一個強大的巫師可以棲息在松鼠的屍體中，雖然喪屍松鼠軍團好像很可笑，但是松鼠本身能承受的靈力肯定不如人類– 更不用說它們在影之領域的存在了。基本上，靈魂留下的虛空越大，巫師可以投入他個人靈力的空間就會越多(最理想的是剛死去的時候，因為當屍體開始腐爛是，他的靈魂空間也是開始崩潰。屍體越是放得久，可用之處就越少。)對於活生生的人來說也是同理，不是每一個人都有空間可以巫師施法。影之管道最多可以通過少部分他的靈魂，不會讓他們做出一些需要的能量遠超
$ENTRY_JOURNAL2_BOSSREVENANT_RIGHT_0_00	他們能承受的事。另一方面來說，一個人如果在靈魂上更有深度，自然就會有更大的空間可以操控 – 屍體越是新鮮，就有越大的虛空可以讓人乘虛而入。
$ENTRY_JOURNAL2_BOSSREVENANT_LEFT_1_00	
$ENTRY_JOURNAL2_BOSSREVENANT_RIGHT_1_00	
$ENTRY_JOURNAL2_CHIEFTANSTUNIC_TITLE	
$ENTRY_JOURNAL2_CHIEFTANSTUNIC_LEFT_00	酋長的祭袍和世界樹
$ENTRY_JOURNAL2_CHIEFTANSTUNIC_LEFT_10	酋長祭袍上裝飾著世界樹交纏的根，這是我為了加深文化意味和強調不同文化的民間傳說所作出的眾多努力之一，這次的物件就是諾曼族。<N><N>世界上很多文化都有世界樹的概念，但是我對於希臘的其中一個牽涉及巴爾幹半島妖精Kallikantzaroi特別著迷。Kallikantzaroi整年都住在地底下，為了鋸斷世界樹的根，好讓它倒下（所以世界也會倒下）。我猜它們就是那麼討厭吧。不過就在耶誕節那一天，它們差不多把樹根都鋸斷時，它們就會來到地面，跑來跑去實施惡作劇，好像在人家的啤酒撒尿，從孩子手上偷糖果，把你的牙刷放進馬桶，總之就是討厭鬼的表表者。它們會一直玩到
$ENTRY_JOURNAL2_CHIEFTANSTUNIC_RIGHT_0_00	頓悟之日，它們就會回歸地底。它們會發現原來它們才是鬧笑話的人，因為世界樹的傷口已經完全癒合了。這事每年都會發生因為Kallikantzaroi不只是討厭鬼，還是大笨蛋(我喜歡想像當它們不在時，世界樹往它們的啤酒中撒尿。)<N><N>噢！如果你想保護你的啤酒，糖果，還有牙刷，你只需要把一個漏勺放入包包中隨身帶著。Kallikantzaroi只可以數數到2，因為3是個神聖的數字，代表三為一體的神，如果其中一個Kallikantzaroi大聲說出來，它們立即就會死掉。如果你把湯勺隨身帶著，這些傻瓜就會徹夜去數上面的小孔，但是往往在數到第二個就數不下去。第二天你醒來時，第一件事就是拿出你的手槍，瘋狂掃射這幫討厭鬼，然後把它們掃盡垃圾桶，接下來你就可以安心喝你的啤酒來享受餘下的加起來。最少，我是這樣想的。
$ENTRY_JOURNAL2_CHIEFTANSTUNIC_LEFT_1_00	
$ENTRY_JOURNAL2_CHIEFTANSTUNIC_RIGHT_1_00	
$ENTRY_JOURNAL2_CUTCHARS_TITLE	
$ENTRY_JOURNAL2_CUTCHARS_LEFT_00	裁減的角色：聖騎士與保衛者
$ENTRY_JOURNAL2_CUTCHARS_LEFT_10	我們原本打算設計更龐大的陣型，但是為了更好管理2而不得不裁減一些角色，最後聖騎士和保衛者就是我們裁走的。<N><N>保衛者其實極具防衛優勢，是個<LQ>坦克<RQ>，用來保衛隊員的。他最大的特色是他不但可以保護自己，還可以保護身邊的隊友。所以當一個守衛者在受到攻擊時，保衛者會用他的盾牌格擋。故事方面，如果我記得沒錯的話，保衛者是來自艾殊的精英軍事狂熱者，相信他有責任去保衛他的成員曾經濺血的土地。部分保衛者的元素已經應用在騎士馬可斯身上，但是那些狂熱，<LQ>我們的血！愛國者之血！<RQ>等層面都被刪去了。
$ENTRY_JOURNAL2_CUTCHARS_RIGHT_0_00	聖騎士也是因為與騎士太過相像而被裁走。原本瓦娜就是屬於這個職業的-那個<LQ>瘋狂又好戰的敵方公主變成不情願的盟友<RQ>，看來這個帶劍的角色也不測啊。當這個職業被取消時，我覺得敵方公主這個角色實在太好，必須要把她用在其他地方，於是我們熟悉的冰霜法師就誕生了。<N><N>當我們還在討論如何改動職業時，那條龍原本其實是龍騎士，這個角色會是一個超級厲害的射手，他會騎著一條龍出現。如果是這樣，射手就會變成整個遊戲中過分強大的職業，所以我們就只好使用龍這個角色了。我想尼胡會同意這個做法吧。
$ENTRY_JOURNAL2_CUTCHARS_LEFT_1_00	
$ENTRY_JOURNAL2_CUTCHARS_RIGHT_1_00	
$ENTRY_JOURNAL2_EYEOFFLAME_TITLE	
$ENTRY_JOURNAL2_EYEOFFLAME_LEFT_00	火焰之瞳
$ENTRY_JOURNAL2_EYEOFFLAME_LEFT_10	這個物品的描述靈感是來自盎格魯-撒克遜的詩歌<LQ>廢墟(The Ruins)，<RQ>這是悼念羅馬城遺址等一首挽歌。這是詩歌只有在一部文獻中有記載，不過這部文獻已經嚴重損毀，詩歌的結尾部分只有斷斷續續的詞句。最後一組可以被理解的文字翻譯為<LQ>這是帝王的事……(It is a kingly thing...) <RQ><N><N>如果你從未讀過，我極力推薦你去買一本回來，花上十年去瞭解盎格魯-撒克遜的語言，用原文來閱讀。或者你可以找到翻譯本，但是你不能跟在派對上認識的人賣弄，然後在一個人對著牆用盎格魯-撒克遜罵髒話，最後被人家趕出派對了。因為盎格魯-撒克遜的髒話跟現代英語甚為相像。
$ENTRY_JOURNAL2_EYEOFFLAME_RIGHT_0_00	
$ENTRY_JOURNAL2_EYEOFFLAME_LEFT_1_00	
$ENTRY_JOURNAL2_EYEOFFLAME_RIGHT_1_00	
$ENTRY_JOURNAL2_RIGHTHAND_TITLE	
$ENTRY_JOURNAL2_RIGHTHAND_LEFT_00	以斯裡·特諾奇的右手
$ENTRY_JOURNAL2_RIGHTHAND_LEFT_10	我原本會把以斯裡·特諾奇的右手寫進故事中，呃，我指的是<LQ>右手<RQ>，就像我們平常說那個將軍是<LQ>國王的右手<RQ> –純粹是借喻。以斯裡特諾奇的右手原本指的就是一大群可怕的亡者，他們都是特諾奇的最佳僕人。
$ENTRY_JOURNAL2_RIGHTHAND_LEFT_20	但是不知道為什麼，事情變得跟文字非常貼近，於是乎遊戲中久出現了那恐怖的大手。我可不想重新再出美術，於是就在對話中加了一些解釋。這個誤會令其中一個Boss關卡變得令人印象深刻！(還有，Lars親自為右手配上文案的，所以<LQ>罪人<RQ>可不止我一個啊！)
$ENTRY_JOURNAL2_RIGHTHAND_RIGHT_0_00	
$ENTRY_JOURNAL2_RIGHTHAND_LEFT_1_00	
$ENTRY_JOURNAL2_RIGHTHAND_RIGHT_1_00	
$ENTRY_JOURNAL2_MASTEROFARCHERS_TITLE	
$ENTRY_JOURNAL2_MASTEROFARCHERS_LEFT_00	箭術大師-嘉德蒙·達萊巴
$ENTRY_JOURNAL2_MASTEROFARCHERS_LEFT_10	嘉德蒙·達萊巴有一句話被引用在我們其中一幕的開端，他是其中一個穿著箭術大師裝備的角色。<N><N>我曾經有個想法，想要寫一部有關他冒險的書，但是我一想到要顧及的細節我就要發瘋了。<N><N>不過，實在說不準呢……<N><N>(當然，我們的諾曼族冒險家卡勒卡達，也會有自己的故事啊。)
$ENTRY_JOURNAL2_MASTEROFARCHERS_RIGHT_0_00	
$ENTRY_JOURNAL2_MASTEROFARCHERS_LEFT_1_00	
$ENTRY_JOURNAL2_MASTEROFARCHERS_RIGHT_1_00	
$ENTRY_JOURNAL2_SANDWICH_TITLE	
$ENTRY_JOURNAL2_SANDWICH_LEFT_00	James最喜歡的三明治食譜
$ENTRY_JOURNAL2_SANDWICH_LEFT_10	啊，所有的寫作工作都已經令我饑腸轆轆了，你們餓了嗎？我可餓得不行。我們好好應對一下這個問題吧。<N><N>你將會需要：<N><N>香腸<N>雞蛋<N>麵包<N>番茄<N>德式醃青瓜<N>黃芥末<N>優格乳(沒有加糖加調味的那些，因為你不是小孩子了)<N>辣醬(我個人來說是偏好路易士安納州的風味，不過你可以隨意選擇你喜歡的。)
$ENTRY_JOURNAL2_SANDWICH_RIGHT_0_00	第一步：謀殺一些動物（最好是聽起來很厲害的那些，例如鯊魚。），然後攪碎牠的屍體，再把碎肉塞進腸衣。不過，你可以買香腸代替，但是就沒那麼好玩了。<N><N>第2步:把香腸切成長條狀。<N><N>第3步：<N>在平底鍋上煎這些香腸，記得要把它們煎得金黃又酥脆，但不要煎焦了。<N><N>第4步：<N>煎蛋（你想煎多少就煎多少吧，確保都能放進三明治就好。我自己會煎兩個，不過我不會阻止你煎更多的。）<N><N>第5步：<N>麵包看起來是目前最健康的材料，就把它丟進香腸的油中在煎一下吧，你需要很多的油。最重要的是：
$ENTRY_JOURNAL2_SANDWICH_LEFT_1_00	你需要把一些可能比較健康的東西，轉化為油膩的心臟病毒藥。記住，一頓大餐如果不能讓你後悔，你就是做錯了。<N><N>第6步：<N>現在是醬料的時候了！把黃芥末與優格乳以同等分量在碗中混合，記得要用力拌好，就像把你的敵人腦袋攪碎一樣，加入辣醬，試味，然後確保每一種材料都已經拌勻。如果你的平底鍋中還有些油剩下的話，也可以把它加入。<N><N>第7步：<N>是時候組裝三明治了！把醬汁塗在兩片麵包上，現在就可以不按順序把材料疊上去。這件偉大的傑作起碼有5寸高的。
$ENTRY_JOURNAL2_SANDWICH_RIGHT_1_00	第8步：<N>狼吞虎嚥。因為你所有的材料都沾滿了油，所以你的三明治會很快變得軟塌塌的。趕緊把它吃下啊！不要再猶豫了！你的憐憫就不了它的!<N><N>第9步<N>：後悔。
$ENTRY_JOURNAL2_LORDWARDEN_TITLE	
$ENTRY_JOURNAL2_LORDWARDEN_LEFT_00	監獄長的馬具
$ENTRY_JOURNAL2_LORDWARDEN_LEFT_10	原本，那個監獄長在故事中占了一個重要位置的。在我的初稿中，他是一個重要的對手，他秘密地被瘟疫感染了。他會用在艾殊王國中的權力去為瘟疫和瘟疫的創造者做一些迷信的工作。最後，他被舍裡米爾所取代，因為舍裡米爾的動機更有意思，也更複雜。但是，我非常喜歡監獄長這個設定，所以他轉生為一套裝備。嘿, 最少他的名字還留在遊戲中啊（比起其他裁掉的角色要幸運多了）。
$ENTRY_JOURNAL2_LORDWARDEN_RIGHT_0_00	
$ENTRY_JOURNAL2_LORDWARDEN_LEFT_1_00	
$ENTRY_JOURNAL2_LORDWARDEN_RIGHT_1_00	
$ENTRY_JOURNAL2_MARKOS_MUSTACHE_TITLE	
$ENTRY_JOURNAL2_MARKOS_MUSTACHE_LEFT_00	馬可斯的小鬍子
$ENTRY_JOURNAL2_MARKOS_MUSTACHE_LEFT_10	馬可斯的鬍子會是現在這個樣子是因為他原本的山羊鬍子會令人覺得，<LQ>他像是一個二手車的銷售員。<RQ>
$ENTRY_JOURNAL2_MARKOS_MUSTACHE_LEFT_20	他的面部特徵靈感是來自與盟軍將軍Ambrose Everett Burnside (多奇怪的名字)和搖滾樂團摩托頭的主音萊米（重金屬音樂之父，如果他搬到你家旁邊，你家的花園就會死的那種。）搖滾萬歲！兄弟，搖滾萬歲！
$ENTRY_JOURNAL2_MARKOS_MUSTACHE_LEFT_30	還有一個更令人佩服的事，那就是當你發現他用來刮鬍子的就是他的劍……
$ENTRY_JOURNAL2_MARKOS_MUSTACHE_RIGHT_0_00	
$ENTRY_JOURNAL2_MARKOS_MUSTACHE_LEFT_1_00	
$ENTRY_JOURNAL2_MARKOS_MUSTACHE_RIGHT_1_00	
$ENTRY_JOURNAL2_MARKOS_NAME_TITLE	
$ENTRY_JOURNAL2_MARKOS_NAME_LEFT_00	馬可斯的名字
$ENTRY_JOURNAL2_MARKOS_NAME_LEFT_10	馬可的名字來源於我一個好朋友，他在聖安德魯斯大學的一位教授告訴他一個古怪的故事。那位教授在年輕時，曾經去歐洲旅遊。在法國的時候，他會參觀一些開放給公眾的中世紀教堂。他對那些建築物非常著迷，所以決定從旅行團中偷走，藏起來，這樣他就可以在教堂關門的時候，偷偷享受獨自一人的參觀了,尤其是沒有指指點點的導遊囉嗦他。<N><N>他的計畫很成功，當教堂關門是，他就攝手攝腳走出他的藏身之處，開始他的遊覽。就在這個時候，他發現了在掛毯下面露出了一對鞋子，原來他不是唯一一個有同樣想法的人。那個藏身在掛毯後的原來是跟他是同一個旅行團的年輕女子，於是他們就開始一同遊覽教堂。
$ENTRY_JOURNAL2_MARKOS_NAME_RIGHT_0_00	他們一直興高采烈地聊天，完全沒有發現第三個人的來到，直到那個陌生人問他們想不想要來一個<LQ>秘密導嚮<RQ>。那個男人自稱馬可斯，有一頭亂糟糟的頭髮，不修邊幅的鬍子，還留著長長的指甲。他經常在教堂關門以後，藏身其中，然後他就會在晚上來探險,所有的幕後故事，還會在教堂的風琴上來一段即興表演。也就是這個時候他向他們解釋很多中世紀的教堂其實是再異教的建築物上興建的，很多時這些遺址依然存在於後來建築物之下。這就是為什麼他這樣鍾情於教堂，因為他是個德魯伊。很多時候，他在教堂的背面走走逛逛時，他在地面上發現一個小通道,讓他可以到達教堂的地下墓穴。這兩位遊客覺得跟一個陌生男人走進地下死亡室明顯沒有問題，所以他們就跟著馬可斯走。在那裡，他們發現異教徒的埋骨之地，也是教堂地底的真面目。拿起一些頭骨來把玩一下喉，馬可斯跟他們道別，他們就從此分開。
$ENTRY_JOURNAL2_MARKOS_NAME_LEFT_1_00	不久以後，教授與那以為年輕女子共諧連理。至於馬可斯呢？我相信他把自己塗成藍色，住在教堂地底下其中一個小石窟之中。<N><N>因為我太喜歡這個人了，所以我決定總有一天要用他的名字做些事。
$ENTRY_JOURNAL2_MARKOS_NAME_RIGHT_1_00	
$ENTRY_JOURNAL2_MARKOS_SKIRT_TITLE	
$ENTRY_JOURNAL2_MARKOS_SKIRT_LEFT_00	馬可斯的裙子
$ENTRY_JOURNAL2_MARKOS_SKIRT_LEFT_10	你們可能留意到，馬可斯的<LQ>裙子<RQ>是由一條條皮革組成的，叫做皮條裙。再告訴一件事吧！<N><N>你也可以在希臘和羅馬士兵身上見到類似的東西- 因為我很努力去賦予艾殊一種拜占庭/地中海的味道。
$ENTRY_JOURNAL2_MARKOS_SKIRT_RIGHT_0_00	
$ENTRY_JOURNAL2_MARKOS_SKIRT_LEFT_1_00	
$ENTRY_JOURNAL2_MARKOS_SKIRT_RIGHT_1_00	
$ENTRY_JOURNAL2_MARKOS_SPELL_TITLE	
$ENTRY_JOURNAL2_MARKOS_SPELL_LEFT_00	馬可斯的咒語和五環書
$ENTRY_JOURNAL2_MARKOS_SPELL_LEFT_10	不要用手臂之力刺出，要用靈魂之力量，身心合一，從你的身上比敵人扔出去。
$ENTRY_JOURNAL2_MARKOS_SPELL_LEFT_20	馬可斯的<LQ>咒語<RQ>靈感是來自“五環書”，一本成書於1645年有個武士道與劍術的厲害著作。作者是宮本武藏，是史上最著名的武士。他也是超級演員三船敏郎的靈感來源，如果你喜歡看他那種砍到成千上萬的人話，我極力推薦三船敏郎在五十年代的電影給你。(我絕對會邀請三船敏郎來參加我的生日派對，可惜的是在我11歲的時候，他就去世了。)
$ENTRY_JOURNAL2_MARKOS_SPELL_RIGHT_0_00	
$ENTRY_JOURNAL2_MARKOS_SPELL_LEFT_1_00	
$ENTRY_JOURNAL2_MARKOS_SPELL_RIGHT_1_00	
$ENTRY_JOURNAL2_MEET_BERSERKER_TITLE	
$ENTRY_JOURNAL2_MEET_BERSERKER_LEFT_00	認識狂戰士：<N>被刪除的情節
$ENTRY_JOURNAL2_MEET_BERSERKER_LEFT_10	原本，在第一場戰鬥之前，玩家是不會得到史勒的。第一場戰爭用Arza的閃電咒語就可以了，不過最後我們發現這樣回讓玩家覺得這是一個用咒語，而不是守衛者的遊戲。<N><N>於是，我們趕緊做調整，將史勒加入去，然後玩家就沒有那麼疑惑了！對於你們這些有興趣看看我們原本如何介紹史勒的話，以下就是舊過場的片段：<N><N>阿史娜:<N>(困惑)<N> <LQ>天啊……那到底是什麼？<RQ><N><N>阿史娜:<N>(疑惑)<N> <LQ>我到底躺了多久呢?<RQ>
$ENTRY_JOURNAL2_MEET_BERSERKER_RIGHT_0_00	(史勒進場)<N><N>史勒:<N>(興奮)<N> <LQ>這太厲害了!<RQ><N><N>阿史娜:<N>(疑惑)<N> <LQ>什麼?<RQ><N><N>史勒:<N>(興奮)<N> <LQ>你剛剛殺了近20個亡者！<RQ><N><N>阿史娜:<N>(疑惑)<N> <LQ>亡者?<RQ><N><N>史勒：<N>(隨意)<N> <LQ>你知道的，怪物，喪屍，死人頭，恐怖的東西，會動的死屍，吃人的, 就是亡者。<RQ>
$ENTRY_JOURNAL2_MEET_BERSERKER_LEFT_1_00	史勒:<N>(興奮)<N> <LQ>這實在太厲害了！<RQ><N><N>阿史娜:<N>(疑惑)<N> <LQ>聽著，我可不知道你說什麼。我只知道我現在很不舒服-<RQ><N><N>史勒:<N>(隨意)<N> <LQ>-還有他們把你丟進來等死的。<RQ><N><N>阿史娜<N>(疑惑)<N> <LQ>是的。<RQ><N><N>史勒：<N>(裝模作樣)<N> <LQ>那些喪屍就好像 “噢，我們可以吃掉你了。<RQ><N><N>史勒:<N>(瘋狂)
$ENTRY_JOURNAL2_MEET_BERSERKER_RIGHT_1_00	<LQ>之後你就像“我可不這樣認為，你這群傻蛋！吃我一記點擊死亡攻擊！”<RQ><N><N>史勒:<N>(畏縮)<N> <LQ>然後他們就像“啊!天啊！不要用你的超級死亡電擊來煎我們啊！天啊！好疼！天啊！燒著了！天啊！就像一千個太陽同時燒一樣!”<RQ><N><N>史勒：<N>(失望)<N> <LQ>然後我就說“哇靠！我可能偷不到她的鞋子了。<RQ><N><N>阿史娜:<N>(煩躁)<N> <LQ>...<RQ><N><N>史勒:<N>(隨意)<N> <LQ>忘了我剛剛說的吧。<RQ>
$ENTRY_JOURNAL2_MEET_BERSERKER_LEFT_2_00	阿史娜:<N>(煩躁)<N> <LQ>聽著，無論我多麼佩服你的戲劇表演。我完全不知道我為什麼在這裡，所以如果你不介意的話-<RQ><N><N>史勒：<N>(友善)<N> <LQ>吖，你很幸運，你剛剛碰上了全墓坑中最棒的響導！<RQ><N><N>阿史娜:<N>(煩躁)<N> <LQ>響導？<RQ><N><N>史勒：<N>(友善)<N> <LQ>聽著，這裡有各種的危險對於一個新人，好像你，是沒法生存超過五秒的，那些亡者，賊人，土匪……都會威脅你的性命。但是你現在可以以極低極低的成本，免費！來得到我的指引，這可是你唯一的希望啊！<RQ>
$ENTRY_JOURNAL2_MEET_BERSERKER_RIGHT_2_00	阿史娜:<N>(疑惑)<N> <LQ>免費? <RQ><N><N>史勒:<N>(友善)<N> <LQ>當然，那是出於我無敵性感又健壯的內心那無私的好意。我絕對沒有使用你超凡能力來累積個人財富的私心。<RQ><N><N>史勒：<N>(大聲公佈)<N> <LQ>第一站，奧斯蒙卡茲的偉大藏寶庫！<RQ>
$ENTRY_JOURNAL2_NAMES_LANG_TITLE	
$ENTRY_JOURNAL2_NAMES_LANG_LEFT_00	名字和語言
$ENTRY_JOURNAL2_NAMES_LANG_LEFT_10	很多人都提及過那些玩家在城中招募的小兵，名字都又古怪又不常見。這些名字是用來區別不同文化（艾殊，奎德和諾曼）的重要元素。
$ENTRY_JOURNAL2_NAMES_LANG_LEFT_15	你會發現有部分名字會帶有身體特徵。這是因為這個遊戲為身體特徵配了一個表，就像每一個文明都有一個文化相關的名字表一樣- 當玩家點擊來招募一個角色，遊戲會首先隨機抽取一個文化，然後在隨機生成一個名字，從那張文化表中抽取一個身體特徵。如果你對這三部分都有興趣，這就是我們舊的命名規則：
$ENTRY_JOURNAL2_NAMES_LANG_LEFT_20	這是我們角色的名字形檔。這些名字都會匹配上不同的文化。隨便加入一些你想到的吧，基本的應用原則如下：
$ENTRY_JOURNAL2_NAMES_LANG_RIGHT_0_00	艾殊名字：有很多Z 和V， 具有強烈的連續響音，普遍帶著地中海風格。男性的名字通常以-mon/man, -ir or -al做為結尾, 女性的名字通常以-a or -i 和有時候以<LQ>-vni<RQ>作為結尾。常用聲音組合包括<LQ>vn<RQ>和<LQ>zr<RQ>。<N><N>艾殊人的外表： <N><N>橄欖色，有時是非洲裔的膚色，例如<N><N>黑，棕，有時是混色金髮，有時是紅發。<N><N>棕色，淡褐色，還有藍色的眼睛。<N><N>整體而言，是地中海，希臘，日爾曼和阿拉伯風格的混合。艾殊人在外型上具有多種特徵，這是因為周邊民族跨種族通婚的關係。<N><N>諾曼名字：強而短的輔音，通常以非連續響音結尾。女性的名字常以-a結尾。K的發音通常會被強調，發音
$ENTRY_JOURNAL2_NAMES_LANG_LEFT_1_00	會傾向於<LQ>sk<RQ>和<LQ>st<RQ>，還有這是唯一使用J發音的語言。
$ENTRY_JOURNAL2_NAMES_LANG_LEFT_1_10	諾曼的外形：<N><N>淺棕色皮膚。<N>綠色，藍色和淡褐色的眼睛。<N>深深淺淺的紅棕發色，有時也有黑髮。
$ENTRY_JOURNAL2_NAMES_LANG_LEFT_1_20	整體來說，是羅曼尼與阿富汗的風格。人口偏小與通常與自己人通婚，會帶來獨特的基因辨識度，例如紅發與綠眼，這些都是較為常見。奎德名字- 通常有很多W與L，靈感是來自威爾斯和夏威夷，當中也沒有哪一個是主導的（因為我在找艾殊名字沒有用到的字母時，好像就只有L跟W了）,還帶有一點盎格魯-撒克遜語的影響,奎德傾向用C而不是K, 用Y 而不用I。女性的名字通常以-a和<LQ>-nna.<RQ>作為結尾。
$ENTRY_JOURNAL2_NAMES_LANG_RIGHT_1_00	奎德族的外形：<N><N>非常白的皮膚<N>非常黑或是非常淺色的頭髮(兩種極端，很少有中間的).人口中金髮的數量比較少，通常是王族才比較常見。<N>黑(指的是非常深的棕色),深棕色和灰色的眼。<N><N>整體來說，是威爾斯，挪威和遠東的混合。<N><N>艾殊名字:<N><N>Zir<N>Kered<N>Kolos<N>Teluman<N>Gozal<N>Gozra (女性)<N>Sivnah (女性)<N>Zamena (女性)<N>Hektamon<N>Devdi (女性)
$ENTRY_JOURNAL2_NAMES_LANG_LEFT_2_00	Tavida (女性)<N>Yoavna (女性)<N>Kesmir<N>Vasmon<N>Zenimon<N>Kastal<N>Kavni (女性)<N>Bazan<N>Evni (女性)<N>Rostal<N>Kezal<N>Tezra (女性)<N>Zinak<N>Restavni (女性)<N>Sedemon<N>Zerevna (女性)<N>Ezran<N>Tanos<N>Yevkani (女性)<N>Keznimon<N>Ayimi (女性)<N>Admon<N>Azakal<N>Bakaza
$ENTRY_JOURNAL2_NAMES_LANG_RIGHT_2_00	Kevnimi (女性)<N><N>Nomad Names:<N><N>Senna (女性)<N>Koat<N>Kem<N>Raska (女性)<N>Saja (女性)<N>Tulk<N>Rendt<N>Senga (女性)<N>Jast<N>Pak<N>Tanna (女性)<N>Dank<N>Serk<N>Drask<N>Sotta (女性)<N>Leska (女性)<N>Joata (女性)<N>Saj<N>Het<N>Tetch
$ENTRY_JOURNAL2_NAMES_LANG_LEFT_3_00	Nesk<N>Dysta (女性)<N>Skod<N>Senji (女性)<N>Klest<N>Zekka (女性)<N>Kask<N>Droat<N>Jek<N>Jekka (女性)<N>Kaji (女性)<N>Plosk<N>Skent<N>Foska (女性)<N>Fytt<N>Zesk<N>Sajesh<N><N><N>Quaid Names:<N><N>Lawan<N>Sawul<N>Wassa
$ENTRY_JOURNAL2_NAMES_LANG_RIGHT_3_00	Aluwo<N>Sanna (女性)<N>Wocolan<N>Celu<N>Laclanna (女性)<N>Walucella (女性)<N>Xeowan<N>Xeowanna (女性)<N>Wastan<N>Luwella (女性)<N>Lumenna (女性)<N>Stawan<N>Wacali (女性)<N>Neorxennawanga (女性)<N>Centawal<N>Solowan<N>Cyleth<N>Wulacal<N>Cedmal<N>Lanna (女性)<N>Hylla (女性)<N>Hywada (女性)<N>Walacanna (女性)<N>Cullad
$ENTRY_JOURNAL2_NAMES_LANG_LEFT_4_00	Cuwain<N>Cella (女性)<N>Celuwanna (女性)<N>Celuwon<N>Cylehal<N>Awan<N>Alenna (女性)<N>Awucella (女性)<N>Awucan<N>Iowan<N>Ittella (女性)<N>Walla<N>Lacan
$ENTRY_JOURNAL2_NAMINGEVIL_TITLE	
$ENTRY_JOURNAL2_NAMINGEVIL_LEFT_00	魔鬼的命名
$ENTRY_JOURNAL2_NAMINGEVIL_LEFT_10	當要命名我們的大壞蛋時，我想要用上一個特別有異國格調的名字，好讓他與我們的角色跟他們的國家有所區別。有一個比較複雜的問題就是我們的三個文明本身已經存在比較明顯的區別。<N><N>於是我決定使用那瓦特(阿茲特克)名字，因為這個語言與我們其他使用的現實語言是有明顯的區別(艾殊使用希臘和阿拉伯語，奎德使用威爾斯，夏威夷和盎格魯-撒克遜,諾曼使用加工過的北歐語和阿富汗語)。<N><N>現在回想起來，混合使用真實世界的名字（好像阿史娜與舍裡米爾）與完全創造出來的名字（好像可塔與巴卡），有點奇怪，不過我個人還是覺得挺符合角色扮演遊戲的風格的。<N><N>據Lars 所說，我們這個遊戲都可以用一句句子總結，<LQ>一段追殺到最後有一個阿茲特克神明被埋葬。<RQ>
$ENTRY_JOURNAL2_NAMINGEVIL_RIGHT_0_00	
$ENTRY_JOURNAL2_NAMINGEVIL_LEFT_1_00	
$ENTRY_JOURNAL2_NAMINGEVIL_RIGHT_1_00	
$ENTRY_JOURNAL2_NOMADSPIRIT_TITLE	
$ENTRY_JOURNAL2_NOMADSPIRIT_LEFT_00	諾曼的靈魂崇拜
$ENTRY_JOURNAL2_NOMADSPIRIT_LEFT_10	原本，諾曼族是部落式多神論。每個部落都有自己崇拜的神祇(在不同的部落中，不同的家庭都會有他們家庭專屬的守護神或是半神人)，有不同的偶像來代表。這些神祇都是為了部落的利益而存在的，作為交換祂們也必須受到崇拜和侍奉的。內訌和紛爭在不同部落之間常常發生，因為遊牧民族的特性讓他們經常侵犯別人的領土，習慣搶掠和爭奪。部落的神祇就是這些衝突的標準。一個部落失去自己偶像是極端侮辱的事(除非他們能透過戰爭把偶像搶回來)，通常這代表這個部落的消亡。一個沒有神祇的部落地位是非常低下的，往往不能和其他部落通商和被排除在會議之外。<N><N>每個諾曼族的人都會在出生時收到一個個人專屬的偶像，這代表部落神祇的僕人。這些僕人靈魂是每一個人的守護神。當一個諾曼族人去世時，他一定要與自己的小木雕合葬，因為這個木雕會確保他的靈魂可以順利通過前往天堂的道路。一個諾曼族人如果不見了
$ENTRY_JOURNAL2_NOMADSPIRIT_RIGHT_0_00	自己的木雕，這可是天大的事情。沒有守護神的引領，一個諾曼族的鬼魂會花上很長的時間來尋找前往天堂的道路。<N>與艾殊王國長期保持緊密的通商與交往，有很多部落也相信了艾殊神廟的教導。只有少數的諾曼人會願意完全放棄舊信仰，改信艾殊神廟。大部分人傾向與艾殊的神明融和，這些信仰上的得過且過和艾殊王國對諾曼族的偏見，經常會引發宗教衝突。
$ENTRY_JOURNAL2_NOMADSPIRIT_LEFT_1_00	
$ENTRY_JOURNAL2_NOMADSPIRIT_RIGHT_1_00	
$ENTRY_JOURNAL2_SCARS_TITLE	
$ENTRY_JOURNAL2_SCARS_LEFT_00	傷疤
$ENTRY_JOURNAL2_SCARS_LEFT_10	我們並沒有在故事中提及，不過烏仁娜臉上的傷疤是來自艾殊和奎德的戰爭。當時她被俘虜了，因為懼怕她會在受逼供後，吐露出秘密，所以她想把自己的舌頭割掉，以防止背叛自己的國家。原本，這些傷疤都是蠻顯眼的，但是為了不讓她看起來像蝙蝠俠中的小丑，我們決定在淡化一點。<N><N>烏仁娜是唯一一個角色跟傷疤有關聯的，所以我們嘗試把其他墓坑生還者的傷疤以另外一些方式表達。這不單只加強了墓坑的危險性和經常有暴力事件出現的形象，也讓阿史娜更像一個<LQ>新人。<RQ>在墓坑中，她初來乍到，所以並沒有像其他人一樣有老傷疤。
$ENTRY_JOURNAL2_SCARS_RIGHT_0_00	
$ENTRY_JOURNAL2_SCARS_LEFT_1_00	
$ENTRY_JOURNAL2_SCARS_RIGHT_1_00	
$ENTRY_JOURNAL2_SLAKLIBRARIAN_TITLE	
$ENTRY_JOURNAL2_SLAKLIBRARIAN_LEFT_00	圖書館管理員史勒
$ENTRY_JOURNAL2_SLAKLIBRARIAN_LEFT_10	你知道嗎？原本的圖書館管理員，是史勒而非阿史娜，<N><N>在原本的介紹中是這樣寫的：
$ENTRY_JOURNAL2_SLAKLIBRARIAN_LEFT_20	職業：在被監禁以前，他是個首都圖書館管理員的一名成員。現在，在墓坑之中，他是一個職業的冒險家和雇傭兵。<N><N>教育程度：非常高，最喜歡的是歷史與傳奇文學，非常討厭應用科學和數學。<N>
$ENTRY_JOURNAL2_SLAKLIBRARIAN_LEFT_30	最後，我們把他的背景設定給了阿史娜,讓她成為那個神經質，經常揮舞湯勺子的圖書館管理員。史勒呢……有了一個全新的設定。
$ENTRY_JOURNAL2_SLAKLIBRARIAN_RIGHT_0_00	
$ENTRY_JOURNAL2_SLAKLIBRARIAN_LEFT_1_00	
$ENTRY_JOURNAL2_SLAKLIBRARIAN_RIGHT_1_00	
$ENTRY_JOURNAL2_STORYINSPIRE_TITLE	
$ENTRY_JOURNAL2_STORYINSPIRE_LEFT_00	故事靈感
$ENTRY_JOURNAL2_STORYINSPIRE_LEFT_10	有一個英語專業的朋友曾經問我Valley of the Forgotten的靈感來源，對於感興趣的人來說，以下是我寫作的時候經常出現在我腦海的東西：
$ENTRY_JOURNAL2_STORYINSPIRE_LEFT_20	瘟疫殖民地的概念其實是來自拉迪亞德·吉卜林（Rudyard Kipling）的短篇小說”The Strange Ride of Morrowbie Jukes”。我在11或是12歲的時候就讀過這本書，那個自然形成的監獄，滿滿都是人，他們原本應該已經<LQ>死了的<RQ>，卻後來痊癒了，這讓我印象非常深刻。瘟疫社會強烈的景象也啟發了我創作墓坑的一些細節（好像那裡並沒有馬。Morrowbie 遭遇的第一件事就是他的馬被人殺來吃，不過他也分到一份肉，所以並沒有那麼糟糕。）
$ENTRY_JOURNAL2_STORYINSPIRE_LEFT_30	除此以外，很多文化的元素來自於拜占庭的歷史記錄。很多瑟連裡文化都是來自仙逝的偉人
$ENTRY_JOURNAL2_STORYINSPIRE_RIGHT_0_00	和早期東方基督教徒的手稿。
$ENTRY_JOURNAL2_STORYINSPIRE_RIGHT_0_10	還有我是一個歷史文學的書呆子，很多靈感是來自盎格魯-撒克遜的文學。當我開始進行Defender's Quest的創作時，我開始了古英語這門課，於是當中的語言和文化對近乎所有東西都有影響。那種憂鬱有哀傷的語調看起來非常符合我們這個中世紀後末世時代設定。
$ENTRY_JOURNAL2_STORYINSPIRE_RIGHT_0_20	如果你對這一類的東西很感興趣的話，我非常推薦“The Ruin”。它雖然短，但是包含了所有盎格魯-撒克遜文學的死亡氣息。
$ENTRY_JOURNAL2_STORYINSPIRE_RIGHT_0_30	當然，那裡有很多東西在背後，但是這三個是對設定有最大的影響。嘿，這有我最喜歡的幽默作家的影響。
$ENTRY_JOURNAL2_STORYINSPIRE_LEFT_1_00	
$ENTRY_JOURNAL2_STORYINSPIRE_RIGHT_1_00	
$ENTRY_JOURNAL2_WOCOLAN_TITLE	
$ENTRY_JOURNAL2_WOCOLAN_LEFT_00	沃可蘭的力量
$ENTRY_JOURNAL2_WOCOLAN_LEFT_10	描述<LQ>沃可蘭裝備重型武器後，圖手把一隻熊的頭打碎<RQ>，是意圖將奎德神話的背景再增加深度。<LQ>之後，他的孩子瓦斯坦與瓦絲拉因為喝下熊口中流下的鮮血，而可以在折磨人的家族放逐路途中撐過來。<RQ>我們並沒有細寫，但是沃可蘭和孩子的故事，就是奎德族起源的傳說，對他們的宗教也有深遠的影響。在他流放的過程中，沃可蘭被宇宙之焰選中並賦予力量，不止是為了讓他通過嚴峻的考驗，而是為了讓他可以建立奎德族。<N><N>我嘗試令整個故事更加古怪，更有傳說的感覺。任何時候如果你想讓一個故事更有<LQ>遠古的宗教<RQ>色彩，你只需要讓他們吃一些很噁心的東西。(或是你也可以走古埃及的路線，不過那可是頗為兒童不宜呢。)
$ENTRY_JOURNAL2_WOCOLAN_RIGHT_0_00	
$ENTRY_JOURNAL2_WOCOLAN_LEFT_1_00	
$ENTRY_JOURNAL2_WOCOLAN_RIGHT_1_00	
$ENTRY_JOURNAL2_BLOODMAD_TITLE	
$ENTRY_JOURNAL2_BLOODMAD_LEFT_00	狂血部落
$ENTRY_JOURNAL2_BLOODMAD_LEFT_10	諾曼族其實是一個屬於以斯裡·特諾奇管治的古文明的殘餘人口。當以斯裡·特諾奇被打敗後，他們流離失所，變成今天我們所認識的多神崇拜遊牧部落。不過他們還是有些人忠於他們被擊敗的<LQ>神<RQ>，在他們神秘的女王領導下，組織成一個以解放以斯裡·特諾奇的死亡薩滿教派。這些部落圍繞著Eztli的監獄聚居，用他們唯一知道的辦法來嘗試打破封印，那就是殺人後將那些血塗在巨石之上，希望有一天他們可以抓到對的人來打破封印。大家都很快知道要避開那些地方，所以血教迅速擴大地盤，最終開始影響到奎德帝國。很明顯，把所有你遇見的人都殺來獻祭並不是什麼好主意，也對宇宙之焰來說是個侮辱，所以奎德者也發動了幾次戰爭來對抗這些異教徒（就是烏仁娜所說的那些）。
$ENTRY_JOURNAL2_BLOODMAD_RIGHT_0_00	這些異教徒雖然散居各處，但是依然是個潛在的威脅。就在幾個世紀以前，他們的女王消失了，這些異教徒失去了進行複雜獻祭的意義，很多血族沒有在巨石附近聚居，改為崇拜一個比較小的代替品，進行獻祭。不過，以斯裡·特諾奇在某程度上被釋放後，他就去找自己散落四處的孩子。血族的薩滿聽到他的呼召後，就帶領人民重返墓坑，回到囚禁他們神的巨石監獄附近。<N><N>這些異教徒維持著一種有毒的飲食(舍裡米爾用在奧斯蒙身上那種)，保持著一種近乎瘋狂的執念，就是相信他們可以被主人的靈魂所支配。這種有毒的飲食讓他們可以在需要的時候邊成亡者(以斯裡·特諾奇的右手就是一個薩滿，或是一群薩滿，願意為了他們的主人獻身變成可怕的工具)。<N><N>Ketta的部落-革卡就是當她十來歲的時候，就被血族所屠殺，這也是為什麼她對自己部落比較陌生，這也是她可以
$ENTRY_JOURNAL2_BLOODMAD_LEFT_1_00	認出她們的原因。<N><N>舍裡米爾在奧斯蒙的飲食中下毒，是Lars 的主意。如果沒有這個主意，我可沒有狂血部落這個靈感。(原本，奧斯蒙是在被舍裡米爾殘忍地殺死後，才變為亡者，但是我那昆汀·塔倫蒂諾式的大屠殺被否決了，我還是更喜歡毒殺。順帶一說，那個眼罩長槍手，就是那個莫名奇妙地吸引了一堆小粉絲的，其實他原本也是死在混戰之中)。<N>
$ENTRY_JOURNAL2_BLOODMAD_RIGHT_1_00	
$ENTRY_JOURNAL2_CITYSTATES_TITLE	
$ENTRY_JOURNAL2_CITYSTATES_LEFT_00	北方城邦
$ENTRY_JOURNAL2_CITYSTATES_LEFT_10	當我為了HD版的上線做準備時，要將故事擴展，我發現了一本舊的設計記事本。明顯地，在過去某段日子，我曾經想把遊戲中提及的北方城邦命名為卡革斯。我認為這聽起來挺酷的，所以我就把它應用在遊戲之中。我驚奇于這本封塵的記事本竟然像一個魔法的入口一樣，把我引領進一個不需要再多幹活的時光中。很明顯，我們的冰霜法師是個命名為Laz的男人，他是修理鐘錶的工匠。還有最後一頁是一張<LQ>清單<RQ>，寫著:<N><N>1.倒垃圾<N>2.打電話給水喉修理工來把漏水修理好<N>3.中彩票，娶一個芬蘭的超模或是公主，然後搬去加勒比的一個小島，建一個城堡，生2.5個小孩。<N><N>你猜猜我做到了哪些？我的垃圾還在垃圾桶中。
$ENTRY_JOURNAL2_CITYSTATES_RIGHT_0_00	
$ENTRY_JOURNAL2_CITYSTATES_LEFT_1_00	
$ENTRY_JOURNAL2_CITYSTATES_RIGHT_1_00	
$ENTRY_JOURNAL2_FIRECULT_TITLE	
$ENTRY_JOURNAL2_FIRECULT_LEFT_00	奎德王族的拜火教
$ENTRY_JOURNAL2_FIRECULT_LEFT_10	奎德帝國擁有較為悠久的歷史，它的宗教都是比較古老，雖然它是在歲月中慢慢把周邊國家的宗教元素吸收進來。整體而言，王家宗教是以火為中心，比較嚴謹的一神崇拜。<N><N>王室成員都相信自己是宇宙之焰選中的孩子。只要為奎德帝國帶來榮耀，他們就可以獲得死後跟隨先祖的權利。那些為帝國帶來榮耀的王室成員名字會被記錄在王宮的巨大石碑中，這就好像是一種通行證，代表著誰在死後可以通過一樣。而那些不能為帝國帶來任何榮耀的則會收到歷史的評擊，而且他們的遺體也不能火化，只能土葬，這可以一件非常不名譽的事情，因為火葬是唯一可以回歸宇宙之焰的方法。
$ENTRY_JOURNAL2_FIRECULT_RIGHT_0_00	這意味著貴族比起平民享有更多的特權，因為他們肩負著更多的期望。<N><N>很多國王被推翻或是被殺就是因為他們漠視了自己的職責。與艾殊的戰爭持續了好幾代的統治者，因為這在戰爭中更為容易<LQ>為國家帶來榮耀<RQ>。
$ENTRY_JOURNAL2_FIRECULT_LEFT_1_00	
$ENTRY_JOURNAL2_FIRECULT_RIGHT_1_00	
$ENTRY_JOURNAL2_SELINI_TITLE	
$ENTRY_JOURNAL2_SELINI_LEFT_00	瑟連裡
$ENTRY_JOURNAL2_SELINI_LEFT_10	艾殊神廟中不同的思想流派是很常見的，瑟連裡派就是仿效宗教的始創人瑟連達的生活，追求重整世界的平衡。他們相信通過個人禁欲與侍奉身邊的世界就可以做到。很多瑟連裡的寺廟都在戰亂地區或是其他不平靜地區作為醫院或是避難所地存在。
$ENTRY_JOURNAL2_SELINI_RIGHT_0_00	
$ENTRY_JOURNAL2_SELINI_LEFT_1_00	
$ENTRY_JOURNAL2_SELINI_RIGHT_1_00	
$ENTRY_JOURNAL2_ASHTEMPLE_TITLE	
$ENTRY_JOURNAL2_ASHTEMPLE_LEFT_00	艾殊神廟
$ENTRY_JOURNAL2_ASHTEMPLE_LEFT_10	艾殊神廟是一個以君主政體為核心的一神宗教，中心思想在於平衡與社區互動。世界就像一部大型機器，一切的動力來自于它的那永恆不變的創造者，每個人都有存在的意義，是這個大型機器中的一個小零件，所以每一個人都有責任保持平衡。不能做到或是失去平衡就是惡魔的象徵(這個地方都是被社會結構所控制，大家都很重視指揮鏈和存在鏈)。整個宗教的中心就是那座高高的神廟，那曾經是創始人的學校。在神廟儀式中，水是重要的元素，水的不同形態就是保持世界平衡的完美象徵。死亡後，那些在地上滿足了存活目的的人，會被創造者帶往神聖之地，基本上是完美的所在。<N>艾殊神廟是由來自北方的流亡哲學家瑟連達所創立。
$ENTRY_JOURNAL2_ASHTEMPLE_RIGHT_0_00	由於政治對手的逼害,瑟連達向南方出走，為不同的統治者擔任幕僚。他在一場謎語比賽擊敗其他智者後，艾殊的國王就把他迎回國內。由於國王是第一個信徒，所以瑟連達的宗教哲學很快就在整個地區流行起來。<N><N>因為國王是第一個信徒，他的繼承者也被視為管理神廟的人。整個王國的周邊地區都信奉著同樣的宗教，但是還是一艾殊神廟為中心。因為這個原因，艾殊一直都對於周邊國家爆發的戰爭保持中立態度。只有很少的時候，當它的鄰居收到威脅，它才會與其他的國家聯合起來，共同為保衛神廟而戰。這種中立的態度讓艾殊成為繁榮的商業中心，大大提高了它的影響力。面對奎德帝國的威脅，艾殊王國周邊的小國都聯合起來，成為事實聯邦，這令到艾殊帝國的規模龐大之餘，國內又相對獨立。
$ENTRY_JOURNAL2_ASHTEMPLE_LEFT_1_00	
$ENTRY_JOURNAL2_ASHTEMPLE_RIGHT_1_00	
$ENTRY_JOURNAL2_WARRIORMONK_TITLE	
$ENTRY_JOURNAL2_WARRIORMONK_LEFT_00	瑟連裡的第9分支-真理與秩序的捍衛者-護教教派
$ENTRY_JOURNAL2_WARRIORMONK_LEFT_10	艾殊宗教最大的靈感來源，尤其是瑟連裡等元素的，其實大多來自東方基督教。當我寫作的時候，我也有擔心這樣會不會太明顯。我急切希望避免直接複製現實的宗教至虛擬的故事世界中，而不是為這個世界創作更符合其世界觀的宗教。<N><N>於是，我開始找尋艾殊哲學跟我靈感中的不同之處，看看那些價值是如何演變為這個設定中特別的一環。其中和平主意立馬獲得我的注意。東方基督教即使某程度上依然允許有限度度必要暴力，但是還是保留了令人難以置信的和平主意氛圍。神職人員是絕對不可以殺人，即使是自衛（平民自衛的話也是不被認同的）。當進行禮拜儀式，就是教會生活的中心時，祭師必須進行
$ENTRY_JOURNAL2_WARRIORMONK_RIGHT_0_00	<LQ>無血獻祭<RQ>。(實際上，如果神職人員遇上意外，例如一場有人命傷亡的車禍，他以後就不可以再進行侍奉了。)<N>這看起來跟我所創作的瑟連裡哲學有較大的出入。在艾殊的宗教中，暴力是可以被視為進行神聖職務是其中一種必然手段。有時候，對於機器來說，你必須要移除已經壞了的零件，避免它會破壞其他零件。誰會比瑟連裡的戰士更適合來進行這個任務呢？當瑟連裡認為暴力是最後的解決辦法是，他們並沒有任何禁忌來阻止神職人員或是僧侶去使用暴力，就像我並沒有加入<LQ>無血奉獻<RQ>作為中心思想。<N><N>這是我們武僧的靈感來源，即使他們並沒有在遊戲當中出現，但是他們是在背景中存在的。(有很多章節有關瑟連裡教派，但是只有很少是與<LQ>護教教派<RQ>有關。巴可是更為愛好和平的教派。)武僧，
$ENTRY_JOURNAL2_WARRIORMONK_LEFT_1_00	，基於種性與社會等級的制度,創造者永恆不變的神聖，還有水的儀式等等，都讓我覺得艾殊神廟是一個新東西，而不是從現實世界的宗教照搬過來。
$ENTRY_JOURNAL2_WARRIORMONK_RIGHT_1_00	
$ENTRY_JOURNAL2_ZELEMIR_NAME_TITLE	
$ENTRY_JOURNAL2_ZELEMIR_NAME_LEFT_00	舍裡米爾之名
$ENTRY_JOURNAL2_ZELEMIR_NAME_LEFT_10	我選擇這個名字的原因有二：1）它以Z開始，聽起來很酷， 2）在古老的斯拉夫語中，它的意思是<LQ>對和平的渴望<RQ>。有趣的是，<LQ>和平<RQ>這個字(原文中的<LQ>mir<RQ>)另外一個意思是指<LQ>世界。<RQ>所以他的名字另外一重意義就是<LQ>對世界的渴望。<RQ>我覺得這對於我們心中充滿矛盾的壞蛋來說是非常合襯的名字。
$ENTRY_JOURNAL2_ZELEMIR_NAME_RIGHT_0_00	
$ENTRY_JOURNAL2_ZELEMIR_NAME_LEFT_1_00	
$ENTRY_JOURNAL2_ZELEMIR_NAME_RIGHT_1_00	
$ENTRY_JOURNAL2_OUTRO_TITLE	
$ENTRY_JOURNAL2_OUTRO_LEFT_00	完
$ENTRY_JOURNAL2_OUTRO_LEFT_10	那是什麼？代表幕後製作日記的完結？
$ENTRY_JOURNAL2_OUTRO_LEFT_20	多麼緊張刺激的旅程啊！我們笑過，哭過，我為了追求真理而超越存在！我覺得我們已經建立起聯繫了，就像你們全是我的兄弟姐妹一樣，雖然你們沒有搶過我的玩具和圖釘配過顏色後釘在我的床單上，讓我很淒慘地整個冬天都要睡在那又髒又不舒服的床單上……
$ENTRY_JOURNAL2_OUTRO_LEFT_30	話說回來，這是一個冒險！我希望你們都喜歡這個瘋狂又可怕的Defender's Quest: Valley of the Forgotten創作之旅(撇除了那些我哭著入睡，喝著漱口水,偷看鄰居有線電視上西班牙語廣告的日子)。<N>
$ENTRY_JOURNAL2_OUTRO_RIGHT_0_00	我會在Defender's Quest 2再見到你們的!<N><N>什麼，有這樣的東西嗎？<N><N>是的！它會是超級的酷！<N><N>你應該立馬就買下它！<N><N>PS:狼叔，你錯過了一個超級棒的生日派對了！有人帶了漱口水過來，然後我們都玩瘋了。<N><N>PPS:如果你以為我偷看了鄰居的有線電視很奇怪，我告訴你是他們偷了人家的線路，我不過是用望遠鏡看看他們家的電視罷了。
$ENTRY_JOURNAL2_OUTRO_LEFT_1_00	
$ENTRY_JOURNAL2_OUTRO_RIGHT_1_00	
$ENTRY_JOURNAL_END	完
