flag	content
$SCENE_OPENING_TITLE	開幕
$NARR_OPENING_00_TEXT	*我的名字是$MCG
$NARR_OPENING_10_TEXT	我快死了
$NARR_OPENING_20_TEXT	他們不會等待
$NARR_OPENING_30_TEXT	甚至沒有時間焚燒屍體
$NARR_OPENING_40_TEXT	只是把屍體弄出城外
$NARR_OPENING_50_TEXT	……然後扔進墓坑
$SCENE_WHERE_AM_I_TITLE	中途世界
$NARR_WHERE_AM_I_00_TEXT	第一幕
$NARR_WHERE_AM_I_00_SUB_TEXT	*一腳踏於此岸，一腳踏於彼岸，靈魂位於中間，$N垂死之人可見萬物。
$NARR_WHERE_AM_I_00_SUB_SUB_TEXT	*$N$N$N ——諾曼諺語
$LINE_WHERE_AM_I_00_CHAR	瘟疫受害者
$LINE_WHERE_AM_I_00_TEXT	你能感受到他嗎？
$LINE_WHERE_AM_I_10_CHAR	$MCG
$LINE_WHERE_AM_I_10_TEXT	什麼？我們在哪兒？
$LINE_WHERE_AM_I_20_CHAR	瘟疫受害者
$LINE_WHERE_AM_I_20_TEXT	他在呼喚我們……
$LINE_WHERE_AM_I_30_CHAR	瘟疫受害者
$LINE_WHERE_AM_I_30_TEXT	來，我們必須加入他……
$LINE_WHERE_AM_I_40_CHAR	瘟疫受害者
$LINE_WHERE_AM_I_40_TEXT	我們已經在半路了……
$LINE_WHERE_AM_I_50_CHAR	$MCG
$LINE_WHERE_AM_I_50_TEXT	你在做什麼？你瘋了嗎？
$LINE_WHERE_AM_I_60_CHAR	瘟疫受害者
$LINE_WHERE_AM_I_60_TEXT	聽……
$LINE_WHERE_AM_I_70_CHAR	瘟疫受害者
$LINE_WHERE_AM_I_70_TEXT	他出價那麼高……讓我們參與……一件重大的事情。
$LINE_WHERE_AM_I_80_CHAR	瘟疫受害者
$LINE_WHERE_AM_I_80_TEXT	只有傻瓜才會拒絕。
$LINE_WHERE_AM_I_90_CHAR	$MCG
$LINE_WHERE_AM_I_90_TEXT	離我遠點！
$LINE_WHERE_AM_I_100_CHAR	聲音
$LINE_WHERE_AM_I_100_TEXT	所有人都會加入。所有人都會變成容器。
$LINE_WHERE_AM_I_110_CHAR	$MCG
$LINE_WHERE_AM_I_110_TEXT	放我出去！
$LINE_WHERE_AM_I_120_CHAR	聲音
$LINE_WHERE_AM_I_120_TEXT	這是命令。
$LINE_WHERE_AM_I_130_CHAR	$MCG
$LINE_WHERE_AM_I_130_TEXT	不能……動了……
$LINE_WHERE_AM_I_140_CHAR	$MCG
$LINE_WHERE_AM_I_140_TEXT	救救我……有人嗎……
$LINE_WHERE_AM_I_150_CHAR	$BER
$LINE_WHERE_AM_I_150_TEXT	什麼？！那個發狂的——在哪裡？！
$SCENE_MEET_BERSERKER_TITLE	奇怪的新朋友
$LINE_MEET_BERSERKER_00_CHAR	$MCG
$LINE_MEET_BERSERKER_00_TEXT	哇哦。
$LINE_MEET_BERSERKER_10_CHAR	$MCG
$LINE_MEET_BERSERKER_10_TEXT	發生了什麼？
$LINE_MEET_BERSERKER_20_CHAR	$BER
$LINE_MEET_BERSERKER_20_TEXT	我不知道。五分鐘前你是一具屍體，而我只是想扒幾雙新鞋。
$LINE_MEET_BERSERKER_30_CHAR	$BER
$LINE_MEET_BERSERKER_30_TEXT	好消息！你活了，而且好像也沒有再感染瘟疫了。
$LINE_MEET_BERSERKER_40_CHAR	$MCG
$LINE_MEET_BERSERKER_40_TEXT	哪裡——？
$LINE_MEET_BERSERKER_50_CHAR	$BER
$LINE_MEET_BERSERKER_50_TEXT	壞消息是，這意味著我得不到新鞋了。
$LINE_MEET_BERSERKER_60_CHAR	$BER
$LINE_MEET_BERSERKER_60_TEXT	還有，你現在和我們一樣，被困在這個瘟疫群落裡了。
$LINE_MEET_BERSERKER_70_CHAR	$MCG
$LINE_MEET_BERSERKER_70_TEXT	墓坑……
$LINE_MEET_BERSERKER_80_CHAR	$BER
$LINE_MEET_BERSERKER_80_TEXT	開心點！你活過來了，所以你現在對瘟疫已經免疫了。
$LINE_MEET_BERSERKER_90_CHAR	$MCG
$LINE_MEET_BERSERKER_90_TEXT	既然這樣，守衛會讓我們出去，對嗎？
$LINE_MEET_BERSERKER_100_CHAR	$BER
$LINE_MEET_BERSERKER_100_TEXT	你可以去試著跟他們解釋一下，但是他們貌似不太擅長傾聽。
$LINE_MEET_BERSERKER_110_CHAR	$BER
$LINE_MEET_BERSERKER_110_TEXT	*他們似乎分不清“洗耳恭聽”，$N和“把你射成篩子”的區別。
$LINE_MEET_BERSERKER_120_CHAR	$BER
$LINE_MEET_BERSERKER_120_TEXT	真的。我不知道艾殊王國是怎麼進行禮儀培訓的。
$LINE_MEET_BERSERKER_130_CHAR	$MCG
$LINE_MEET_BERSERKER_130_TEXT	……
$LINE_MEET_BERSERKER_140_CHAR	$MCG
$LINE_MEET_BERSERKER_140_TEXT	我還是沒有搞懂……那裡……發生了什麼……
$LINE_MEET_BERSERKER_150_CHAR	$BER
$LINE_MEET_BERSERKER_150_TEXT	別擔心了。我一開始得瘟疫的時候也有過一樣的幻覺。
$LINE_MEET_BERSERKER_160_CHAR	$MCG
$LINE_MEET_BERSERKER_160_TEXT	等一下——你當時和我在一起的！那怎麼會是幻覺、
$LINE_MEET_BERSERKER_170_CHAR	$BER
$LINE_MEET_BERSERKER_170_TEXT	噢，那是什麼？商隊！
$LINE_MEET_BERSERKER_180_CHAR	$MCG
$LINE_MEET_BERSERKER_180_TEXT	等一下！
$LINE_MEET_BERSERKER_190_CHAR	$MCG
$LINE_MEET_BERSERKER_190_TEXT	至少告訴我你的名字！
$SCENE_SECOND_BATTLE_TITLE	死亡商隊
$LINE_SECOND_BATTLE_00_CHAR	$BER
$LINE_SECOND_BATTLE_00_TEXT	嘿，商隊的夥計們！誰有鞋子嗎？
$LINE_SECOND_BATTLE_10_CHAR	被感染的商隊守衛
$LINE_SECOND_BATTLE_10_TEXT	請……進貢……為了奧斯蒙……
$LINE_SECOND_BATTLE_20_CHAR	$BER
$LINE_SECOND_BATTLE_20_TEXT	噢哦。
$LINE_SECOND_BATTLE_30_CHAR	$MCG
$LINE_SECOND_BATTLE_30_TEXT	這些人是誰？
$LINE_SECOND_BATTLE_40_CHAR	$BER
$LINE_SECOND_BATTLE_40_TEXT	我們必須離開這裡，馬上。
$LINE_SECOND_BATTLE_50_CHAR	$MCG
$LINE_SECOND_BATTLE_50_TEXT	但是他們需要幫助！
$LINE_SECOND_BATTLE_60_CHAR	$BER
$LINE_SECOND_BATTLE_60_TEXT	啊哈哈，不。
$LINE_SECOND_BATTLE_70_CHAR	$MCG
$LINE_SECOND_BATTLE_70_TEXT	我們不能就這樣丟下他們！
$LINE_SECOND_BATTLE_80_CHAR	$BER
$LINE_SECOND_BATTLE_80_TEXT	他們中了瘟疫了。
$LINE_SECOND_BATTLE_90_CHAR	$MCG
$LINE_SECOND_BATTLE_90_TEXT	但是我們都免疫了，對嗎？
$LINE_SECOND_BATTLE_100_CHAR	$BER
$LINE_SECOND_BATTLE_100_TEXT	但是對於他們轉過身來吃掉我們的臉這件事，我們是無法免疫的。
$LINE_SECOND_BATTLE_110_CHAR	$MCG
$LINE_SECOND_BATTLE_110_TEXT	轉過身？
$LINE_SECOND_BATTLE_120_CHAR	得疫病的商隊守衛
$LINE_SECOND_BATTLE_120_TEXT	噢！啊啊啊啊啊啊啊啊啊啊！
$LINE_SECOND_BATTLE_130_CHAR	$BER
$LINE_SECOND_BATTLE_130_TEXT	就像那樣。
$LINE_SECOND_BATTLE_140_CHAR	$BER
$LINE_SECOND_BATTLE_140_TEXT	好吧，很高興見到你。
$LINE_SECOND_BATTLE_150_CHAR	$MCG
$LINE_SECOND_BATTLE_150_TEXT	等等！
$LINE_SECOND_BATTLE_160_CHAR	$BER
$LINE_SECOND_BATTLE_160_TEXT	……
$LINE_SECOND_BATTLE_170_CHAR	$BER
$LINE_SECOND_BATTLE_170_TEXT	你還好嗎？
$SCENE_TALK_BERSERKER_TITLE	倉庫突襲
$LINE_TALK_BERSERKER_00_CHAR	$MCG
$LINE_TALK_BERSERKER_00_TEXT	那些人……他們都變成怪物了！
$LINE_TALK_BERSERKER_10_CHAR	$BER
$LINE_TALK_BERSERKER_10_TEXT	你一定是新來的。
$LINE_TALK_BERSERKER_20_CHAR	$BER
$LINE_TALK_BERSERKER_20_TEXT	不能在瘟疫中存活的人就會是那個下場。
$LINE_TALK_BERSERKER_30_CHAR	$MCG
$LINE_TALK_BERSERKER_30_TEXT	我們之前到過同樣的地方……半路之地……
$LINE_TALK_BERSERKER_40_CHAR	$MCG
$LINE_TALK_BERSERKER_40_TEXT	這個地方太恐怖了！我……我必須得離開這裡！
$LINE_TALK_BERSERKER_50_CHAR	$BER
$LINE_TALK_BERSERKER_50_TEXT	算了吧，人們已經嘗試從墓坑逃跑有十年了。
$LINE_TALK_BERSERKER_60_CHAR	$MCG
$LINE_TALK_BERSERKER_60_TEXT	這已經有十年了？！
$LINE_TALK_BERSERKER_70_CHAR	$BER
$LINE_TALK_BERSERKER_70_TEXT	讓我猜猜，你是從首都來的，是吧？
$LINE_TALK_BERSERKER_80_CHAR	$MCG
$LINE_TALK_BERSERKER_80_TEXT	我是皇家圖書管理員……
$LINE_TALK_BERSERKER_90_CHAR	$BER
$LINE_TALK_BERSERKER_90_TEXT	看出來了。攝政王做事真是滴水不漏。
$LINE_TALK_BERSERKER_100_CHAR	$BER
$LINE_TALK_BERSERKER_100_TEXT	我猜你也不知道戰爭已經結束了吧。
$LINE_TALK_BERSERKER_110_CHAR	$MCG
$LINE_TALK_BERSERKER_110_TEXT	戰爭結束了？！但是那些士兵……那……那些軍隊都被派遣到哪裡去了？
$LINE_TALK_BERSERKER_120_CHAR	$BER
$LINE_TALK_BERSERKER_120_TEXT	嘿？還記的把人們變成怪物的瘟疫嗎？那需要很多的人力去控制！
$LINE_TALK_BERSERKER_130_CHAR	$MCG
$LINE_TALK_BERSERKER_130_TEXT	這……對不起，我只是……我只是需要一本好書和一瓶——不，兩瓶酒。
$LINE_TALK_BERSERKER_140_CHAR	$BER
$LINE_TALK_BERSERKER_140_TEXT	嘿，朝好的一面看吧——至少亡者都離開了。
$LINE_TALK_BERSERKER_150_CHAR	$BER
$LINE_TALK_BERSERKER_150_TEXT	等等，他們沒有離開，他們都死了！
$LINE_TALK_BERSERKER_160_CHAR	$BER
$LINE_TALK_BERSERKER_160_TEXT	從來沒有人做過那樣的事！
$LINE_TALK_BERSERKER_170_CHAR	$MCG
$LINE_TALK_BERSERKER_170_TEXT	什麼？
$LINE_TALK_BERSERKER_180_CHAR	$BER
$LINE_TALK_BERSERKER_180_TEXT	亡者不會死……至少他們曾經不會死！
$LINE_TALK_BERSERKER_190_CHAR	$BER
$LINE_TALK_BERSERKER_190_TEXT	噢，夥計，這真是我的幸運日！
$LINE_TALK_BERSERKER_200_CHAR	$BER
$LINE_TALK_BERSERKER_200_TEXT	我交到了以為新的好友，而且他還有神秘的魔法力量……
$LINE_TALK_BERSERKER_210_CHAR	$BER
$LINE_TALK_BERSERKER_210_TEXT	而且一輛無人看守的拖車就是無盡的財富！我們發財了！發財了！我告訴你！
$LINE_TALK_BERSERKER_220_CHAR	$BER
$LINE_TALK_BERSERKER_220_TEXT	那些是鞋子嗎？
$LINE_TALK_BERSERKER_221_CHAR	$MCG
$LINE_TALK_BERSERKER_221_TEXT	把那三瓶……
$SCENE_CAUGHT_BY_OZIMAL_TITLE	被捕
$LINE_CAUGHT_BY_OZIMAL_00_CHAR	$MCG
$LINE_CAUGHT_BY_OZIMAL_00_TEXT	*$BER，這些都是垃圾……
$LINE_CAUGHT_BY_OZIMAL_10_CHAR	大傢伙
$LINE_CAUGHT_BY_OZIMAL_10_TEXT	強盜。我早該料到的。
$LINE_CAUGHT_BY_OZIMAL_20_CHAR	$MCG
$LINE_CAUGHT_BY_OZIMAL_20_TEXT	你是誰？
$LINE_CAUGHT_BY_OZIMAL_30_CHAR	奧斯蒙
$LINE_CAUGHT_BY_OZIMAL_30_TEXT	我是奧斯蒙·卡茲，墓坑戰神，這些貢品是我的。
$LINE_CAUGHT_BY_OZIMAL_40_CHAR	$MCG
$LINE_CAUGHT_BY_OZIMAL_40_TEXT	等等，我才到這裡，我不知道——
$LINE_CAUGHT_BY_OZIMAL_50_CHAR	奧斯蒙
$LINE_CAUGHT_BY_OZIMAL_50_TEXT	守衛，把這些沒用的賊都扔進競技場裡！
$LINE_CAUGHT_BY_OZIMAL_60_CHAR	奧斯蒙
$LINE_CAUGHT_BY_OZIMAL_60_TEXT	讓他們知道，偷奧斯蒙·卡茲的東西是什麼下場。
$SCENE_COLISEUM_INTRO_TITLE	競技場
$LINE_COLISEUM_INTRO_00_CHAR	$MCG
$LINE_COLISEUM_INTRO_00_TEXT	這看起來不妙。
$LINE_COLISEUM_INTRO_10_CHAR	囚犯
$LINE_COLISEUM_INTRO_10_TEXT	我猜這是你第一次受刑？
$LINE_COLISEUM_INTRO_20_CHAR	$MCG
$LINE_COLISEUM_INTRO_20_TEXT	受刑？
$LINE_COLISEUM_INTRO_30_CHAR	囚犯
$LINE_COLISEUM_INTRO_30_TEXT	是啊。馬上他們就會打開那些大門，然後成群結隊的野獸就會湧進來把我們吃掉。
$LINE_COLISEUM_INTRO_40_CHAR	$MCG
$LINE_COLISEUM_INTRO_40_TEXT	所以我們……必死無疑了？
$LINE_COLISEUM_INTRO_50_CHAR	囚犯
$LINE_COLISEUM_INTRO_50_TEXT	是的，歡迎來到墓坑。
$LINE_COLISEUM_INTRO_60_CHAR	囚犯
$LINE_COLISEUM_INTRO_60_TEXT	我還不認識你，公主，但是我打算堅持到底。
$LINE_COLISEUM_INTRO_70_CHAR	$MCG
$LINE_COLISEUM_INTRO_70_TEXT	*等等！如果我們必死無疑，那至少我們應該知道彼此的名字。我是$MCG。
$LINE_COLISEUM_INTRO_80_CHAR	囚犯
$LINE_COLISEUM_INTRO_80_TEXT	很高興認識你。我是……
$SCENE_COLISEUM_OUTRO_TITLE	迎難而上
$LINE_COLISEUM_OUTRO_00_CHAR	守衛
$LINE_COLISEUM_OUTRO_00_TEXT	長官！亡者都死了！
$LINE_COLISEUM_OUTRO_10_CHAR	奧斯蒙
$LINE_COLISEUM_OUTRO_10_TEXT	不可能。沒人可以殺死一個亡者。
$LINE_COLISEUM_OUTRO_20_CHAR	守衛
$LINE_COLISEUM_OUTRO_20_TEXT	是那個新來的姑娘……我不知道她做了什麼，但是囚犯都還活著，但是亡者都死了。
$LINE_COLISEUM_OUTRO_30_CHAR	奧斯蒙
$LINE_COLISEUM_OUTRO_30_TEXT	有意思……
$LINE_COLISEUM_OUTRO_40_CHAR	奧斯蒙
$LINE_COLISEUM_OUTRO_40_TEXT	把他們扔進監獄。
$LINE_COLISEUM_OUTRO_50_CHAR	守衛
$LINE_COLISEUM_OUTRO_50_TEXT	是！長官！
$LINE_COLISEUM_OUTRO_60_CHAR	奧斯蒙
$LINE_COLISEUM_OUTRO_60_TEXT	然後，寄一封信給我們的朋友，收藏家。
$LINE_COLISEUM_OUTRO_70_CHAR	奧斯蒙
$LINE_COLISEUM_OUTRO_70_TEXT	告訴他，我有一件有趣的新寶貝想要出售。
$SCENE_OZIMAL_PRISON_TITLE	身陷囹圄
$LINE_OZIMAL_PRISON_00_CHAR	$RAN
$LINE_OZIMAL_PRISON_00_TEXT	好吧，你做了什麼？
$LINE_OZIMAL_PRISON_10_CHAR	$RAN
$LINE_OZIMAL_PRISON_10_TEXT	我感覺……我的心臟被同時向著兩個方向用力撕扯著。
$LINE_OZIMAL_PRISON_20_CHAR	$MCG
$LINE_OZIMAL_PRISON_20_TEXT	對不起，我真不知道。我只知道它起作用了。
$LINE_OZIMAL_PRISON_30_CHAR	$MCG
$LINE_OZIMAL_PRISON_30_TEXT	但是我們還活著！或者就有意義，對嗎？
$LINE_OZIMAL_PRISON_40_CHAR	$RAN
$LINE_OZIMAL_PRISON_40_TEXT	很顯然，活著，然後瘋了。上帝啊，我需要一杯酒。
$LINE_OZIMAL_PRISON_50_CHAR	$MCG
$LINE_OZIMAL_PRISON_50_TEXT	我也是。
$LINE_OZIMAL_PRISON_60_CHAR	神秘的陌生人
$LINE_OZIMAL_PRISON_60_TEXT	*噓！$MCG！這邊！
$LINE_OZIMAL_PRISON_70_CHAR	$MCG
$LINE_OZIMAL_PRISON_70_TEXT	你怎麼知道我的名字？
$LINE_OZIMAL_PRISON_80_CHAR	神秘的陌生人
$LINE_OZIMAL_PRISON_80_TEXT	守衛很快就會回來。如果你想要活著離開這裡，你就必須好好聽著。
$LINE_OZIMAL_PRISON_90_CHAR	$MCG
$LINE_OZIMAL_PRISON_90_TEXT	你是誰？
$LINE_OZIMAL_PRISON_100_CHAR	神秘的陌生人
$LINE_OZIMAL_PRISON_100_TEXT	一個朋友。
$LINE_OZIMAL_PRISON_110_CHAR	神秘的陌生人
$LINE_OZIMAL_PRISON_110_TEXT	仔細挺好：明天奧斯蒙打算把你賣給一個紅衣人。我要阻止這件事情。
$LINE_OZIMAL_PRISON_120_CHAR	$MCG
$LINE_OZIMAL_PRISON_120_TEXT	……
$LINE_OZIMAL_PRISON_130_CHAR	神秘的陌生人
$LINE_OZIMAL_PRISON_130_TEXT	他會把你再次送回競技場，讓你示範你的技能。
$LINE_OZIMAL_PRISON_140_CHAR	$MCG
$LINE_OZIMAL_PRISON_140_TEXT	你怎麼——？
$LINE_OZIMAL_PRISON_150_CHAR	神秘的陌生人
$LINE_OZIMAL_PRISON_150_TEXT	這時候，我會想辦法干擾大家的注意力。你必須趁機逃走。
$LINE_OZIMAL_PRISON_160_CHAR	神秘的陌生人
$LINE_OZIMAL_PRISON_160_TEXT	拿上這個。用它來賄賂你的囚犯朋友們，讓他們幫助你。你明天必須做好準備。
$LINE_OZIMAL_PRISON_170_CHAR	$MCG
$LINE_OZIMAL_PRISON_170_TEXT	你為什麼要幫我？
$LINE_OZIMAL_PRISON_180_CHAR	神秘的陌生人
$LINE_OZIMAL_PRISON_180_TEXT	目前你知道的越少越安全。回頭去修道院找我。我會把一切解釋給你聽。
$LINE_OZIMAL_PRISON_190_CHAR	$MCG
$LINE_OZIMAL_PRISON_190_TEXT	好吧……
$LINE_OZIMAL_PRISON_200_CHAR	神秘的陌生人
$LINE_OZIMAL_PRISON_200_TEXT	*$MCG，你一定不能落在他的手上。
$SCENE_COLISEUM_2_INTRO_TITLE	小小的示範
$LINE_COLISEUM_2_INTRO_00_CHAR	奧斯蒙
$LINE_COLISEUM_2_INTRO_00_TEXT	那麼，我尊貴的客人，外面的世界發生了些什麼？
$LINE_COLISEUM_2_INTRO_10_CHAR	紅衣人
$LINE_COLISEUM_2_INTRO_10_TEXT	瘟疫已經完全摧毀了奎德帝國。除了那些成群結隊的扭曲殘暴的受感染者，其他一切都已經不復存在。
$LINE_COLISEUM_2_INTRO_20_CHAR	奧斯蒙
$LINE_COLISEUM_2_INTRO_20_TEXT	噢，這真是令人欣喜的消息。
$LINE_COLISEUM_2_INTRO_30_CHAR	紅衣人
$LINE_COLISEUM_2_INTRO_30_TEXT	現在瘟疫已經傳到了艾殊王國。如果不採取任何措施，疫病將完成奎德軍隊都無法完成的事情。
$LINE_COLISEUM_2_INTRO_40_CHAR	奧斯蒙
$LINE_COLISEUM_2_INTRO_40_TEXT	好吧，只要恐慌的阿薩尼持續不斷的流放那些被感染者，我們墓坑統治者就有生意可做。
$LINE_COLISEUM_2_INTRO_50_CHAR	奧斯蒙
$LINE_COLISEUM_2_INTRO_50_TEXT	那些瘟疫巨獸對於能善加利用的人來說是一筆非常寶貴的資源，對吧？
$LINE_COLISEUM_2_INTRO_60_CHAR	紅衣人
$LINE_COLISEUM_2_INTRO_60_TEXT	談話就到此為止吧。那個女孩在哪兒？
$LINE_COLISEUM_2_INTRO_70_CHAR	奧斯蒙
$LINE_COLISEUM_2_INTRO_70_TEXT	在那邊。我想你對於她的能力會非常感興趣的。
$LINE_COLISEUM_2_INTRO_80_CHAR	紅衣人
$LINE_COLISEUM_2_INTRO_80_TEXT	讓我們拭目以待吧。
$LINE_COLISEUM_2_INTRO_90_CHAR	奧斯蒙
$LINE_COLISEUM_2_INTRO_90_TEXT	她陷入了一種精神恍惚的狀態，她的同伴們似乎漸漸融入虛無之中。
$LINE_COLISEUM_2_INTRO_100_CHAR	奧斯蒙
$LINE_COLISEUM_2_INTRO_100_TEXT	在他們周圍，亡者們成堆的倒下死去，就像是被無形的弓箭擊殺一樣。
$LINE_COLISEUM_2_INTRO_110_CHAR	紅衣人
$LINE_COLISEUM_2_INTRO_110_TEXT	讓我看看。
$LINE_COLISEUM_2_INTRO_120_CHAR	奧斯蒙
$LINE_COLISEUM_2_INTRO_120_TEXT	守衛，釋放亡者！
$SCENE_COLISEUM_2_OUTRO_TITLE	大膽越獄
$LINE_COLISEUM_2_OUTRO_00_CHAR	紅衣人
$LINE_COLISEUM_2_OUTRO_00_TEXT	難以置信。她能看到它們真實的樣子。
$LINE_COLISEUM_2_OUTRO_10_CHAR	紅衣人
$LINE_COLISEUM_2_OUTRO_10_TEXT	她在它們自己的世界中和它們戰鬥。
$LINE_COLISEUM_2_OUTRO_20_CHAR	奧斯蒙
$LINE_COLISEUM_2_OUTRO_20_TEXT	那麼，你是否有興趣？
$LINE_COLISEUM_2_OUTRO_30_CHAR	紅衣人
$LINE_COLISEUM_2_OUTRO_30_TEXT	*考慮到雙倍的價格，$N這可不算是我認知當中的公平交易。
$LINE_COLISEUM_2_OUTRO_40_CHAR	紅衣人
$LINE_COLISEUM_2_OUTRO_40_TEXT	這是什麼？
$LINE_COLISEUM_2_OUTRO_50_CHAR	奧斯蒙
$LINE_COLISEUM_2_OUTRO_50_TEXT	守衛！
$LINE_COLISEUM_2_OUTRO_60_CHAR	守衛
$LINE_COLISEUM_2_OUTRO_60_TEXT	長官，競技場的南牆崩塌了！
$LINE_COLISEUM_2_OUTRO_70_CHAR	守衛
$LINE_COLISEUM_2_OUTRO_70_TEXT	囚犯們都逃跑了！
$LINE_COLISEUM_2_OUTRO_80_CHAR	奧斯蒙
$LINE_COLISEUM_2_OUTRO_80_TEXT	什麼！
$LINE_COLISEUM_2_OUTRO_90_CHAR	奧斯蒙
$LINE_COLISEUM_2_OUTRO_90_TEXT	釋放亡者！全力追擊！
$SCENE_RIVER_INTRO_TITLE	渡河
$LINE_RIVER_INTRO_00_CHAR	$MCG
$LINE_RIVER_INTRO_00_TEXT	大家走這邊！
$LINE_RIVER_INTRO_10_CHAR	$RAN
$LINE_RIVER_INTRO_10_TEXT	沒有用，他們在逼近！
$LINE_RIVER_INTRO_20_CHAR	$MCG
$LINE_RIVER_INTRO_20_TEXT	快點，過河！我們可以在淺灘那裡拖住他們！
$LINE_RIVER_INTRO_30_CHAR	$RAN
$LINE_RIVER_INTRO_30_TEXT	他們人太多了！
$LINE_RIVER_INTRO_40_CHAR	$BER
$LINE_RIVER_INTRO_40_TEXT	只有一件事可以做了……
$LINE_RIVER_INTRO_50_CHAR	$BER
$LINE_RIVER_INTRO_50_TEXT	瘋狂自殺狂暴時間！！
$LINE_RIVER_INTRO_60_CHAR	$MCG
$LINE_RIVER_INTRO_60_TEXT	我認為你似乎想到了點什麼……
$LINE_RIVER_INTRO_61_CHAR	$MCG
$LINE_RIVER_INTRO_61_TEXT	這是什麼感覺？好像我——
$LINE_RIVER_INTRO_70_CHAR	$BER
$LINE_RIVER_INTRO_70_TEXT	像是你想要屠戮一切移動的東西，然後在漫天撒落的內臟殘渣中舞蹈，然後想像自己是在生日聚會上的潮濕彩帶紙屑中舞蹈？
$LINE_RIVER_INTRO_71_CHAR	$MCG
$LINE_RIVER_INTRO_71_TEXT	……
$LINE_RIVER_INTRO_72_CHAR	$MCG
$LINE_RIVER_INTRO_72_TEXT	……沒錯？
$SCENE_RIVER_OUTRO_TITLE	繼續逃亡
$NARR_RIVER_OUTRO_00_TEXT	第二幕
$NARR_RIVER_OUTRO_00_SUB_TEXT	*我唾棄的看著叛徒的眼睛，他親手謀殺了榮譽。$N願他溺死在自己的血泊中。$N願他的屍體在腐爛進土地裡。$N願嚴寒永久地吞噬他的骸骨。
$NARR_RIVER_OUTRO_00_SUB_SUB_TEXT	*$N$N$N$N$N——摘自奎德的就職宣言
$LINE_RIVER_OUTRO_00_CHAR	$BER
$LINE_RIVER_OUTRO_00_TEXT	誰準備好參加第二輪了？
$LINE_RIVER_OUTRO_10_CHAR	$BER
$LINE_RIVER_OUTRO_10_TEXT	我要撕爛你們的臉，再用你們的頭骨來種裝飾盆栽！
$LINE_RIVER_OUTRO_20_CHAR	$MCG
$LINE_RIVER_OUTRO_20_TEXT	*$BER，他們都死了……而且，你所有的盆栽都會聞起來像死人的。
$LINE_RIVER_OUTRO_30_CHAR	$BER
$LINE_RIVER_OUTRO_30_TEXT	噢。
$LINE_RIVER_OUTRO_40_CHAR	$BER
$LINE_RIVER_OUTRO_40_TEXT	那現在的計畫是什麼？
$LINE_RIVER_OUTRO_50_CHAR	$MCG
$LINE_RIVER_OUTRO_50_TEXT	嗯，那個神秘的老人說去<LQ>修道院<RQ>找他……
$LINE_RIVER_OUTRO_60_CHAR	$BER
$LINE_RIVER_OUTRO_60_TEXT	啊，他說的肯定是墓坑北邊的瑟連裡會堂。
$LINE_RIVER_OUTRO_70_CHAR	$MCG
$LINE_RIVER_OUTRO_70_TEXT	這裡有艾殊神廟的僧侶嗎……在這個瘟疫群落裡？
$LINE_RIVER_OUTRO_80_CHAR	$BER
$LINE_RIVER_OUTRO_80_TEXT	有什麼比醫院更好的地方嗎？來，我來給你指路。
$LINE_RIVER_OUTRO_90_CHAR	$RAN
$LINE_RIVER_OUTRO_90_TEXT	你信任這傢伙？
$LINE_RIVER_OUTRO_100_CHAR	$MCG
$LINE_RIVER_OUTRO_100_TEXT	好吧，他非常的瘋狂，的確如此，但是他看起來很忠誠。面對朋友的時候不能太吹毛求疵。
$LINE_RIVER_OUTRO_110_CHAR	$RAN
$LINE_RIVER_OUTRO_110_TEXT	不，我不是指小丑，我是指那個神秘的老人。
$LINE_RIVER_OUTRO_120_CHAR	$MCG
$LINE_RIVER_OUTRO_120_TEXT	如果他是一位艾殊神廟的僧侶，那我們就沒有什麼可以擔心的。
$LINE_RIVER_OUTRO_130_CHAR	$RAN
$LINE_RIVER_OUTRO_130_TEXT	你認為你的修道院從來沒有做過什麼骯髒的事嗎？
$LINE_RIVER_OUTRO_140_CHAR	$MCG
$LINE_RIVER_OUTRO_140_TEXT	嘿，你要是不信任他你不必一起來。
$LINE_RIVER_OUTRO_150_CHAR	$RAN
$LINE_RIVER_OUTRO_150_TEXT	然後也放棄跟你一起逃走的機會？如果可以逃離這個魔窟的話，我願意接納整個艾殊王國。
$LINE_RIVER_OUTRO_160_CHAR	$RAN
$LINE_RIVER_OUTRO_160_TEXT	只是——小心行事，好嗎？
$SCENE_RANGER_TOWN_INTRO_TITLE	踏上征途
$LINE_RANGER_TOWN_INTRO_00_CHAR	$RAN
$LINE_RANGER_TOWN_INTRO_00_TEXT	*聽著，$MCG，如果我們要去修道院，我認為我們需要更多的人。
$LINE_RANGER_TOWN_INTRO_10_CHAR	$MCG
$LINE_RANGER_TOWN_INTRO_10_TEXT	*嗯，我們已經有$BER了。
$LINE_RANGER_TOWN_INTRO_20_CHAR	$RAN
$LINE_RANGER_TOWN_INTRO_20_TEXT	我是說……正常人。
$LINE_RANGER_TOWN_INTRO_30_CHAR	$RAN
$LINE_RANGER_TOWN_INTRO_30_TEXT	真正可以和你並肩作戰的人。
$LINE_RANGER_TOWN_INTRO_40_CHAR	$RAN
$LINE_RANGER_TOWN_INTRO_40_TEXT	裝備著護甲的人。
$LINE_RANGER_TOWN_INTRO_50_CHAR	$BER
$LINE_RANGER_TOWN_INTRO_50_TEXT	什麼，然後遮掩住這完美的身材？
$LINE_RANGER_TOWN_INTRO_60_CHAR	$RAN
$LINE_RANGER_TOWN_INTRO_60_TEXT	是的……我們雇傭一些增援部隊吧。
$LINE_RANGER_TOWN_INTRO_70_CHAR	$BER
$LINE_RANGER_TOWN_INTRO_70_TEXT	什麼？有我就夠了！我可是擁有金剛不壞之身的人！
$LINE_RANGER_TOWN_INTRO_80_CHAR	$RAN
$LINE_RANGER_TOWN_INTRO_80_TEXT	……還有醉酒黃鼠狼之腦。
$LINE_RANGER_TOWN_INTRO_90_CHAR	$BER
$LINE_RANGER_TOWN_INTRO_90_TEXT	……醉酒黃鼠狼！天呐！
$SCENE_RANGER_TOWN_FIGHT_INTRO_TITLE	四面楚歌
$LINE_RANGER_TOWN_FIGHT_INTRO_00_CHAR	$MCG
$LINE_RANGER_TOWN_FIGHT_INTRO_00_TEXT	他們發現我們了！城鎮正在受到攻擊！
$LINE_RANGER_TOWN_FIGHT_INTRO_10_CHAR	奧斯蒙
$LINE_RANGER_TOWN_FIGHT_INTRO_10_TEXT	守衛，發動攻擊！
$LINE_RANGER_TOWN_FIGHT_INTRO_20_CHAR	奧斯蒙
$LINE_RANGER_TOWN_FIGHT_INTRO_20_TEXT	她很值錢！給我抓活的！
$LINE_RANGER_TOWN_FIGHT_INTRO_30_CHAR	奧斯蒙
$LINE_RANGER_TOWN_FIGHT_INTRO_30_TEXT	其餘人隨意處置。
$LINE_RANGER_TOWN_FIGHT_INTRO_40_CHAR	奧斯蒙
$LINE_RANGER_TOWN_FIGHT_INTRO_40_TEXT	釋放亡者！
$SCENE_RANGER_TOWN_FIGHT_OUTRO_TITLE	救援部隊
$LINE_RANGER_TOWN_FIGHT_OUTRO_00_CHAR	奧斯蒙
$LINE_RANGER_TOWN_FIGHT_OUTRO_00_TEXT	什麼，整個城鎮都是死人，但是沒有抓到一個囚犯？！
$LINE_RANGER_TOWN_FIGHT_OUTRO_10_CHAR	守衛
$LINE_RANGER_TOWN_FIGHT_OUTRO_10_TEXT	長官，我們沒有足夠的亡者了。
$LINE_RANGER_TOWN_FIGHT_OUTRO_20_CHAR	奧斯蒙
$LINE_RANGER_TOWN_FIGHT_OUTRO_20_TEXT	你以為我不知道嗎？滾開！
$LINE_RANGER_TOWN_FIGHT_OUTRO_30_CHAR	奧斯蒙
$LINE_RANGER_TOWN_FIGHT_OUTRO_30_TEXT	沒用的飯桶。
$LINE_RANGER_TOWN_FIGHT_OUTRO_40_CHAR	紅衣人
$LINE_RANGER_TOWN_FIGHT_OUTRO_40_TEXT	不能讓他們跑了。
$LINE_RANGER_TOWN_FIGHT_OUTRO_50_CHAR	奧斯蒙
$LINE_RANGER_TOWN_FIGHT_OUTRO_50_TEXT	我能怎麼辦？我的亡者大軍都快被摧毀了。
$LINE_RANGER_TOWN_FIGHT_OUTRO_60_CHAR	奧斯蒙
$LINE_RANGER_TOWN_FIGHT_OUTRO_60_TEXT	我們沒有足夠的後續部隊了。
$LINE_RANGER_TOWN_FIGHT_OUTRO_70_CHAR	紅衣人
$LINE_RANGER_TOWN_FIGHT_OUTRO_70_TEXT	看看你周圍。你看到了什麼？
$LINE_RANGER_TOWN_FIGHT_OUTRO_80_CHAR	奧斯蒙
$LINE_RANGER_TOWN_FIGHT_OUTRO_80_TEXT	我看到了成堆的屍體，但是沒有我們要找的人！
$LINE_RANGER_TOWN_FIGHT_OUTRO_90_CHAR	紅衣人
$LINE_RANGER_TOWN_FIGHT_OUTRO_90_TEXT	繼續追擊。
$LINE_RANGER_TOWN_FIGHT_OUTRO_100_CHAR	紅衣人
$LINE_RANGER_TOWN_FIGHT_OUTRO_100_TEXT	我們已經有足夠的增援部隊了。
$SCENE_2_2_INTRO_TITLE	老友，新敵
$LINE_2_2_INTRO_00_CHAR	$RAN
$LINE_2_2_INTRO_00_TEXT	等等，路上有人。
$LINE_2_2_INTRO_10_CHAR	$RAN
$LINE_2_2_INTRO_10_TEXT	是其他遊俠嗎……？
$LINE_2_2_INTRO_20_CHAR	$RAN
$LINE_2_2_INTRO_20_TEXT	其他人一定從村子裡逃出來了！
$LINE_2_2_INTRO_30_CHAR	$RAN
$LINE_2_2_INTRO_30_TEXT	等等……有點不對勁！
$LINE_2_2_INTRO_40_CHAR	亡者
$LINE_2_2_INTRO_40_TEXT	哈……
$LINE_2_2_INTRO_50_CHAR	$RAN
$LINE_2_2_INTRO_50_TEXT	我們被攻擊了！
$SCENE_2_2_OUTRO_TITLE	一日之間
$LINE_2_2_OUTRO_00_CHAR	$MCG
$LINE_2_2_OUTRO_00_TEXT	那些亡者……
$LINE_2_2_OUTRO_10_CHAR	$RAN
$LINE_2_2_OUTRO_10_TEXT	它們是從村子裡來的。
$LINE_2_2_OUTRO_20_CHAR	$MCG
$LINE_2_2_OUTRO_20_TEXT	你是說所有人都被……變成亡者了？
$LINE_2_2_OUTRO_30_CHAR	$RAN
$LINE_2_2_OUTRO_30_TEXT	那裡所有人都應該對瘟疫免疫。那些倖存者已經免疫了啊。
$LINE_2_2_OUTRO_40_CHAR	$MCG
$LINE_2_2_OUTRO_40_TEXT	我不覺得他們是自願變成亡者的。
$LINE_2_2_OUTRO_50_CHAR	$RAN
$LINE_2_2_OUTRO_50_TEXT	紅衣人……
$SCENE_CARAVAN_TOWN_INTRO_TITLE	我叫大塊頭布林奇
$LINE_CARAVAN_TOWN_INTRO_00_CHAR	$MCG
$LINE_CARAVAN_TOWN_INTRO_00_TEXT	我想我們失去它們了！
$LINE_CARAVAN_TOWN_INTRO_10_CHAR	$BER
$LINE_CARAVAN_TOWN_INTRO_10_TEXT	噢夥計，我只想再要三塊亡者頭骨來完成我的項鍊！
$LINE_CARAVAN_TOWN_INTRO_20_CHAR	$BER
$LINE_CARAVAN_TOWN_INTRO_20_TEXT	過來看！
$LINE_CARAVAN_TOWN_INTRO_30_CHAR	$BER
$LINE_CARAVAN_TOWN_INTRO_30_TEXT	我叫大塊頭布林奇，這個小個子是尖牙先生。
$LINE_CARAVAN_TOWN_INTRO_40_CHAR	$MCG
$LINE_CARAVAN_TOWN_INTRO_40_TEXT	*這真是……令人不安， $BER……
$LINE_CARAVAN_TOWN_INTRO_50_CHAR	$RAN
$LINE_CARAVAN_TOWN_INTRO_50_TEXT	*$MCG，這裡有一些諾曼的商隊，可以為我們提供些補給——當然價格合理。
$LINE_CARAVAN_TOWN_INTRO_60_CHAR	$RAN
$LINE_CARAVAN_TOWN_INTRO_60_TEXT	而且推車工是我外祖父的五姨太的二表弟，所以我可以嘗試討價還價來爭取一些優惠。
$LINE_CARAVAN_TOWN_INTRO_70_CHAR	$RAN
$LINE_CARAVAN_TOWN_INTRO_70_TEXT	我建議我們應該提前儲備些物資。
$SCENE_CARAVAN_TOWN_OUTRO_TITLE	來自朋友的禮物
$LINE_CARAVAN_TOWN_OUTRO_00_CHAR	諾曼
$LINE_CARAVAN_TOWN_OUTRO_00_TEXT	*嘿，陌生人！你不會就是$MCG把？
$LINE_CARAVAN_TOWN_OUTRO_10_CHAR	$MCG
$LINE_CARAVAN_TOWN_OUTRO_10_TEXT	是的，怎麼？
$LINE_CARAVAN_TOWN_OUTRO_20_CHAR	諾曼
$LINE_CARAVAN_TOWN_OUTRO_20_TEXT	太棒了！
$LINE_CARAVAN_TOWN_OUTRO_30_CHAR	諾曼
$LINE_CARAVAN_TOWN_OUTRO_30_TEXT	幾天前，有一位老人來過這裡。
$LINE_CARAVAN_TOWN_OUTRO_40_CHAR	諾曼
$LINE_CARAVAN_TOWN_OUTRO_40_TEXT	他說你會來，然後讓我把這個轉交給你。
$LINE_CARAVAN_TOWN_OUTRO_50_CHAR	諾曼
$LINE_CARAVAN_TOWN_OUTRO_50_TEXT	他說這會對你有所幫助。
$LINE_CARAVAN_TOWN_OUTRO_60_CHAR	諾曼
$LINE_CARAVAN_TOWN_OUTRO_60_TEXT	如果硬要說的話，他是有一點點奇怪。
$LINE_CARAVAN_TOWN_OUTRO_70_CHAR	諾曼
$LINE_CARAVAN_TOWN_OUTRO_70_TEXT	但是任何送我免費羊皮紙的人，就是大好人！
$LINE_CARAVAN_TOWN_OUTRO_80_CHAR	諾曼
$LINE_CARAVAN_TOWN_OUTRO_80_TEXT	我很缺這東西。
$LINE_CARAVAN_TOWN_OUTRO_90_CHAR	諾曼
$LINE_CARAVAN_TOWN_OUTRO_90_TEXT	這東西很好吃！
$LINE_CARAVAN_TOWN_OUTRO_100_CHAR	$MCG
$LINE_CARAVAN_TOWN_OUTRO_100_TEXT	謝謝你，朋友。
$SCENE_MONASTERY_GATES_INTRO_TITLE	修道院大門
$LINE_MONASTERY_GATES_INTRO_00_CHAR	$BER
$LINE_MONASTERY_GATES_INTRO_00_TEXT	我們到了：瑟連裡第七分會會堂！
$LINE_MONASTERY_GATES_INTRO_10_CHAR	$MCG
$LINE_MONASTERY_GATES_INTRO_10_TEXT	這就是修道院？
$LINE_MONASTERY_GATES_INTRO_20_CHAR	$BER
$LINE_MONASTERY_GATES_INTRO_20_TEXT	怎麼，你以為是怎樣的？
$LINE_MONASTERY_GATES_INTRO_30_CHAR	$MCG
$LINE_MONASTERY_GATES_INTRO_30_TEXT	我還以為它會像艾殊王國的皇家修道院那樣呢。
$LINE_MONASTERY_GATES_INTRO_40_CHAR	$BER
$LINE_MONASTERY_GATES_INTRO_40_TEXT	好吧，如果你還嫌氣氛不夠，你可以為你唱聖歌。
$LINE_MONASTERY_GATES_INTRO_50_CHAR	$BER
$LINE_MONASTERY_GATES_INTRO_50_TEXT	哦哦哦哦哦哦哦啊啊啊啊啊啊哈啊啊啊啊
$LINE_MONASTERY_GATES_INTRO_60_CHAR	$MCG
$LINE_MONASTERY_GATES_INTRO_60_TEXT	它看起來不像是寺廟，更像是堡壘。
$LINE_MONASTERY_GATES_INTRO_70_CHAR	紅衣人
$LINE_MONASTERY_GATES_INTRO_70_TEXT	沒錯，因為墓坑裡到處都是危險。
$LINE_MONASTERY_GATES_INTRO_80_CHAR	$MCG
$LINE_MONASTERY_GATES_INTRO_80_TEXT	你！
$LINE_MONASTERY_GATES_INTRO_90_CHAR	紅衣人
$LINE_MONASTERY_GATES_INTRO_90_TEXT	你以為坐在這牆後面的那個老蠢貨能救你？
$LINE_MONASTERY_GATES_INTRO_100_CHAR	紅衣人
$LINE_MONASTERY_GATES_INTRO_100_TEXT	你已經被隔絕了。這座寺廟也許也是奎德帝國能給予你幫助的最後的救命稻草了吧。
$LINE_MONASTERY_GATES_INTRO_110_CHAR	紅衣人
$LINE_MONASTERY_GATES_INTRO_110_TEXT	亡者，擊潰他們！
$SCENE_MONASTERY_GATES_OUTRO_TITLE	友好之牆
$LINE_MONASTERY_GATES_OUTRO_00_CHAR	神秘老人
$LINE_MONASTERY_GATES_OUTRO_00_TEXT	大門開了！快進去，趁他們還沒有重整部隊！
$LINE_MONASTERY_GATES_OUTRO_10_CHAR	$MCG
$LINE_MONASTERY_GATES_OUTRO_10_TEXT	所有人快進修道院！
$LINE_MONASTERY_GATES_OUTRO_20_CHAR	$MCG
$LINE_MONASTERY_GATES_OUTRO_20_TEXT	你又一次救了我們的命，尊敬的長者。
$LINE_MONASTERY_GATES_OUTRO_30_CHAR	神秘老人
$LINE_MONASTERY_GATES_OUTRO_30_TEXT	我是為你們，也是為了我自己。
$LINE_MONASTERY_GATES_OUTRO_40_CHAR	神秘老人
$LINE_MONASTERY_GATES_OUTRO_40_TEXT	你不知道你自己的重要性。
$LINE_MONASTERY_GATES_OUTRO_50_CHAR	神秘老人
$LINE_MONASTERY_GATES_OUTRO_50_TEXT	你是能夠進入他們世界的人……
$LINE_MONASTERY_GATES_OUTRO_60_CHAR	$MCG
$LINE_MONASTERY_GATES_OUTRO_60_TEXT	拜託了，請你解釋一下上周發生在我身上的事情——
$LINE_MONASTERY_GATES_OUTRO_70_CHAR	神秘老人
$LINE_MONASTERY_GATES_OUTRO_70_TEXT	這說來話長，但是我們的時間不多了。
$LINE_MONASTERY_GATES_OUTRO_80_CHAR	神秘老人
$LINE_MONASTERY_GATES_OUTRO_80_TEXT	敵人的軍隊仍然在門口。
$LINE_MONASTERY_GATES_OUTRO_90_CHAR	$MCG
$LINE_MONASTERY_GATES_OUTRO_90_TEXT	那至少告訴我：我到底欠誰一條命？
$SCENE_MONASTERY_SIEGE_INTRO_TITLE	圍城
$LINE_MONASTERY_SIEGE_INTRO_00_CHAR	奧斯蒙
$LINE_MONASTERY_SIEGE_INTRO_00_TEXT	夠了！
$LINE_MONASTERY_SIEGE_INTRO_10_CHAR	奧斯蒙
$LINE_MONASTERY_SIEGE_INTRO_10_TEXT	我的亡者大軍都被摧毀了。
$LINE_MONASTERY_SIEGE_INTRO_20_CHAR	奧斯蒙
$LINE_MONASTERY_SIEGE_INTRO_20_TEXT	我不打算再讓我的人去攻打修道院城門了。
$LINE_MONASTERY_SIEGE_INTRO_30_CHAR	紅衣人
$LINE_MONASTERY_SIEGE_INTRO_30_TEXT	而這正是你需要做的事情。
$LINE_MONASTERY_SIEGE_INTRO_40_CHAR	奧斯蒙
$LINE_MONASTERY_SIEGE_INTRO_40_TEXT	不，我的朋友，我們完了。該死的！你的決定讓我破了一大筆財。
$LINE_MONASTERY_SIEGE_INTRO_50_CHAR	紅衣人
$LINE_MONASTERY_SIEGE_INTRO_50_TEXT	而你還需要再破一點財。
$LINE_MONASTERY_SIEGE_INTRO_51_CHAR	奧斯蒙
$LINE_MONASTERY_SIEGE_INTRO_51_TEXT	什麼？！
$LINE_MONASTERY_SIEGE_INTRO_52_CHAR	舍裡米爾
$LINE_MONASTERY_SIEGE_INTRO_52_TEXT	你應該更小心地看管你的實物。只要一點點毒藥，你就只是另一具注入我意志的屍體了。
$LINE_MONASTERY_SIEGE_INTRO_60_CHAR	奧斯蒙
$LINE_MONASTERY_SIEGE_INTRO_60_TEXT	啊啊啊啊啊啊啊啊！
$LINE_MONASTERY_SIEGE_INTRO_70_CHAR	奧斯蒙
$LINE_MONASTERY_SIEGE_INTRO_70_TEXT	我、我的……主人……您……想要什麼……？
$LINE_MONASTERY_SIEGE_INTRO_80_CHAR	紅衣人
$LINE_MONASTERY_SIEGE_INTRO_80_TEXT	我的孩子，我有個任務給你……
$SCENE_MONASTERY_SIEGE_OUTRO_TITLE	預兆
$LINE_MONASTERY_SIEGE_OUTRO_00_CHAR	$HEA
$LINE_MONASTERY_SIEGE_OUTRO_00_TEXT	他們最後的力量也被瓦解了。
$LINE_MONASTERY_SIEGE_OUTRO_10_CHAR	$HEA
$LINE_MONASTERY_SIEGE_OUTRO_10_TEXT	我們暫時沒事了。
$LINE_MONASTERY_SIEGE_OUTRO_20_CHAR	聲音
$LINE_MONASTERY_SIEGE_OUTRO_20_TEXT	還沒有結束，朋友。
$LINE_MONASTERY_SIEGE_OUTRO_30_CHAR	$MCG
$LINE_MONASTERY_SIEGE_OUTRO_30_TEXT	那是什麼？
$LINE_MONASTERY_SIEGE_OUTRO_40_CHAR	$HEA
$LINE_MONASTERY_SIEGE_OUTRO_40_TEXT	現在你的死人僕從們不僅幫你戰鬥，還幫你說話了？
$LINE_MONASTERY_SIEGE_OUTRO_50_CHAR	紅衣人
$LINE_MONASTERY_SIEGE_OUTRO_50_TEXT	你們現在也看到了，我已經勢不可擋了。
$LINE_MONASTERY_SIEGE_OUTRO_60_CHAR	紅衣人
$LINE_MONASTERY_SIEGE_OUTRO_60_TEXT	把女孩交過來，那麼修道院就不會有事。
$LINE_MONASTERY_SIEGE_OUTRO_70_CHAR	$HEA
$LINE_MONASTERY_SIEGE_OUTRO_70_TEXT	舍裡米爾，你曾經是那個人——
$LINE_MONASTERY_SIEGE_OUTRO_80_CHAR	舍裡米爾
$LINE_MONASTERY_SIEGE_OUTRO_80_TEXT	你是說，<LQ>人<RQ>？
$LINE_MONASTERY_SIEGE_OUTRO_90_CHAR	舍裡米爾
$LINE_MONASTERY_SIEGE_OUTRO_90_TEXT	你這個掩藏在僧侶長袍之下，畏縮在修道院高牆之後的膽小鬼，你有什麼資格和我提<LQ>人<RQ>這個字！
$LINE_MONASTERY_SIEGE_OUTRO_100_CHAR	舍裡米爾
$LINE_MONASTERY_SIEGE_OUTRO_100_TEXT	在這血流成河的情況下你還想保持兩手乾淨嗎？
$LINE_MONASTERY_SIEGE_OUTRO_110_CHAR	舍裡米爾
$LINE_MONASTERY_SIEGE_OUTRO_110_TEXT	我的朋友，我沒有你那麼崇高的美德，這對我來說是一種奢侈。我只會盡自己一切所能去拯救這個世界。
$LINE_MONASTERY_SIEGE_OUTRO_120_CHAR	舍裡米爾
$LINE_MONASTERY_SIEGE_OUTRO_120_TEXT	不管需要犧牲什麼。
$LINE_MONASTERY_SIEGE_OUTRO_130_CHAR	$HEA
$LINE_MONASTERY_SIEGE_OUTRO_130_TEXT	這？這叫做拯救？這些屍骨遍野？這些血流成河？這都是你一手造成的！
$LINE_MONASTERY_SIEGE_OUTRO_140_CHAR	舍裡米爾
$LINE_MONASTERY_SIEGE_OUTRO_140_TEXT	犧牲一些人可以拯救全世界。我記得你也做出過這樣的犧牲……
$LINE_MONASTERY_SIEGE_OUTRO_150_CHAR	舍裡米爾
$LINE_MONASTERY_SIEGE_OUTRO_150_TEXT	……曾經好幾次。
$LINE_MONASTERY_SIEGE_OUTRO_160_CHAR	$HEA
$LINE_MONASTERY_SIEGE_OUTRO_160_TEXT	舍裡米爾——
$LINE_MONASTERY_SIEGE_OUTRO_170_CHAR	舍裡米爾
$LINE_MONASTERY_SIEGE_OUTRO_170_TEXT	*夠了。我現在在和叫$MCG的人說話。
$LINE_MONASTERY_SIEGE_OUTRO_180_CHAR	$MCG
$LINE_MONASTERY_SIEGE_OUTRO_180_TEXT	你想要什麼？
$LINE_MONASTERY_SIEGE_OUTRO_190_CHAR	舍裡米爾
$LINE_MONASTERY_SIEGE_OUTRO_190_TEXT	如果你現在投降的話，可以拯救無數的性命。
$LINE_MONASTERY_SIEGE_OUTRO_200_CHAR	舍裡米爾
$LINE_MONASTERY_SIEGE_OUTRO_200_TEXT	你活著是一件很危險的事。
$LINE_MONASTERY_SIEGE_OUTRO_210_CHAR	舍裡米爾
$LINE_MONASTERY_SIEGE_OUTRO_210_TEXT	跟我來，你會拯救成百，甚至上千的人的性命。
$LINE_MONASTERY_SIEGE_OUTRO_220_CHAR	$HEA
$LINE_MONASTERY_SIEGE_OUTRO_220_TEXT	聖令將永不背叛踏入此地之人。
$LINE_MONASTERY_SIEGE_OUTRO_230_CHAR	舍裡米爾
$LINE_MONASTERY_SIEGE_OUTRO_230_TEXT	很好。
$LINE_MONASTERY_SIEGE_OUTRO_240_CHAR	舍裡米爾
$LINE_MONASTERY_SIEGE_OUTRO_240_TEXT	再見，朋友。我還會回來的。
$SCENE_MONASTERY_TOWN_OUTRO_TITLE	獵殺行動
$NARR_MONASTERY_TOWN_OUTRO_00_TEXT	第三幕
$NARR_MONASTERY_TOWN_OUTRO_00_SUB_TEXT	*齒輪不會怨恨杠杆，砝碼不會責怪鐵鍊，但是每一部分都和諧相處，只為了完成造物者的意願。
$NARR_MONASTERY_TOWN_OUTRO_00_SUB_SUB_TEXT	*$N$N$N$N$N——摘自瑟林達寫給七王國的第二封信
$LINE_MONASTERY_TOWN_OUTRO_00_CHAR	$MCG
$LINE_MONASTERY_TOWN_OUTRO_00_TEXT	我還是不敢相信屍體會做出這樣的事情……
$LINE_MONASTERY_TOWN_OUTRO_10_CHAR	$HEA
$LINE_MONASTERY_TOWN_OUTRO_10_TEXT	肉體只是精神棲息的容器罷了。
$LINE_MONASTERY_TOWN_OUTRO_20_CHAR	$HEA
$LINE_MONASTERY_TOWN_OUTRO_20_TEXT	你可以去達的世界，精神的世界，這讓你可以從本質上進行攻擊，而不是僅僅對抗其肉身載體。
$LINE_MONASTERY_TOWN_OUTRO_30_CHAR	$MCG
$LINE_MONASTERY_TOWN_OUTRO_30_TEXT	但是，是什麼精神在驅使他們？
$LINE_MONASTERY_TOWN_OUTRO_40_CHAR	$MCG
$LINE_MONASTERY_TOWN_OUTRO_40_TEXT	舍裡米爾
$LINE_MONASTERY_TOWN_OUTRO_50_CHAR	$HEA
$LINE_MONASTERY_TOWN_OUTRO_50_TEXT	……是的。他可以通過未知的力量，來講自己的意願灌注進死者的軀體之內……
$LINE_MONASTERY_TOWN_OUTRO_60_CHAR	$HEA
$LINE_MONASTERY_TOWN_OUTRO_60_TEXT	最終來達成他那些黑暗的目的。
$LINE_MONASTERY_TOWN_OUTRO_70_CHAR	$HEA
$LINE_MONASTERY_TOWN_OUTRO_70_TEXT	*有很多事我必須要告訴你，$MCG。
$LINE_MONASTERY_TOWN_OUTRO_80_CHAR	$HEA
$LINE_MONASTERY_TOWN_OUTRO_80_TEXT	……但是我們沒有時間了。等我們安全出去後，我再告訴你。
$SCENE_3_1_INTRO_TITLE	遠處的煙霧
$LINE_3_1_INTRO_00_CHAR	$MCG
$LINE_3_1_INTRO_00_TEXT	我必須要向僧侶們為我們所做的一切表示感激。我從來沒想到會有人願意無私地幫助這些瘟疫受害者。
$LINE_3_1_INTRO_10_CHAR	$HEA
$LINE_3_1_INTRO_10_TEXT	在混亂之中重建秩序，這是瑟連裡一直以來的宗旨。我們有一家醫院在這附近，我們現在就過去吧。
$LINE_3_1_INTRO_20_CHAR	$MCG
$LINE_3_1_INTRO_20_TEXT	那裡安全嗎？
$LINE_3_1_INTRO_30_CHAR	$HEA
$LINE_3_1_INTRO_30_TEXT	不，但是那裡有一個病人會成為我們強大的盟友。
$LINE_3_1_INTRO_40_CHAR	$HEA
$LINE_3_1_INTRO_40_TEXT	你不是唯一一個從死亡邊緣逃生回來並且獲得新能力的人。
$LINE_3_1_INTRO_50_CHAR	$MCG
$LINE_3_1_INTRO_50_TEXT	長老，遠處那是煙嗎？
$LINE_3_1_INTRO_60_CHAR	$HEA
$LINE_3_1_INTRO_60_TEXT	是醫院！出事了！
$LINE_3_1_INTRO_70_CHAR	$HEA
$LINE_3_1_INTRO_70_TEXT	我們必須快點！
$SCENE_3_1_OUTRO_TITLE	新盟友
$LINE_3_1_OUTRO_00_CHAR	$HEA
$LINE_3_1_OUTRO_00_TEXT	他是唯一的倖存者了。
$LINE_3_1_OUTRO_10_CHAR	病人
$LINE_3_1_OUTRO_10_TEXT	你好啊，尊敬的老者。
$LINE_3_1_OUTRO_20_CHAR	$HEA
$LINE_3_1_OUTRO_20_TEXT	醫院怎樣了？
$LINE_3_1_OUTRO_30_CHAR	病人
$LINE_3_1_OUTRO_30_TEXT	這是這些天來的第四次攻擊了。
$LINE_3_1_OUTRO_40_CHAR	$HEA
$LINE_3_1_OUTRO_40_TEXT	病人們呢？
$LINE_3_1_OUTRO_50_CHAR	病人
$LINE_3_1_OUTRO_50_TEXT	大家都還活著。
$LINE_3_1_OUTRO_60_CHAR	病人
$LINE_3_1_OUTRO_60_TEXT	敵人被打的落花流水。
$LINE_3_1_OUTRO_70_CHAR	$HEA
$LINE_3_1_OUTRO_70_TEXT	還是老樣子，這麼好戰。
$LINE_3_1_OUTRO_80_CHAR	$HEA
$LINE_3_1_OUTRO_80_TEXT	我想讓你來見見今天的戰鬥勝利的功臣。
$LINE_3_1_OUTRO_90_CHAR	$MCG
$LINE_3_1_OUTRO_90_TEXT	*嗯……你好。我是$MCG。
$LINE_3_1_OUTRO_100_CHAR	病人
$LINE_3_1_OUTRO_100_TEXT	很高興見到新盟友。
$SCENE_3_2_INTRO_TITLE	火焰之女
$LINE_3_2_INTRO_00_CHAR	$MAG
$LINE_3_2_INTRO_00_TEXT	我很感激這裡為我提供的一切。
$LINE_3_2_INTRO_10_CHAR	$MAG
$LINE_3_2_INTRO_10_TEXT	你救了我的命，不然我現在已經……渾身冰涼了。
$LINE_3_2_INTRO_20_CHAR	$MAG
$LINE_3_2_INTRO_20_TEXT	但是醫院的圍牆保護了我。
$LINE_3_2_INTRO_30_CHAR	$MAG
$LINE_3_2_INTRO_30_TEXT	儘管有寒冰的覆蓋，但是宇宙的怒焰仍然在我體內燃燒。
$LINE_3_2_INTRO_40_CHAR	$MAG
$LINE_3_2_INTRO_40_TEXT	我渴望和敵人大戰一場。
$LINE_3_2_INTRO_50_CHAR	$HEA
$LINE_3_2_INTRO_50_TEXT	*這也是我在這裡的原因，$MAG。
$LINE_3_2_INTRO_60_CHAR	$HEA
$LINE_3_2_INTRO_60_TEXT	我們——需要你的説明。
$LINE_3_2_INTRO_70_CHAR	$HEA
$LINE_3_2_INTRO_70_TEXT	明天，我會率領——
$LINE_3_2_INTRO_80_CHAR	$HEA
$LINE_3_2_INTRO_80_TEXT	那是什麼？
$LINE_3_2_INTRO_90_CHAR	$MAG
$LINE_3_2_INTRO_90_TEXT	門口又來了好多敵人！
$LINE_3_2_INTRO_100_CHAR	$HEA
$LINE_3_2_INTRO_100_TEXT	守護者們！我們受到攻擊了！
$LINE_3_2_INTRO_110_CHAR	$MAG
$LINE_3_2_INTRO_110_TEXT	此生此世，我仍是火焰之女。
$LINE_3_2_INTRO_120_CHAR	$MAG
$LINE_3_2_INTRO_120_TEXT	與我對抗的敵人，會被燃燒成灰燼！
$SCENE_3_2_OUTRO_TITLE	盟友的背景
$LINE_3_2_OUTRO_00_CHAR	$MCG
$LINE_3_2_OUTRO_00_TEXT	咳咳。無意冒犯，但她是奎德人，對嗎？
$LINE_3_2_OUTRO_10_CHAR	$HEA
$LINE_3_2_OUTRO_10_TEXT	這裡的大多數人都是。
$LINE_3_2_OUTRO_20_CHAR	$HEA
$LINE_3_2_OUTRO_20_TEXT	在瘟疫爆發之前，墓坑是一個戰俘營。
$LINE_3_2_OUTRO_30_CHAR	$HEA
$LINE_3_2_OUTRO_30_TEXT	這裡的很多人勞苦一生開採礦山，最終卻把瘟疫受害者扔進來與他們為伴。
$LINE_3_2_OUTRO_40_CHAR	$MCG
$LINE_3_2_OUTRO_40_TEXT	但這改變不了一個事實，他們就是一群種族滅絕的拜火教瘋子。奎德帝國不惜一切代價要——
$LINE_3_2_OUTRO_50_CHAR	$HEA
$LINE_3_2_OUTRO_50_TEXT	*$MCG，奎德帝國已經滅絕了。毀滅奎德的敵人現在已經開始覬覦這個世界的其他國家。
$LINE_3_2_OUTRO_60_CHAR	$HEA
$LINE_3_2_OUTRO_60_TEXT	我們不能對盟友的背景吹毛求疵。
$LINE_3_2_OUTRO_70_CHAR	$MCG
$LINE_3_2_OUTRO_70_TEXT	*噢，嘿，$MAG，我沒看到你也在這兒。
$LINE_3_2_OUTRO_80_CHAR	$MCG
$LINE_3_2_OUTRO_80_TEXT	我們只是在討論，呃，一些事情……
$LINE_3_2_OUTRO_90_CHAR	$MAG
$LINE_3_2_OUTRO_90_TEXT	很好。你知道他們說了什麼：
$LINE_3_2_OUTRO_100_CHAR	$MAG
$LINE_3_2_OUTRO_100_TEXT	<LQ>對於那些可能會在半夜撕裂你喉嚨的人，最好不要在背後說他們的閒話。<RQ>
$LINE_3_2_OUTRO_110_CHAR	$MCG
$LINE_3_2_OUTRO_110_TEXT	我對這句話不是很熟悉……誰……呃……誰說的？
$LINE_3_2_OUTRO_120_CHAR	$MAG
$LINE_3_2_OUTRO_120_TEXT	大概是那些喉嚨還沒有撕裂的人吧。
$LINE_3_2_OUTRO_130_CHAR	$MAG
$LINE_3_2_OUTRO_130_TEXT	因為那些已經被撕裂的人估計也沒法說話了吧。
$LINE_3_2_OUTRO_140_CHAR	$MAG
$LINE_3_2_OUTRO_140_TEXT	他們只會，<LQ>咯咯，咯咯，咯咯。<RQ>
$LINE_3_2_OUTRO_150_CHAR	$MAG
$LINE_3_2_OUTRO_150_TEXT	然後你就會問，<LQ>這是什麼建議嗎？我不明白。能不能說清楚些？<RQ>
$LINE_3_2_OUTRO_160_CHAR	$MCG
$LINE_3_2_OUTRO_160_TEXT	……我真的很高興我們是朋友。
$LINE_3_2_OUTRO_170_CHAR	$MAG
$LINE_3_2_OUTRO_170_TEXT	我也是！友誼萬歲！比如，如果你想要在誰睡著的時候撕裂他的喉嚨的話，你只要說，<LQ>嘿朋友，幹掉他——<RQ>
$LINE_3_2_OUTRO_180_CHAR	$MCG
$LINE_3_2_OUTRO_180_TEXT	……確實如此！
$LINE_3_2_OUTRO_190_CHAR	$MCG
$LINE_3_2_OUTRO_190_TEXT	……我有一個很重要的問題要問你！
$LINE_3_2_OUTRO_200_CHAR	$MAG
$LINE_3_2_OUTRO_200_TEXT	什麼？
$LINE_3_2_OUTRO_210_CHAR	$MCG
$LINE_3_2_OUTRO_210_TEXT	嗯……這些冰是怎麼回事？我知道你通常是個火人，那……
$LINE_3_2_OUTRO_220_CHAR	$MAG
$LINE_3_2_OUTRO_220_TEXT	那我為什麼不從我的眼眶裡射出火球來？
$LINE_3_2_OUTRO_230_CHAR	$MCG
$LINE_3_2_OUTRO_230_TEXT	是的，我猜想。
$LINE_3_2_OUTRO_240_CHAR	$MAG
$LINE_3_2_OUTRO_240_TEXT	當我瀕臨死亡的時候……我看到了地獄……冰涼的黑暗無窮無盡地延伸。那是個沒有溫暖和光明的地方。
$LINE_3_2_OUTRO_250_CHAR	$MAG
$LINE_3_2_OUTRO_250_TEXT	然後一個金色的人，輕聲呼喚我的名字。緊接著我才知道，聽下去會變成詛咒。
$LINE_3_2_OUTRO_260_CHAR	$MAG
$LINE_3_2_OUTRO_260_TEXT	我想逃走，但是我無法移動。隨著時間推移，低語聲越來越大，最後掩蓋了我的尖叫。
$LINE_3_2_OUTRO_270_CHAR	$MAG
$LINE_3_2_OUTRO_270_TEXT	然後突然間，所有的一切都消失了。我發現自己在醫院裡，僧侶們在照顧我。
$LINE_3_2_OUTRO_280_CHAR	$MAG
$LINE_3_2_OUTRO_280_TEXT	但是儘管我逃離了地獄，但我也發現自己從那裡帶了些東西回來。
$LINE_3_2_OUTRO_290_CHAR	$MAG
$LINE_3_2_OUTRO_290_TEXT	這……這些我心臟中的寒冰。我從來沒有過這樣的感覺。
$LINE_3_2_OUTRO_300_CHAR	$MAG
$LINE_3_2_OUTRO_300_TEXT	每一天我都希望火焰能讓我重新變得完整……但是每一天詛咒都在繼續。
$LINE_3_2_OUTRO_310_CHAR	$MAG
$LINE_3_2_OUTRO_310_TEXT	我不是唯一一個有這樣經歷的人。很多瘟疫的倖存者都發生了變化。
$LINE_3_2_OUTRO_320_CHAR	$MAG
$LINE_3_2_OUTRO_320_TEXT	直到火焰憐憫我的時候，我就能用這詛咒對抗那些違背正義的敵人。
$LINE_3_2_OUTRO_330_CHAR	$MAG
$LINE_3_2_OUTRO_330_TEXT	正如你所見的，只要你全身心專注，你可以使用任何東西殺死你的敵人。
$SCENE_HOSPITAL_INTRO_TITLE	骯髒的過去
$LINE_HOSPITAL_INTRO_00_CHAR	$MCG
$LINE_HOSPITAL_INTRO_00_TEXT	尊敬的長者，如果我們不能在這裡尋求庇護，那麼你的計畫是什麼？
$LINE_HOSPITAL_INTRO_10_CHAR	$HEA
$LINE_HOSPITAL_INTRO_10_TEXT	*$MCG，我的一生中有很多愧疚的事情……
$LINE_HOSPITAL_INTRO_20_CHAR	$HEA
$LINE_HOSPITAL_INTRO_20_TEXT	我不希望其中再增加一項欺騙你的罪名。
$LINE_HOSPITAL_INTRO_30_CHAR	$HEA
$LINE_HOSPITAL_INTRO_30_TEXT	如果我要繼續引導你，那麼有些關於我和我們對手的事情，你必須知道。
$LINE_HOSPITAL_INTRO_40_CHAR	$MCG
$LINE_HOSPITAL_INTRO_40_TEXT	舍裡米爾？
$LINE_HOSPITAL_INTRO_50_CHAR	$HEA
$LINE_HOSPITAL_INTRO_50_TEXT	是的。他曾經是我們這些人的偉大領袖，現在一些神秘的力量讓他變得瘋狂。
$LINE_HOSPITAL_INTRO_60_CHAR	$MCG
$LINE_HOSPITAL_INTRO_60_TEXT	等等，你是說他是那個舍裡米爾？那個皇太子舍裡米爾·阿薩提莫？
$LINE_HOSPITAL_INTRO_70_CHAR	$MCG
$LINE_HOSPITAL_INTRO_70_TEXT	但是，他是那場戰爭中犧牲的英雄！
$LINE_HOSPITAL_INTRO_80_CHAR	$HEA
$LINE_HOSPITAL_INTRO_80_TEXT	所以每個人都相信這種說法，但是真相是一段更痛苦的歷史。
$LINE_HOSPITAL_INTRO_90_CHAR	$HEA
$LINE_HOSPITAL_INTRO_90_TEXT	在你之前，那時候奎德戰爭達到了新的高度……你無法想像那種毀滅性的災難。
$LINE_HOSPITAL_INTRO_100_CHAR	$HEA
$LINE_HOSPITAL_INTRO_100_TEXT	王權毀滅，屠殺遍野。
$LINE_HOSPITAL_INTRO_110_CHAR	$HEA
$LINE_HOSPITAL_INTRO_110_TEXT	我們已經處於湮滅的邊緣。
$LINE_HOSPITAL_INTRO_120_CHAR	$HEA
$LINE_HOSPITAL_INTRO_120_TEXT	舍裡米爾和我都是艾殊軍團的將帥，我們就像親兄弟一樣。
$LINE_HOSPITAL_INTRO_130_CHAR	$HEA
$LINE_HOSPITAL_INTRO_130_TEXT	我們的軍隊驍勇如虎，但是我們心中都清楚自己在劫難逃。
$LINE_HOSPITAL_INTRO_140_CHAR	$HEA
$LINE_HOSPITAL_INTRO_140_TEXT	每天我們都看著艾殊一步步走向滅亡。
$LINE_HOSPITAL_INTRO_150_CHAR	$HEA
$LINE_HOSPITAL_INTRO_150_TEXT	然後，在一個敵人的廢墟城市中，舍裡米爾王子發現了一些東西。
$LINE_HOSPITAL_INTRO_160_CHAR	$HEA
$LINE_HOSPITAL_INTRO_160_TEXT	一個古老力量的位置，本來已經遺失在過去的時間長河裡。
$LINE_HOSPITAL_INTRO_170_CHAR	$HEA
$LINE_HOSPITAL_INTRO_170_TEXT	門外的敵人已經兵臨城下時，他制定了一個計畫。
$LINE_HOSPITAL_INTRO_180_CHAR	$HEA
$LINE_HOSPITAL_INTRO_180_TEXT	一個黑暗的計畫，一個絕望的產物。
$LINE_HOSPITAL_INTRO_190_CHAR	$HEA
$LINE_HOSPITAL_INTRO_190_TEXT	而我，十分愚蠢地，幫助了他。
$LINE_HOSPITAL_INTRO_200_CHAR	$HEA
$LINE_HOSPITAL_INTRO_200_TEXT	*$MCG，我已經竭盡全力的用我餘下的生命來挽回舍裡米爾的毀滅。
$LINE_HOSPITAL_INTRO_210_CHAR	$HEA
$LINE_HOSPITAL_INTRO_210_TEXT	無論出於什麼原因，他選擇了你作為他瘋狂的目標。
$LINE_HOSPITAL_INTRO_220_CHAR	$HEA
$LINE_HOSPITAL_INTRO_220_TEXT	如果我們能找到原因，我們也許能利用其來對抗他。
$LINE_HOSPITAL_INTRO_230_CHAR	$HEA
$LINE_HOSPITAL_INTRO_230_TEXT	*你已經看到他的能力了，$MCG。你會幫助我嗎？
$LINE_HOSPITAL_INTRO_240_CHAR	$MCG
$LINE_HOSPITAL_INTRO_240_TEXT	盡我所能。
$SCENE_HOSPITAL_OUTRO_TITLE	進入沙漠
$LINE_HOSPITAL_OUTRO_00_CHAR	$HEA
$LINE_HOSPITAL_OUTRO_00_TEXT	做好準備。在我們面前的是一個漫長的遠征。
$LINE_HOSPITAL_OUTRO_10_CHAR	$MCG
$LINE_HOSPITAL_OUTRO_10_TEXT	我們要去哪裡？
$LINE_HOSPITAL_OUTRO_20_CHAR	$HEA
$LINE_HOSPITAL_OUTRO_20_TEXT	舍裡米爾發現他黑暗力量歷史的城市。
$LINE_HOSPITAL_OUTRO_30_CHAR	$HEA
$LINE_HOSPITAL_OUTRO_30_TEXT	我希望找到那些記錄，也許它們就是我們能理解舍裡米爾尋找你的關鍵……也是我們要如何對抗他的關鍵。
$LINE_HOSPITAL_OUTRO_40_CHAR	$MCG
$LINE_HOSPITAL_OUTRO_40_TEXT	那座城市在這裡……在墓坑？
$LINE_HOSPITAL_OUTRO_50_CHAR	$HEA
$LINE_HOSPITAL_OUTRO_50_TEXT	是的，是戰爭時期的遺跡。
$LINE_HOSPITAL_OUTRO_60_CHAR	$MCG
$LINE_HOSPITAL_OUTRO_60_TEXT	那舍裡米爾呢？如果他知道這個地方……
$LINE_HOSPITAL_OUTRO_70_CHAR	$HEA
$LINE_HOSPITAL_OUTRO_70_TEXT	是的，他可能預料到我們的行動。
$LINE_HOSPITAL_OUTRO_80_CHAR	$HEA
$LINE_HOSPITAL_OUTRO_80_TEXT	但是，我們不能呆在這裡。如果我們的行動足夠快速，足夠隱蔽，那麼我們也許可以在他重建軍隊之前快速進城。
$SCENE_3_3_INTRO_TITLE	沙漠據點
$LINE_3_3_INTRO_00_CHAR	$HEA
$LINE_3_3_INTRO_00_TEXT	我們的秘密入口就在這裡，沙漠表面。
$LINE_3_3_INTRO_10_CHAR	$RAN
$LINE_3_3_INTRO_10_TEXT	敵人就在我們身後！
$LINE_3_3_INTRO_20_CHAR	$HEA
$LINE_3_3_INTRO_20_TEXT	是舍裡米爾的先遣部隊。
$LINE_3_3_INTRO_30_CHAR	$HEA
$LINE_3_3_INTRO_30_TEXT	我們太慢了。
$LINE_3_3_INTRO_40_CHAR	$RAN
$LINE_3_3_INTRO_40_TEXT	快，我們必須進城！
$LINE_3_3_INTRO_50_CHAR	$HEA
$LINE_3_3_INTRO_50_TEXT	不！如果我們現在逃跑的話，大門就會被敵人佔領。
$LINE_3_3_INTRO_60_CHAR	$HEA
$LINE_3_3_INTRO_60_TEXT	然後，他的整個軍隊就會跟上，而我們會被困在彎曲纏繞的街道迷宮中無法逃跑。
$LINE_3_3_INTRO_70_CHAR	$HEA
$LINE_3_3_INTRO_70_TEXT	我們必須在這裡擊敗他們，並且摧毀我們身後的入口。
$SCENE_3_3_OUTRO_TITLE	沙漠之寶
$NARR_3_3_OUTRO_00_TEXT	第四幕
$NARR_3_3_OUTRO_00_SUB_TEXT	*我無法分辨自己在這地下呆了多久——$N幾周，也許是幾個月，暗無天日，$N隨時隨地生活在恐懼之中，因為眼前翻滾的黑暗，$N以及那些在黑暗中移動的東西。
$NARR_3_3_OUTRO_00_SUB_SUB_TEXT	*$N$N$N$N$N——摘自諾曼冒險家，克萊斯特·卡達所收集的故事
$LINE_3_3_OUTRO_00_CHAR	$BER
$LINE_3_3_OUTRO_00_TEXT	*沒錯！感受$BER的憤怒吧！快跑吧！快從我這粗獷不羈但誘人性感的魅力中逃跑吧！
$LINE_3_3_OUTRO_10_CHAR	$BER
$LINE_3_3_OUTRO_10_TEXT	*趁你們現在還能逃跑，快跑吧！你們這些悲慘的可憐蟲！你們這些卑微的渣滓！你們……你們……這些娘娘腔！
$LINE_3_3_OUTRO_20_CHAR	$HEA
$LINE_3_3_OUTRO_20_TEXT	……
$LINE_3_3_OUTRO_30_CHAR	$BER
$LINE_3_3_OUTRO_30_TEXT	你認為最後一個太過了嗎？我在努力保持新鮮感，你懂的。我在努力創造一些新的罵人的話。
$LINE_3_3_OUTRO_40_CHAR	$HEA
$LINE_3_3_OUTRO_40_TEXT	那你創作完畢了嗎？我必須要封閉我們身後的入口了。
$LINE_3_3_OUTRO_50_CHAR	$BER
$LINE_3_3_OUTRO_50_TEXT	哇……你可以用意念讓東西爆炸？
$LINE_3_3_OUTRO_60_CHAR	$BER
$LINE_3_3_OUTRO_60_TEXT	原諒我！請不要用你的意念能力讓我的頭爆炸！
$LINE_3_3_OUTRO_70_CHAR	$BER
$LINE_3_3_OUTRO_70_TEXT	我會歸還所有從你包裡偷走的鞋子，我發誓！我還會還你一百雙鞋子，一千雙！
$LINE_3_3_OUTRO_80_CHAR	$HEA
$LINE_3_3_OUTRO_80_TEXT	冷靜點。這裡生長的水晶天生就不穩定。奎德帝國當年建造這座城市，就是為了戰爭來開採礦藏。
$LINE_3_3_OUTRO_90_CHAR	$HEA
$LINE_3_3_OUTRO_90_TEXT	我剛剛只是操縱了一個簡單的導火線，來引爆這裡。
$LINE_3_3_OUTRO_100_CHAR	$BER
$LINE_3_3_OUTRO_100_TEXT	等等，什麼？哦，那就算了。
$SCENE_3_4_INTRO_TITLE	不祥之兆
$LINE_3_4_INTRO_00_CHAR	$HEA
$LINE_3_4_INTRO_00_TEXT	幾年前，我和舍裡米爾也走過同樣的大廳，這裡還是沾滿了戰爭的血跡。
$LINE_3_4_INTRO_10_CHAR	$MCG
$LINE_3_4_INTRO_10_TEXT	這就是舍裡米爾發現他力量來源的地方嗎？
$LINE_3_4_INTRO_20_CHAR	$HEA
$LINE_3_4_INTRO_20_TEXT	不，我們發現了一段用奎德語撰寫的神秘歷史，但是那語言太古老了，就算是舍裡米爾這樣的博學者也完全無法解讀。
$LINE_3_4_INTRO_30_CHAR	$MCG
$LINE_3_4_INTRO_30_TEXT	那如果那古老的力量在別的地方，我們在這裡幹什麼？
$LINE_3_4_INTRO_40_CHAR	$HEA
$LINE_3_4_INTRO_40_TEXT	舍裡米爾懼怕你，很有可能是因為他當時在那份稿件中讀到了什麼——一些他當時沒有分享出來的東西……
$LINE_3_4_INTRO_50_CHAR	$HEA
$LINE_3_4_INTRO_50_TEXT	……就像他計畫中的很多方面一樣。
$LINE_3_4_INTRO_60_CHAR	$MCG
$LINE_3_4_INTRO_60_TEXT	你不可能知道。
$LINE_3_4_INTRO_70_CHAR	$HEA
$LINE_3_4_INTRO_70_TEXT	我本應該猜到的。
$LINE_3_4_INTRO_80_CHAR	$HEA
$LINE_3_4_INTRO_80_TEXT	但是徒有後悔是沒用的。我必須去制止那個我參與創造出來的怪物。
$LINE_3_4_INTRO_90_CHAR	$HEA
$LINE_3_4_INTRO_90_TEXT	我必須找到那些神秘的記錄，並且找出究竟是什麼讓舍裡米爾如此懼怕。
$LINE_3_4_INTRO_100_CHAR	$MCG
$LINE_3_4_INTRO_100_TEXT	那你認為你這次可以閱讀它嗎？
$LINE_3_4_INTRO_110_CHAR	$HEA
$LINE_3_4_INTRO_110_TEXT	我已經花費了幾年……而且，這次——奎德公主和我們在一起。
$LINE_3_4_INTRO_120_CHAR	$MCG
$LINE_3_4_INTRO_120_TEXT	她會幫助我們嗎？你的那些過去——
$LINE_3_4_INTRO_130_CHAR	$HEA
$LINE_3_4_INTRO_130_TEXT	*$MCG！有什麼東西在動！
$LINE_3_4_INTRO_140_CHAR	$MCG
$LINE_3_4_INTRO_140_TEXT	可是，我以為你已經封閉了入口！
$LINE_3_4_INTRO_150_CHAR	$HEA
$LINE_3_4_INTRO_150_TEXT	我封閉了！這肯定是別的東西！
$LINE_3_4_INTRO_160_CHAR	$MCG
$LINE_3_4_INTRO_160_TEXT	所有人，到我這兒來！
$SCENE_3_4_OUTRO_TITLE	戰爭機器的燃料
$LINE_3_4_OUTRO_00_CHAR	$MCG
$LINE_3_4_OUTRO_00_TEXT	那個水晶是什麼？
$LINE_3_4_OUTRO_10_CHAR	$HEA
$LINE_3_4_OUTRO_10_TEXT	那曾經是奎德攻城武器的關鍵。
$LINE_3_4_OUTRO_20_CHAR	$HEA
$LINE_3_4_OUTRO_20_TEXT	在地下的礦藏中隨處可見。
$LINE_3_4_OUTRO_30_CHAR	$MCG
$LINE_3_4_OUTRO_30_TEXT	你認為那就是亡者的來源嗎？
$LINE_3_4_OUTRO_40_CHAR	$HEA
$LINE_3_4_OUTRO_40_TEXT	不，他們都穿著艾殊的制服……或者別的什麼遺留的東西。
$LINE_3_4_OUTRO_50_CHAR	$HEA
$LINE_3_4_OUTRO_50_TEXT	這些人是艾殊王國的騎士。
$LINE_3_4_OUTRO_60_CHAR	$MCG
$LINE_3_4_OUTRO_60_TEXT	我們封閉了身後的入口！他們是怎麼進來的？
$LINE_3_4_OUTRO_70_CHAR	$HEA
$LINE_3_4_OUTRO_70_TEXT	我不知道……
$LINE_3_4_OUTRO_80_CHAR	$HEA
$LINE_3_4_OUTRO_80_TEXT	但是我們現在無法回頭了。
$LINE_3_4_OUTRO_90_CHAR	$HEA
$LINE_3_4_OUTRO_90_TEXT	我們的目標是皇家檔案室。
$LINE_3_4_OUTRO_100_CHAR	$MCG
$LINE_3_4_OUTRO_100_TEXT	等等……那個水晶……
$LINE_3_4_OUTRO_110_CHAR	$MCG
$LINE_3_4_OUTRO_110_TEXT	物理性質是由精神驅動的。
$LINE_3_4_OUTRO_120_CHAR	$MCG
$LINE_3_4_OUTRO_120_TEXT	而精神……是肉眼可見的……是可以被召喚的……
$LINE_3_4_OUTRO_130_CHAR	$MCG
$LINE_3_4_OUTRO_130_TEXT	我想我明白了。
$SCENE_3_5_INTRO_TITLE	與騎士的相遇
$LINE_3_5_INTRO_00_CHAR	$RAN
$LINE_3_5_INTRO_00_TEXT	……我只是說，如果我要規劃一個城市，我也許會選一個不一樣的地方。
$LINE_3_5_INTRO_10_CHAR	$RAN
$LINE_3_5_INTRO_10_TEXT	你懂的，一個地底下不會埋著一百萬噸爆炸物的地方。
$LINE_3_5_INTRO_20_CHAR	獨行騎士
$LINE_3_5_INTRO_20_TEXT	小心！他們又來了！
$LINE_3_5_INTRO_30_CHAR	$RAN
$LINE_3_5_INTRO_30_TEXT	你到底是誰？
$SCENE_3_5_OUTRO_TITLE	皇家債務
$LINE_3_5_OUTRO_00_CHAR	$KNI
$LINE_3_5_OUTRO_00_TEXT	你正好就在這裡。
$LINE_3_5_OUTRO_10_CHAR	$KNI
$LINE_3_5_OUTRO_10_TEXT	我欠你一個人情，女士。
$LINE_3_5_OUTRO_20_CHAR	$KNI
$LINE_3_5_OUTRO_20_TEXT	也許這在這個混世之中不值一提，但我依然堅守家族的傳統。
$LINE_3_5_OUTRO_30_CHAR	$KNI
$LINE_3_5_OUTRO_30_TEXT	以命償命。我將會一直效命於你，直到我的債務還清。
$LINE_3_5_OUTRO_40_CHAR	$KNI
$LINE_3_5_OUTRO_40_TEXT	這是艾殊皇室的要求。
$LINE_3_5_OUTRO_50_CHAR	$MCG
$LINE_3_5_OUTRO_50_TEXT	皇室？你是……
$LINE_3_5_OUTRO_60_CHAR	$KNI
$LINE_3_5_OUTRO_60_TEXT	誠然，只是一個小皇室，但是我身體裡流淌的血液仍然要求我守護家族的榮耀。
$LINE_3_5_OUTRO_70_CHAR	$MCG
$LINE_3_5_OUTRO_70_TEXT	這是我們的榮幸，王子殿下。
$LINE_3_5_OUTRO_80_CHAR	$KNI
$LINE_3_5_OUTRO_80_TEXT	不要向我鞠躬，女士。你才是我必須效命的人。
$LINE_3_5_OUTRO_90_CHAR	$KNI
$LINE_3_5_OUTRO_90_TEXT	我的刀鋒聽從你的命令，定會竭盡全力完成你所有的旨意。
$LINE_3_5_OUTRO_100_CHAR	$KNI
$LINE_3_5_OUTRO_100_TEXT	當然，是指合情合理的事情。
$LINE_3_5_OUTRO_110_CHAR	$KNI
$LINE_3_5_OUTRO_110_TEXT	而不是<LQ>單腳站立，假聲演唱醉虎之歌<RQ>！
$LINE_3_5_OUTRO_120_CHAR	$KNI
$LINE_3_5_OUTRO_120_TEXT	當人們聽到 <LQ>命債<RQ>二字後冒出的那些瘋狂的念頭，一定會讓你感到震驚的。
$LINE_3_5_OUTRO_130_CHAR	$MCG
$LINE_3_5_OUTRO_130_TEXT	<LQ>醉虎之歌<RQ>？
$LINE_3_5_OUTRO_140_CHAR	$KNI
$LINE_3_5_OUTRO_140_TEXT	不要去想了。
$SCENE_GUARD_TOWN_INTRO_TITLE	守衛的藏身之處
$LINE_GUARD_TOWN_INTRO_00_CHAR	$HEA
$LINE_GUARD_TOWN_INTRO_00_TEXT	我沒想到會在城堡裡找到還活著的人。
$LINE_GUARD_TOWN_INTRO_10_CHAR	$KNI
$LINE_GUARD_TOWN_INTRO_10_TEXT	墓坑的居民對於受到感染的士兵還是充滿同情的。
$LINE_GUARD_TOWN_INTRO_20_CHAR	$KNI
$LINE_GUARD_TOWN_INTRO_20_TEXT	另一方面：暴民的武力並不像所宣揚的那麼厲害。
$LINE_GUARD_TOWN_INTRO_30_CHAR	$KNI
$LINE_GUARD_TOWN_INTRO_30_TEXT	不管怎樣，一些老兵記得城堡的秘密入口——在那裡我們能免受報復。
$LINE_GUARD_TOWN_INTRO_40_CHAR	$KNI
$LINE_GUARD_TOWN_INTRO_40_TEXT	但即使是在這裡，我們仍然受到瘟疫的威脅。
$LINE_GUARD_TOWN_INTRO_50_CHAR	$HEA
$LINE_GUARD_TOWN_INTRO_50_TEXT	裝甲亡者大軍。
$LINE_GUARD_TOWN_INTRO_60_CHAR	$KNI
$LINE_GUARD_TOWN_INTRO_60_TEXT	它們曾經都是營地的成員。每當我們中有人死於噩夢般的瘟疫後，它們的人數就會增加。
$LINE_GUARD_TOWN_INTRO_70_CHAR	$HEA
$LINE_GUARD_TOWN_INTRO_70_TEXT	那此地不宜久留。
$SCENE_GUARD_TOWN_OUTRO_TITLE	警告之語
$LINE_GUARD_TOWN_OUTRO_00_CHAR	$KNI
$LINE_GUARD_TOWN_OUTRO_00_TEXT	你想要進一步深入城市嗎？
$LINE_GUARD_TOWN_OUTRO_10_CHAR	$HEA
$LINE_GUARD_TOWN_OUTRO_10_TEXT	我們必須要去皇家檔案室。
$LINE_GUARD_TOWN_OUTRO_20_CHAR	$HEA
$LINE_GUARD_TOWN_OUTRO_20_TEXT	那裡的資訊能説明扭轉這場災難。
$LINE_GUARD_TOWN_OUTRO_30_CHAR	$KNI
$LINE_GUARD_TOWN_OUTRO_30_TEXT	我必須警告你，除了亡者之外，這座城市裡還有更多其他的危險。
$LINE_GUARD_TOWN_OUTRO_40_CHAR	$KNI
$LINE_GUARD_TOWN_OUTRO_40_TEXT	火焰生物在這片土地的黑暗之處沉睡著。
$LINE_GUARD_TOWN_OUTRO_50_CHAR	$HEA
$LINE_GUARD_TOWN_OUTRO_50_TEXT	我們會直面必須面對的危險。
$LINE_GUARD_TOWN_OUTRO_60_CHAR	$KNI
$LINE_GUARD_TOWN_OUTRO_60_TEXT	我還是要警告你們一句……
$LINE_GUARD_TOWN_OUTRO_70_CHAR	$KNI
$LINE_GUARD_TOWN_OUTRO_70_TEXT	這裡有惡龍。
$LINE_GUARD_TOWN_OUTRO_80_CHAR	$KNI
$LINE_GUARD_TOWN_OUTRO_80_TEXT	我一直都想說！
$LINE_GUARD_TOWN_OUTRO_90_CHAR	$KNI
$LINE_GUARD_TOWN_OUTRO_90_TEXT	但是，認真的，我的朋友，真的有龍。
$SCENE_SIDEQUEST_5_GET_TITLE	移動的黑影
$LINE_SIDEQUEST_5_GET_00_CHAR	$BER
$LINE_SIDEQUEST_5_GET_00_TEXT	嘿，壞蛋們！你們在外面嗎？
$LINE_SIDEQUEST_5_GET_10_CHAR	$BER
$LINE_SIDEQUEST_5_GET_10_TEXT	……
$LINE_SIDEQUEST_5_GET_20_CHAR	$BER
$LINE_SIDEQUEST_5_GET_20_TEXT	不在嗎？太好了！好了，我們完工了。大家去吃飯吧！
$LINE_SIDEQUEST_5_GET_30_CHAR	$KNI
$LINE_SIDEQUEST_5_GET_30_TEXT	嗯，這可不是站崗的人的工作。
$LINE_SIDEQUEST_5_GET_40_CHAR	$BER
$LINE_SIDEQUEST_5_GET_40_TEXT	噢，沒錯！我忘了最重要的一步：
$LINE_SIDEQUEST_5_GET_50_CHAR	$BER
$LINE_SIDEQUEST_5_GET_50_TEXT	保持良好形象！
$LINE_SIDEQUEST_5_GET_60_CHAR	$KNI
$LINE_SIDEQUEST_5_GET_60_TEXT	……
$LINE_SIDEQUEST_5_GET_70_CHAR	$KNI
$LINE_SIDEQUEST_5_GET_70_TEXT	這有什麼幫助嗎？
$LINE_SIDEQUEST_5_GET_80_CHAR	$BER
$LINE_SIDEQUEST_5_GET_80_TEXT	我們要表現的兇神惡煞一點。我是說，像你這樣的小蝦米走出去，擺明就是讓別人來欺負的。
$LINE_SIDEQUEST_5_GET_90_CHAR	$KNI
$LINE_SIDEQUEST_5_GET_90_TEXT	……
$LINE_SIDEQUEST_5_GET_100_CHAR	$KNI
$LINE_SIDEQUEST_5_GET_100_TEXT	那是什麼？
$LINE_SIDEQUEST_5_GET_110_CHAR	$BER
$LINE_SIDEQUEST_5_GET_110_TEXT	*這是我新發現的肌肉群。我把它們命名為$BER肌。
$LINE_SIDEQUEST_5_GET_120_CHAR	$KNI
$LINE_SIDEQUEST_5_GET_120_TEXT	不，你這個白癡！我是說那邊。有人在跟蹤我們。
$LINE_SIDEQUEST_5_GET_130_CHAR	$BER
$LINE_SIDEQUEST_5_GET_130_TEXT	他們一定是難以抗拒我那粗獷男子氣概所散發出來的誘惑力，而被吸引過來的。
$LINE_SIDEQUEST_5_GET_140_CHAR	$KNI
$LINE_SIDEQUEST_5_GET_140_TEXT	或者他們是敵人的間諜。呆在這裡，我去查看一下。
$LINE_SIDEQUEST_5_GET_150_CHAR	$BER
$LINE_SIDEQUEST_5_GET_150_TEXT	什麼？沒有我你怎麼殺人！等等！
$SCENE_SIDEQUEST_5_INTRO_TITLE	消失在黑暗中
$LINE_SIDEQUEST_5_INTRO_00_CHAR	$KNI
$LINE_SIDEQUEST_5_INTRO_00_TEXT	誰在那兒？！亮明你的身份！
$LINE_SIDEQUEST_5_INTRO_10_CHAR	神秘女子
$LINE_SIDEQUEST_5_INTRO_10_TEXT	消失！
$LINE_SIDEQUEST_5_INTRO_20_CHAR	$KNI
$LINE_SIDEQUEST_5_INTRO_20_TEXT	這是什麼？
$LINE_SIDEQUEST_5_INTRO_30_CHAR	神秘女子
$LINE_SIDEQUEST_5_INTRO_30_TEXT	你在這裡做什麼？
$LINE_SIDEQUEST_5_INTRO_40_CHAR	$KNI
$LINE_SIDEQUEST_5_INTRO_40_TEXT	你到底是誰？
$LINE_SIDEQUEST_5_INTRO_50_CHAR	神秘女子
$LINE_SIDEQUEST_5_INTRO_50_TEXT	……我一定是不小心拉上了你。但是這就意味著……
$LINE_SIDEQUEST_5_INTRO_60_CHAR	$BER
$LINE_SIDEQUEST_5_INTRO_60_TEXT	喲。
$LINE_SIDEQUEST_5_INTRO_70_CHAR	$KNI
$LINE_SIDEQUEST_5_INTRO_70_TEXT	太棒了。你還想帶那個傻瓜過來嗎？
$LINE_SIDEQUEST_5_INTRO_80_CHAR	$BER
$LINE_SIDEQUEST_5_INTRO_80_TEXT	外面那些數不清的亡者大軍怎麼辦？
$LINE_SIDEQUEST_5_INTRO_90_CHAR	神秘女子
$LINE_SIDEQUEST_5_INTRO_90_TEXT	什麼？
$LINE_SIDEQUEST_5_INTRO_100_CHAR	神秘女子
$LINE_SIDEQUEST_5_INTRO_100_TEXT	我要怎麼結束這一切？不不不！還太早了！
$LINE_SIDEQUEST_5_INTRO_110_CHAR	神秘女子
$LINE_SIDEQUEST_5_INTRO_110_TEXT	我們必須趕緊逃走！
$LINE_SIDEQUEST_5_INTRO_120_CHAR	$KNI
$LINE_SIDEQUEST_5_INTRO_120_TEXT	你這麼想？
$LINE_SIDEQUEST_5_INTRO_130_CHAR	神秘女子
$LINE_SIDEQUEST_5_INTRO_130_TEXT	我們必須再次消失。
$LINE_SIDEQUEST_5_INTRO_140_CHAR	神秘女子
$LINE_SIDEQUEST_5_INTRO_140_TEXT	讓他們離我遠點！
$SCENE_SIDEQUEST_5_OUTRO_TITLE	沉思謎團
$LINE_SIDEQUEST_5_OUTRO_00_CHAR	$KNI
$LINE_SIDEQUEST_5_OUTRO_00_TEXT	好吧，這是最後一個了。現在我們應該得到一些答案了吧。
$LINE_SIDEQUEST_5_OUTRO_10_CHAR	神秘女子
$LINE_SIDEQUEST_5_OUTRO_10_TEXT	就一次——
$LINE_SIDEQUEST_5_OUTRO_20_CHAR	$KNI
$LINE_SIDEQUEST_5_OUTRO_20_TEXT	你到底是誰？你想幹什麼？你是怎麼能穿越——
$LINE_SIDEQUEST_5_OUTRO_30_CHAR	神秘女子
$LINE_SIDEQUEST_5_OUTRO_30_TEXT	消失。
$LINE_SIDEQUEST_5_OUTRO_40_CHAR	$MCG
$LINE_SIDEQUEST_5_OUTRO_40_TEXT	*好吧，我預料到$BER會幹出這些蠢事，但是你，$KNI？你怎麼也這麼傻？
$LINE_SIDEQUEST_5_OUTRO_50_CHAR	$RAN
$LINE_SIDEQUEST_5_OUTRO_50_TEXT	至少現在還有些東西沒有被燒焦。
$LINE_SIDEQUEST_5_OUTRO_60_CHAR	$MCG
$LINE_SIDEQUEST_5_OUTRO_60_TEXT	嘿！只是因為我不會狼吞虎嚥地生吃東西——
$LINE_SIDEQUEST_5_OUTRO_70_CHAR	$RAN
$LINE_SIDEQUEST_5_OUTRO_70_TEXT	*$MCG，你也許對很多事情很擅長，但是你得承認我更擅長。
$LINE_SIDEQUEST_5_OUTRO_80_CHAR	$MCG
$LINE_SIDEQUEST_5_OUTRO_80_TEXT	更擅長被勺子打臉嗎！
$LINE_SIDEQUEST_5_OUTRO_90_CHAR	$KNI
$LINE_SIDEQUEST_5_OUTRO_90_TEXT	有沒有人能在意一下，我現在正站在一鍋湯裡？！！！
$LINE_SIDEQUEST_5_OUTRO_100_CHAR	$RAN
$LINE_SIDEQUEST_5_OUTRO_100_TEXT	唔，當你把它弄成那樣之後……
$LINE_SIDEQUEST_5_OUTRO_110_CHAR	$MCG
$LINE_SIDEQUEST_5_OUTRO_110_TEXT	是啊，你們到底在幹什麼？
$LINE_SIDEQUEST_5_OUTRO_120_CHAR	$RAN
$LINE_SIDEQUEST_5_OUTRO_120_TEXT	也許可以改善一下湯的味道。
$LINE_SIDEQUEST_5_OUTRO_130_CHAR	$MCG
$LINE_SIDEQUEST_5_OUTRO_130_TEXT	需要我來演示一下我這只拿著勺子的手的力量嗎？
$LINE_SIDEQUEST_5_OUTRO_140_CHAR	$BER
$LINE_SIDEQUEST_5_OUTRO_140_TEXT	打起來了！打起來了！
$LINE_SIDEQUEST_5_OUTRO_150_CHAR	$MCG
$LINE_SIDEQUEST_5_OUTRO_150_TEXT	你們到底去哪裡了？
$LINE_SIDEQUEST_5_OUTRO_160_CHAR	$BER
$LINE_SIDEQUEST_5_OUTRO_160_TEXT	*噢，$KNI和我被女巫綁架了，她一直在跟蹤我們，大概是有什麼不可告人的，陰險毒辣的秘密，但是我們還沒來得及審問她，她就逃跑了。
$LINE_SIDEQUEST_5_OUTRO_170_CHAR	$MCG
$LINE_SIDEQUEST_5_OUTRO_170_TEXT	什麼？你們為什麼不告訴我？
$LINE_SIDEQUEST_5_OUTRO_180_CHAR	$BER
$LINE_SIDEQUEST_5_OUTRO_180_TEXT	*很明顯，$KNI忙著站在湯裡，所以沒有時間立刻宣佈這個重大事件。
$LINE_SIDEQUEST_5_OUTRO_190_CHAR	$KNI
$LINE_SIDEQUEST_5_OUTRO_190_TEXT	……
$LINE_SIDEQUEST_5_OUTRO_200_CHAR	$KNI
$LINE_SIDEQUEST_5_OUTRO_200_TEXT	我可以借用一下那把勺子嗎？
$LINE_SIDEQUEST_5_OUTRO_210_CHAR	$MCG
$LINE_SIDEQUEST_5_OUTRO_210_TEXT	所以她像我一樣把你拉進了中途世界？
$LINE_SIDEQUEST_5_OUTRO_220_CHAR	$KNI
$LINE_SIDEQUEST_5_OUTRO_220_TEXT	不止如此。她還能消失，並在另一個地方重新出現。
$LINE_SIDEQUEST_5_OUTRO_230_CHAR	$MCG
$LINE_SIDEQUEST_5_OUTRO_230_TEXT	如果我也有這樣的能力的話，我確信我已經不會在墓坑裡閒逛了。
$LINE_SIDEQUEST_5_OUTRO_240_CHAR	$KNI
$LINE_SIDEQUEST_5_OUTRO_240_TEXT	我覺得她在找什麼東西。當我們在一個奇怪的廢墟裡出現後，她說了些什麼，類似<LQ>還沒到時間<RQ>。
$LINE_SIDEQUEST_5_OUTRO_250_CHAR	$KNI
$LINE_SIDEQUEST_5_OUTRO_250_TEXT	而且，她還帶著什麼東西。
$LINE_SIDEQUEST_5_OUTRO_260_CHAR	$KNI
$LINE_SIDEQUEST_5_OUTRO_260_TEXT	她想在手掌上刻出某種符號。
$LINE_SIDEQUEST_5_OUTRO_270_CHAR	$KNI
$LINE_SIDEQUEST_5_OUTRO_270_TEXT	不知道是什麼意思，但我也沒有時間去仔細查看。
$LINE_SIDEQUEST_5_OUTRO_280_CHAR	$MCG
$LINE_SIDEQUEST_5_OUTRO_280_TEXT	那是什麼？
$LINE_SIDEQUEST_5_OUTRO_290_CHAR	$KNI
$LINE_SIDEQUEST_5_OUTRO_290_TEXT	有點像我之前看到過的諾曼武器。但是和現在部落裡生產出的任何東西相比起來，工藝都要更加精良。
$LINE_SIDEQUEST_5_OUTRO_300_CHAR	$MCG
$LINE_SIDEQUEST_5_OUTRO_300_TEXT	……我曾經在圖書館裡見過這東西的草圖……非常古老……
$LINE_SIDEQUEST_5_OUTRO_310_CHAR	$MCG
$LINE_SIDEQUEST_5_OUTRO_310_TEXT	不管她是誰，她都掌握著大量的知識。
$LINE_SIDEQUEST_5_OUTRO_320_CHAR	$KNI
$LINE_SIDEQUEST_5_OUTRO_320_TEXT	現在開始我們必須保持警惕。
$LINE_SIDEQUEST_5_OUTRO_330_CHAR	$MCG
$LINE_SIDEQUEST_5_OUTRO_330_TEXT	不開玩笑。
$SCENE_3_6_INTRO_TITLE	帥氣的近戰戰士
$LINE_3_6_INTRO_00_CHAR	$BER
$LINE_3_6_INTRO_00_TEXT	嘿，新來的！讓我告訴你這裡的一些基本規矩。
$LINE_3_6_INTRO_10_CHAR	$BER
$LINE_3_6_INTRO_10_TEXT	這裡已經有了一個狂野帥氣的近戰戰士了。
$LINE_3_6_INTRO_20_CHAR	$BER
$LINE_3_6_INTRO_20_TEXT	所以，你為什麼不自己去找一些娘炮的投擲裝備來使用呢，對吧，新來的？
$LINE_3_6_INTRO_30_CHAR	$BER
$LINE_3_6_INTRO_30_TEXT	我們可不想你在前線受傷。你會弄壞你的指甲或者別的什麼的。
$LINE_3_6_INTRO_40_CHAR	$KNI
$LINE_3_6_INTRO_40_TEXT	*我的名字是$KNI，另外，我不喜歡你說話的語氣。
$LINE_3_6_INTRO_50_CHAR	$BER
$LINE_3_6_INTRO_50_TEXT	哦，硬漢？一個躲在盔甲後面的硬漢？
$LINE_3_6_INTRO_60_CHAR	$KNI
$LINE_3_6_INTRO_60_TEXT	這些是軍用裝備，用來——
$LINE_3_6_INTRO_70_CHAR	$BER
$LINE_3_6_INTRO_70_TEXT	……用來讓小女孩不要害怕被擊中的！
$LINE_3_6_INTRO_80_CHAR	$KNI
$LINE_3_6_INTRO_80_TEXT	這不合乎道理。誰想在戰場中被擊中？
$LINE_3_6_INTRO_90_CHAR	$KNI
$LINE_3_6_INTRO_90_TEXT	即使是你，也還在戰場上穿著褲子呢。
$LINE_3_6_INTRO_100_CHAR	$BER
$LINE_3_6_INTRO_100_TEXT	以後再也不會穿了！
$LINE_3_6_INTRO_110_CHAR	$KNI
$LINE_3_6_INTRO_110_TEXT	什麼——？
$LINE_3_6_INTRO_120_CHAR	$MCG
$LINE_3_6_INTRO_120_TEXT	亡者又來了！
$SCENE_3_6_OUTRO_TITLE	不止一人
$LINE_3_6_OUTRO_00_CHAR	$KNI
$LINE_3_6_OUTRO_00_TEXT	這些不是我的人。
$LINE_3_6_OUTRO_10_CHAR	$KNI
$LINE_3_6_OUTRO_10_TEXT	他們一定是從別的地方進城的。
$LINE_3_6_OUTRO_20_CHAR	$HEA
$LINE_3_6_OUTRO_20_TEXT	那就說明我們的秘密入口被人發現了。
$LINE_3_6_OUTRO_30_CHAR	$HEA
$LINE_3_6_OUTRO_30_TEXT	我們必須趕緊離開。
$LINE_3_6_OUTRO_40_CHAR	$HEA
$LINE_3_6_OUTRO_40_TEXT	舍裡米爾的追兵正在逼近。
$SCENE_3_7_INTRO_TITLE	不速之客
$LINE_3_7_INTRO_00_CHAR	$MCG
$LINE_3_7_INTRO_00_TEXT	*$KNI看到亡者倒下的時候似乎非常吃驚。
$LINE_3_7_INTRO_10_CHAR	$HEA
$LINE_3_7_INTRO_10_TEXT	你第一次擊殺它們的時候，我們都很很吃驚。
$LINE_3_7_INTRO_20_CHAR	$MCG
$LINE_3_7_INTRO_20_TEXT	為什麼別人都無法擊殺亡者，但是我可以做到？
$LINE_3_7_INTRO_30_CHAR	$HEA
$LINE_3_7_INTRO_30_TEXT	亡者，正如它們的名字一樣，它們就只是服從舍裡米爾意志的傀儡而已。
$LINE_3_7_INTRO_40_CHAR	$HEA
$LINE_3_7_INTRO_40_TEXT	就算通過奧術力量我仍然無法理解，究竟他是如何通過精神來操控它們的。
$LINE_3_7_INTRO_50_CHAR	$HEA
$LINE_3_7_INTRO_50_TEXT	理論上來說，想要摧毀舍裡米爾對它們的控制是不可能的，就像我無法用劍砍掉你的 意志一樣。
$LINE_3_7_INTRO_60_CHAR	$MCG
$LINE_3_7_INTRO_60_TEXT	但是我做到了！
$LINE_3_7_INTRO_70_CHAR	$HEA
$LINE_3_7_INTRO_70_TEXT	但是你不是在這個世界做到的。你站在死亡的邊緣，處於前往精神世界的半路上。
$LINE_3_7_INTRO_80_CHAR	$HEA
$LINE_3_7_INTRO_80_TEXT	在那裡，你的意志可以斬斷舍裡米爾的意志。
$LINE_3_7_INTRO_90_CHAR	$HEA
$LINE_3_7_INTRO_90_TEXT	所以，那些已經死去的，便可以再死一次……
$LINE_3_7_INTRO_100_CHAR	$MCG
$LINE_3_7_INTRO_100_TEXT	我明白了，所以——
$LINE_3_7_INTRO_110_CHAR	兇惡的龍
$LINE_3_7_INTRO_110_TEXT	什麼人膽敢闖入神的領地？
$LINE_3_7_INTRO_120_CHAR	$HEA
$LINE_3_7_INTRO_120_TEXT	大家快後退！
$LINE_3_7_INTRO_130_CHAR	兇惡的龍
$LINE_3_7_INTRO_130_TEXT	快說，否則我把你們都燒成灰燼！
$LINE_3_7_INTRO_140_CHAR	$HEA
$LINE_3_7_INTRO_140_TEXT	現在不是戰鬥的時候！亡者大軍來了！
$LINE_3_7_INTRO_150_CHAR	兇惡的龍
$LINE_3_7_INTRO_150_TEXT	又是那些蟲子？我要讓它們見識一下聖神的怒火！
$SCENE_3_7_OUTRO_TITLE	龍的諾言
$LINE_3_7_OUTRO_00_CHAR	$DRA
$LINE_3_7_OUTRO_00_TEXT	作為凡人而言，你們打得很不錯。
$LINE_3_7_OUTRO_10_CHAR	$DRA
$LINE_3_7_OUTRO_10_TEXT	但是你們貿然闖入這裡的行為，仍然不可饒恕。
$LINE_3_7_OUTRO_20_CHAR	$DRA
$LINE_3_7_OUTRO_20_TEXT	……
$LINE_3_7_OUTRO_30_CHAR	$DRA
$LINE_3_7_OUTRO_30_TEXT	不過，如果你們能夠替我完成一項特定任務，我也許可以寬恕你們的無禮。
$LINE_3_7_OUTRO_40_CHAR	$MCG
$LINE_3_7_OUTRO_40_TEXT	那作為交換麼？
$LINE_3_7_OUTRO_50_CHAR	$DRA
$LINE_3_7_OUTRO_50_TEXT	我會 留你們一條活路，不把你們烤焦。
$LINE_3_7_OUTRO_60_CHAR	$RAN
$LINE_3_7_OUTRO_60_TEXT	聽起來是一筆不錯的交易。
$LINE_3_7_OUTRO_70_CHAR	$MCG
$LINE_3_7_OUTRO_70_TEXT	我們需要更多的回報。
$LINE_3_7_OUTRO_80_CHAR	$DRA
$LINE_3_7_OUTRO_80_TEXT	你竟敢跟我討教還價？
$LINE_3_7_OUTRO_90_CHAR	$MCG
$LINE_3_7_OUTRO_90_TEXT	帶我們去皇家檔案室，我們會竭盡全力協助你。
$LINE_3_7_OUTRO_100_CHAR	$DRA
$LINE_3_7_OUTRO_100_TEXT	……凡人跟神做交易是很不明智的選擇。
$LINE_3_7_OUTRO_110_CHAR	$DRA
$LINE_3_7_OUTRO_110_TEXT	你很幸運——我現在心情很好。我同意這個安排。我會遵守諾言的。
$LINE_3_7_OUTRO_120_CHAR	$DRA
$LINE_3_7_OUTRO_120_TEXT	現在跟我來。你們有工作要做。
$LINE_3_7_OUTRO_130_CHAR	$RAN
$LINE_3_7_OUTRO_130_TEXT	哇噢，下次你想要激怒一個巨大的噴火怪物時，請先讓我回避一下。
$LINE_3_7_OUTRO_140_CHAR	$MCG
$LINE_3_7_OUTRO_140_TEXT	如果她想要殺了我們的話，我們早就沒命了。她需要我們。
$LINE_3_7_OUTRO_150_CHAR	$MCG
$LINE_3_7_OUTRO_150_TEXT	……如果我們能善加利用這一點，那就更好了。
$LINE_3_7_OUTRO_160_CHAR	$RAN
$LINE_3_7_OUTRO_160_TEXT	好吧，但是，呃……
$LINE_3_7_OUTRO_170_CHAR	$RAN
$LINE_3_7_OUTRO_170_TEXT	下次她在的時候，我還是要避免站在你身邊。
$LINE_3_7_OUTRO_180_CHAR	$MAG
$LINE_3_7_OUTRO_180_TEXT	你和龍做交易？
$LINE_3_7_OUTRO_190_CHAR	$MCG
$LINE_3_7_OUTRO_190_TEXT	我以為你會很激動……極度，呃……狂熱激昂之類的。
$LINE_3_7_OUTRO_200_CHAR	$MCG
$LINE_3_7_OUTRO_200_TEXT	你不是同道中人嗎？
$LINE_3_7_OUTRO_210_CHAR	$MAG
$LINE_3_7_OUTRO_210_TEXT	你沒有聽到她自稱為神嗎？
$LINE_3_7_OUTRO_220_CHAR	$MAG
$LINE_3_7_OUTRO_220_TEXT	這可不是為火焰效忠的那些龍。
$LINE_3_7_OUTRO_230_CHAR	$MAG
$LINE_3_7_OUTRO_230_TEXT	恐怕我們遇到了一條邪惡的龍……它們運用火焰只是為了它們自私的榮耀。
$LINE_3_7_OUTRO_240_CHAR	$MCG
$LINE_3_7_OUTRO_240_TEXT	但是，即使是惡人也能做善事。
$LINE_3_7_OUTRO_250_CHAR	$MAG
$LINE_3_7_OUTRO_250_TEXT	*說得好，$MCG，但是它仍然非常危險。大多數人認為他們擁有的智慧足以將黑暗力量玩弄於鼓掌之間。
$LINE_3_7_OUTRO_260_CHAR	$MAG
$LINE_3_7_OUTRO_260_TEXT	不要讓自大蒙蔽了雙眼。
$LINE_3_7_OUTRO_270_CHAR	$MCG
$LINE_3_7_OUTRO_270_TEXT	*當然，$MAG。我覺得我們……
$LINE_3_7_OUTRO_280_CHAR	$MCG
$LINE_3_7_OUTRO_280_TEXT	……在玩火。
$LINE_3_7_OUTRO_290_CHAR	$MAG
$LINE_3_7_OUTRO_290_TEXT	甚至……不是……呃。
$LINE_3_7_OUTRO_300_CHAR	$MCG
$LINE_3_7_OUTRO_300_TEXT	來吧，會很有趣的。
$LINE_3_7_OUTRO_310_CHAR	$MAG
$LINE_3_7_OUTRO_310_TEXT	……我腦袋疼。
$SCENE_3_8_INTRO_TITLE	保衛巢穴
$LINE_3_8_INTRO_00_CHAR	$MCG
$LINE_3_8_INTRO_00_TEXT	所以，某些龍是值得信任的？
$LINE_3_8_INTRO_10_CHAR	$MAG
$LINE_3_8_INTRO_10_TEXT	起初，所有的龍都效力於火焰的……
$LINE_3_8_INTRO_20_CHAR	$MAG
$LINE_3_8_INTRO_20_TEXT	而且，火焰把他們作為光輝的榜樣，送到全世界人類的面前。
$LINE_3_8_INTRO_30_CHAR	$MAG
$LINE_3_8_INTRO_30_TEXT	但是有一些龍，它們看到了人類的那些閃亮的金銀珠寶後，開始垂涎覬覦。
$LINE_3_8_INTRO_40_CHAR	$MAG
$LINE_3_8_INTRO_40_TEXT	它們不再願意為宇宙之焰效力，而是開始濫用自身的力量來壯大自己。
$LINE_3_8_INTRO_50_CHAR	$MAG
$LINE_3_8_INTRO_50_TEXT	它們不斷地掠奪，不斷的囤積，最終成為了可悲的，毀滅性的生物，反觀它們真實的初衷，簡直是一種諷刺。
$LINE_3_8_INTRO_60_CHAR	$MAG
$LINE_3_8_INTRO_60_TEXT	其他的在這個世界待得太久，都已經忘了是誰，是什麼 原因把它們送來的。
$LINE_3_8_INTRO_70_CHAR	$MAG
$LINE_3_8_INTRO_70_TEXT	它們在這個世界遊蕩，徘徊，但它們還保留一些關於被召喚的記憶，靠著這點殘存的朦朧記憶，它們沒有墮落。
$LINE_3_8_INTRO_80_CHAR	$MAG
$LINE_3_8_INTRO_80_TEXT	最後，最少數、最明智的一部分，忠誠地效力於火神。
$LINE_3_8_INTRO_90_CHAR	$MAG
$LINE_3_8_INTRO_90_TEXT	最好你要見的就是這一部分。
$LINE_3_8_INTRO_100_CHAR	$MAG
$LINE_3_8_INTRO_100_TEXT	那些已經遺忘的，非常危險而且不可預測，但是有時它們也會給予你祝福和財富。
$LINE_3_8_INTRO_110_CHAR	$MAG
$LINE_3_8_INTRO_110_TEXT	那些已經墮落的，只會帶來毀滅。
$LINE_3_8_INTRO_120_CHAR	$MCG
$LINE_3_8_INTRO_120_TEXT	那你認為我們的夥伴是怎樣的？
$LINE_3_8_INTRO_130_CHAR	$MAG
$LINE_3_8_INTRO_130_TEXT	她要麼是墮落的，要麼是遺忘的。看在上帝的份上，我希望——
$LINE_3_8_INTRO_140_CHAR	$DRA
$LINE_3_8_INTRO_140_TEXT	我們到了，人類！
$LINE_3_8_INTRO_150_CHAR	$DRA
$LINE_3_8_INTRO_150_TEXT	現在開始你們的任務吧。
$LINE_3_8_INTRO_160_CHAR	$MCG
$LINE_3_8_INTRO_160_TEXT	這是一個……巢穴？
$LINE_3_8_INTRO_170_CHAR	$DRA
$LINE_3_8_INTRO_170_TEXT	每天晚上，敵人都會來攻擊。
$LINE_3_8_INTRO_180_CHAR	$DRA
$LINE_3_8_INTRO_180_TEXT	我已經擊退了成千上百的敵人，但他們仍然源源不斷的過來。
$LINE_3_8_INTRO_190_CHAR	$DRA
$LINE_3_8_INTRO_190_TEXT	每天早上，我就又有一些孩子失蹤了。
$LINE_3_8_INTRO_200_CHAR	$MCG
$LINE_3_8_INTRO_200_TEXT	為什麼亡者們想要得到龍？
$LINE_3_8_INTRO_210_CHAR	$DRA
$LINE_3_8_INTRO_210_TEXT	現在不是提問的時間，人類。
$LINE_3_8_INTRO_220_CHAR	$MCG
$LINE_3_8_INTRO_220_TEXT	敵人來了！
$LINE_3_8_INTRO_230_CHAR	$DRA
$LINE_3_8_INTRO_230_TEXT	現在是開火的時間。
$SCENE_3_8_OUTRO_TITLE	最後一件事
$NARR_3_8_OUTRO_00_TEXT	第五幕
$NARR_3_8_OUTRO_00_SUB_TEXT	*讓我們狂舞吧，伴著死者的鮮血！$N讓我們高歌吧，讚頌主人的偉大！$N飛濺，噴射，洗滌這個世界，直到他的歸來！
$NARR_3_8_OUTRO_00_SUB_SUB_TEXT	*$N$N$N$N$N——狂血之歌，來自革卡部落生還者的描述
$LINE_3_8_OUTRO_00_CHAR	$MCG
$LINE_3_8_OUTRO_00_TEXT	你的孩子們都安全了，大人。
$LINE_3_8_OUTRO_10_CHAR	$DRA
$LINE_3_8_OUTRO_10_TEXT	你們做的很好，人類。
$LINE_3_8_OUTRO_20_CHAR	$MCG
$LINE_3_8_OUTRO_20_TEXT	我們堅守了我們的諾言。
$LINE_3_8_OUTRO_30_CHAR	$DRA
$LINE_3_8_OUTRO_30_TEXT	是的，是的……當然……
$LINE_3_8_OUTRO_40_CHAR	$DRA
$LINE_3_8_OUTRO_40_TEXT	但是我的孩子們都太餓了，它們沒辦法走到你要找的那個房間。
$LINE_3_8_OUTRO_50_CHAR	$DRA
$LINE_3_8_OUTRO_50_TEXT	我們上一次進食已經是在好幾個月前了……
$LINE_3_8_OUTRO_60_CHAR	$MCG
$LINE_3_8_OUTRO_60_TEXT	我們有什麼可以幫忙的嗎？
$LINE_3_8_OUTRO_70_CHAR	$DRA
$LINE_3_8_OUTRO_70_TEXT	作為一個人類而言，你勇氣可嘉。
$LINE_3_8_OUTRO_80_CHAR	$DRA
$LINE_3_8_OUTRO_80_TEXT	但是……也許吧。
$LINE_3_8_OUTRO_90_CHAR	$DRA
$LINE_3_8_OUTRO_90_TEXT	也許你隊伍中的一兩個成員，可以充當一下犧牲品？
$LINE_3_8_OUTRO_100_CHAR	$DRA
$LINE_3_8_OUTRO_100_TEXT	例如那個長著奇怪眼睛的呆子。
$LINE_3_8_OUTRO_110_CHAR	$DRA
$LINE_3_8_OUTRO_110_TEXT	或者那個眼裡充滿不信任的，怒氣衝衝的沉默女孩。
$LINE_3_8_OUTRO_120_CHAR	$MCG
$LINE_3_8_OUTRO_120_TEXT	或者是別的東西怎麼樣？
$LINE_3_8_OUTRO_130_CHAR	$MCG
$LINE_3_8_OUTRO_130_TEXT	比如，嗯……用羊來代替？？
$LINE_3_8_OUTRO_140_CHAR	$MCG
$LINE_3_8_OUTRO_140_TEXT	上等，美味，多汁的嫩羊肉？
$LINE_3_8_OUTRO_150_CHAR	$DRA
$LINE_3_8_OUTRO_150_TEXT	嗯……
$LINE_3_8_OUTRO_160_CHAR	$DRA
$LINE_3_8_OUTRO_160_TEXT	我想應該夠了。
$LINE_3_8_OUTRO_170_CHAR	$DRA
$LINE_3_8_OUTRO_170_TEXT	但是要儘快！我的耐心就快消磨光了。
$SCENE_3_9_INTRO_TITLE	羊肉
$LINE_3_9_INTRO_00_CHAR	$RAN
$LINE_3_9_INTRO_00_TEXT	羊？你確定？這就是你能想到的最好的辦法嗎？
$LINE_3_9_INTRO_10_CHAR	$MCG
$LINE_3_9_INTRO_10_TEXT	聽著，我已經在盡力想辦法不讓大家被吃掉了，好嗎？
$LINE_3_9_INTRO_20_CHAR	$RAN
$LINE_3_9_INTRO_20_TEXT	那你認為如果我們找不到你承諾的神奇的羊的話，會發生什麼？
$LINE_3_9_INTRO_30_CHAR	$MCG
$LINE_3_9_INTRO_30_TEXT	我只是說了我腦海中蹦出的想法而已。
$LINE_3_9_INTRO_40_CHAR	$RAN
$LINE_3_9_INTRO_40_TEXT	所以你腦海中蹦出的第一個想法是<LQ>羊<RQ>？這裡在你看來像是一片牧場嗎？
$LINE_3_9_INTRO_50_CHAR	$MCG
$LINE_3_9_INTRO_50_TEXT	不，我腦海中蹦出來的第一個想法是<LQ>是啊，吃了那個討厭的，皮包骨的，喋喋不休的黑髮的女孩吧。<RQ>
$LINE_3_9_INTRO_60_CHAR	$RAN
$LINE_3_9_INTRO_60_TEXT	什麼喋喋不休，我？還是我的黑髮？
$LINE_3_9_INTRO_70_CHAR	$MCG
$LINE_3_9_INTRO_70_TEXT	都是！
$LINE_3_9_INTRO_80_CHAR	$RAN
$LINE_3_9_INTRO_80_TEXT	你要知道，我甚至不需要動腦子去想什麼機智的言論來反駁，因為這是與生俱來的——
$LINE_3_9_INTRO_90_CHAR	羊
$LINE_3_9_INTRO_90_TEXT	咩咩呸。
$LINE_3_9_INTRO_100_CHAR	$RAN
$LINE_3_9_INTRO_100_TEXT	……
$LINE_3_9_INTRO_110_CHAR	$RAN
$LINE_3_9_INTRO_110_TEXT	好吧，這只是……
$LINE_3_9_INTRO_120_CHAR	$MAG
$LINE_3_9_INTRO_120_TEXT	*這讓我印象深刻，$MCG。
$LINE_3_9_INTRO_130_CHAR	$MAG
$LINE_3_9_INTRO_130_TEXT	不是很多人知道奎德城市地下的秘密羊圈。
$LINE_3_9_INTRO_140_CHAR	$MAG
$LINE_3_9_INTRO_140_TEXT	通常只有在城市被圍困時，它們才會派上用場，不過就目前情況而言，可以破例一次。
$LINE_3_9_INTRO_150_CHAR	$MAG
$LINE_3_9_INTRO_150_TEXT	我只希望它們沒有……過於野性化。
$LINE_3_9_INTRO_160_CHAR	$MCG
$LINE_3_9_INTRO_160_TEXT	野性化？
$LINE_3_9_INTRO_170_CHAR	$MAG
$LINE_3_9_INTRO_170_TEXT	因為城市被廢棄已久，它們除了洞穴菇和同類，沒別的東西可吃。
$LINE_3_9_INTRO_180_CHAR	$MAG
$LINE_3_9_INTRO_180_TEXT	它們變得……異常兇殘。
$LINE_3_9_INTRO_190_CHAR	$MCG
$LINE_3_9_INTRO_190_TEXT	我由衷地希望，有一天，我能不用再和那些對我生命構成威脅的生物打交道。
$LINE_3_9_INTRO_200_CHAR	$MAG
$LINE_3_9_INTRO_200_TEXT	從它們的表情來看，今天應該不是你說的那一天。
$SCENE_3_9_OUTRO_TITLE	吃飽喝足
$LINE_3_9_OUTRO_00_CHAR	$DRA
$LINE_3_9_OUTRO_00_TEXT	我的孩子們享用了美食，體力已經恢復了。
$LINE_3_9_OUTRO_10_CHAR	$MCG
$LINE_3_9_OUTRO_10_TEXT	*我們已經兌現了我們的承諾了，$DRA。
$LINE_3_9_OUTRO_20_CHAR	$DRA
$LINE_3_9_OUTRO_20_TEXT	很好，我會帶你們去皇家檔案室，不過我有最後一個規矩。
$LINE_3_9_OUTRO_30_CHAR	$DRA
$LINE_3_9_OUTRO_30_TEXT	當你們完成要做的事之後，必須帶我們一起離開墓坑。
$LINE_3_9_OUTRO_40_CHAR	$MCG
$LINE_3_9_OUTRO_40_TEXT	你有翅膀，你不能直接飛出去嗎？
$LINE_3_9_OUTRO_50_CHAR	$DRA
$LINE_3_9_OUTRO_50_TEXT	你的問題太多了，人類。
$LINE_3_9_OUTRO_60_CHAR	$DRA
$LINE_3_9_OUTRO_60_TEXT	就算是像你這樣有用的人，也會因為冒犯而被我燒死的。
$LINE_3_9_OUTRO_70_CHAR	$MCG
$LINE_3_9_OUTRO_70_TEXT	好吧，我們樂意帶你們一起走。
$LINE_3_9_OUTRO_80_CHAR	$DRA
$LINE_3_9_OUTRO_80_TEXT	你本該如此。
$LINE_3_9_OUTRO_90_CHAR	$MCG
$LINE_3_9_OUTRO_90_TEXT	但是你們都必須像其他人一樣共同戰鬥。
$LINE_3_9_OUTRO_100_CHAR	$DRA
$LINE_3_9_OUTRO_100_TEXT	……
$LINE_3_9_OUTRO_110_CHAR	$DRA
$LINE_3_9_OUTRO_110_TEXT	你在討價還價，人類。
$LINE_3_9_OUTRO_120_CHAR	$DRA
$LINE_3_9_OUTRO_120_TEXT	……你的大膽讓我覺得很有趣。
$LINE_3_9_OUTRO_130_CHAR	$DRA
$LINE_3_9_OUTRO_130_TEXT	只要孩子們的勞動都有補償，那我們會給你的敵人送上烈焰的。
$SCENE_DRAGON_LAIR_INTRO_TITLE	龍之寶庫
$LINE_DRAGON_LAIR_INTRO_00_CHAR	$DRA
$LINE_DRAGON_LAIR_INTRO_00_TEXT	這些年來，我們收藏了很多人類的武器和鎧甲在我們的寶庫裡。
$LINE_DRAGON_LAIR_INTRO_10_CHAR	$DRA
$LINE_DRAGON_LAIR_INTRO_10_TEXT	這些東西對我們而言沒有用處，但是它們……閃閃發光，我們喜歡閃亮的東西。
$LINE_DRAGON_LAIR_INTRO_20_CHAR	$DRA
$LINE_DRAGON_LAIR_INTRO_20_TEXT	我相信，向你們這樣的戰隊應該可以好好利用這些東西。
$LINE_DRAGON_LAIR_INTRO_30_CHAR	$DRA
$LINE_DRAGON_LAIR_INTRO_30_TEXT	當然得有個合適的價格……
$LINE_DRAGON_LAIR_INTRO_40_CHAR	$BER
$LINE_DRAGON_LAIR_INTRO_40_TEXT	夥計，羊肉燉湯就非常棒！
$LINE_DRAGON_LAIR_INTRO_50_CHAR	$DRA
$LINE_DRAGON_LAIR_INTRO_50_TEXT	我已經把那些燉湯反哺給孩子們了。
$LINE_DRAGON_LAIR_INTRO_60_CHAR	$BER
$LINE_DRAGON_LAIR_INTRO_60_TEXT	……
$LINE_DRAGON_LAIR_INTRO_70_CHAR	$DRA
$LINE_DRAGON_LAIR_INTRO_70_TEXT	……
$LINE_DRAGON_LAIR_INTRO_80_CHAR	$BER
$LINE_DRAGON_LAIR_INTRO_80_TEXT	還有嗎？
$SCENE_DRAGON_LAIR_OUTRO_TITLE	漫長的故事
$LINE_DRAGON_LAIR_OUTRO_00_CHAR	$MCG
$LINE_DRAGON_LAIR_OUTRO_00_TEXT	我們現在就走……
$LINE_DRAGON_LAIR_OUTRO_10_CHAR	$MCG
$LINE_DRAGON_LAIR_OUTRO_10_TEXT	*長老$HEA？
$LINE_DRAGON_LAIR_OUTRO_20_CHAR	$HEA
$LINE_DRAGON_LAIR_OUTRO_20_TEXT	摧毀世界，真的是一件極其簡單的事情。
$LINE_DRAGON_LAIR_OUTRO_30_CHAR	$HEA
$LINE_DRAGON_LAIR_OUTRO_30_TEXT	舍裡米爾把我帶了出來——帶到遙遠的東部沙漠，最後帶進一個黑暗洞穴中。
$LINE_DRAGON_LAIR_OUTRO_40_CHAR	$HEA
$LINE_DRAGON_LAIR_OUTRO_40_TEXT	我們來到一個三十尺高的水晶前。
$LINE_DRAGON_LAIR_OUTRO_50_CHAR	$HEA
$LINE_DRAGON_LAIR_OUTRO_50_TEXT	然後，我們讓自己的鮮血流淌到石頭上。
$LINE_DRAGON_LAIR_OUTRO_60_CHAR	$HEA
$LINE_DRAGON_LAIR_OUTRO_60_TEXT	傷口無法癒合。
$LINE_DRAGON_LAIR_OUTRO_70_CHAR	$HEA
$LINE_DRAGON_LAIR_OUTRO_70_TEXT	一開始，我以為什麼都沒有發生。
$LINE_DRAGON_LAIR_OUTRO_80_CHAR	$HEA
$LINE_DRAGON_LAIR_OUTRO_80_TEXT	但是舍裡米爾……他進入了一種恍惚出神的狀態。我只好等著。
$LINE_DRAGON_LAIR_OUTRO_90_CHAR	$HEA
$LINE_DRAGON_LAIR_OUTRO_90_TEXT	太陽下山了，我能聽見周圍那些沙漠野獸的吼叫聲。但是，舍裡米爾仍然紋絲不動。
$LINE_DRAGON_LAIR_OUTRO_100_CHAR	$HEA
$LINE_DRAGON_LAIR_OUTRO_100_TEXT	接著一頭巨狼突然跳進我們的帳篷，他仍然沒有任何反應……
$LINE_DRAGON_LAIR_OUTRO_110_CHAR	$HEA
$LINE_DRAGON_LAIR_OUTRO_110_TEXT	我用劍刺穿了它，然後它就在舍裡米爾的腳邊，抽搐著咽下最後一口氣。
$LINE_DRAGON_LAIR_OUTRO_120_CHAR	$HEA
$LINE_DRAGON_LAIR_OUTRO_120_TEXT	即使這樣，他都沒有注意到。我們就這樣度過了三個晚上。
$LINE_DRAGON_LAIR_OUTRO_130_CHAR	$HEA
$LINE_DRAGON_LAIR_OUTRO_130_TEXT	在第三天的黎明，他眨了三次眼睛，然後站了起來。
$LINE_DRAGON_LAIR_OUTRO_140_CHAR	$HEA
$LINE_DRAGON_LAIR_OUTRO_140_TEXT	<LQ>我們的問題解決了，<RQ>他說道。
$LINE_DRAGON_LAIR_OUTRO_150_CHAR	$HEA
$LINE_DRAGON_LAIR_OUTRO_150_TEXT	當我們回到營地時，敵人已經潰不成軍。
$LINE_DRAGON_LAIR_OUTRO_160_CHAR	$HEA
$LINE_DRAGON_LAIR_OUTRO_160_TEXT	瘟疫開始爆發。
$LINE_DRAGON_LAIR_OUTRO_170_CHAR	$HEA
$LINE_DRAGON_LAIR_OUTRO_170_TEXT	每天，他……出神的時間越來越久，靈魂出竅去了別的地方。
$LINE_DRAGON_LAIR_OUTRO_180_CHAR	$HEA
$LINE_DRAGON_LAIR_OUTRO_180_TEXT	一個月內，奎德帝國的一半人口，要麼死了，要麼瀕臨死亡，或者更糟。
$LINE_DRAGON_LAIR_OUTRO_190_CHAR	$HEA
$LINE_DRAGON_LAIR_OUTRO_190_TEXT	焚燒屍體的火焰把地平線都染紅了……城市崩分離析。我看到了戰爭中都無法目睹的景象。
$LINE_DRAGON_LAIR_OUTRO_200_CHAR	$HEA
$LINE_DRAGON_LAIR_OUTRO_200_TEXT	我知道這必須停止了。
$LINE_DRAGON_LAIR_OUTRO_210_CHAR	$HEA
$LINE_DRAGON_LAIR_OUTRO_210_TEXT	但是舍裡米爾——他聽不見我說話……
$LINE_DRAGON_LAIR_OUTRO_220_CHAR	$HEA
$LINE_DRAGON_LAIR_OUTRO_220_TEXT	每天他出神的時間越來越長，直到最後，他完全不再回神。
$LINE_DRAGON_LAIR_OUTRO_230_CHAR	$HEA
$LINE_DRAGON_LAIR_OUTRO_230_TEXT	我等了三天。每天都有上千人死去。
$LINE_DRAGON_LAIR_OUTRO_240_CHAR	$HEA
$LINE_DRAGON_LAIR_OUTRO_240_TEXT	最後，在一個清晨，我走進了他的帳篷。
$LINE_DRAGON_LAIR_OUTRO_250_CHAR	$HEA
$LINE_DRAGON_LAIR_OUTRO_250_TEXT	他沒有注意到我……他已經不能注意到任何事情。
$LINE_DRAGON_LAIR_OUTRO_260_CHAR	$HEA
$LINE_DRAGON_LAIR_OUTRO_260_TEXT	我拔劍刺穿了他。
$LINE_DRAGON_LAIR_OUTRO_270_CHAR	$HEA
$LINE_DRAGON_LAIR_OUTRO_270_TEXT	我把他埋在了沙漠裡。
$LINE_DRAGON_LAIR_OUTRO_280_CHAR	$HEA
$LINE_DRAGON_LAIR_OUTRO_280_TEXT	但是瘟疫還在繼續蔓延，越過了邊境，毀滅了路上的一切。
$LINE_DRAGON_LAIR_OUTRO_290_CHAR	$HEA
$LINE_DRAGON_LAIR_OUTRO_290_TEXT	在回家的長途跋涉中，我遇到了一群瑟連裡僧侶。
$LINE_DRAGON_LAIR_OUTRO_300_CHAR	$HEA
$LINE_DRAGON_LAIR_OUTRO_300_TEXT	我扔掉了我的劍，跪倒在他們腳下。從此之後，成為了一名僧侶。
$LINE_DRAGON_LAIR_OUTRO_310_CHAR	$HEA
$LINE_DRAGON_LAIR_OUTRO_310_TEXT	但是現在，我曾經殺掉的這位朋友已經變成了怪獸，並且捲土重來。
$LINE_DRAGON_LAIR_OUTRO_320_CHAR	$HEA
$LINE_DRAGON_LAIR_OUTRO_320_TEXT	*這就是我們要對抗的黑魔法，$MCG。
$LINE_DRAGON_LAIR_OUTRO_330_CHAR	$HEA
$LINE_DRAGON_LAIR_OUTRO_330_TEXT	我虔心祈禱，這些記錄資料中有解決這場災難的答案。
$LINE_DRAGON_LAIR_OUTRO_340_CHAR	$MCG
$LINE_DRAGON_LAIR_OUTRO_340_TEXT	我們也是如此，長老。
$SCENE_SIDEQUEST_6_GET_TITLE	墮落神廟
$LINE_SIDEQUEST_6_GET_00_CHAR	$KNI
$LINE_SIDEQUEST_6_GET_00_TEXT	*$MCG？
$LINE_SIDEQUEST_6_GET_10_CHAR	$MCG
$LINE_SIDEQUEST_6_GET_10_TEXT	嘿，你終於搞定了名字這件基礎的事情了。
$LINE_SIDEQUEST_6_GET_20_CHAR	$KNI
$LINE_SIDEQUEST_6_GET_20_TEXT	我無意要評判你對盟友的選擇，但是你那，咆哮的，精神變態的仇敵公主是要把我們都殺了。
$LINE_SIDEQUEST_6_GET_30_CHAR	$MCG
$LINE_SIDEQUEST_6_GET_30_TEXT	*$MAG真的沒有那麼壞，只要你別管那些殺人狂的那部分。
$LINE_SIDEQUEST_6_GET_40_CHAR	$KNI
$LINE_SIDEQUEST_6_GET_40_TEXT	恐怕她只有<LQ>殺人狂<RQ>的那部分。
$LINE_SIDEQUEST_6_GET_50_CHAR	$MCG
$LINE_SIDEQUEST_6_GET_50_TEXT	你應該試著找個時間和她聊聊。
$LINE_SIDEQUEST_6_GET_60_CHAR	$KNI
$LINE_SIDEQUEST_6_GET_60_TEXT	是啊，一個曾經的守衛和一個曾經的犯人應該可以成為好朋友的。
$LINE_SIDEQUEST_6_GET_70_CHAR	$KNI
$LINE_SIDEQUEST_6_GET_70_TEXT	然後，借助友誼的力量，我們可以坐上彩虹，逃出墓坑。
$LINE_SIDEQUEST_6_GET_80_CHAR	$MCG
$LINE_SIDEQUEST_6_GET_80_TEXT	你究竟想說什麼？
$LINE_SIDEQUEST_6_GET_90_CHAR	$KNI
$LINE_SIDEQUEST_6_GET_90_TEXT	好吧，很明顯，這裡有一些被玷污的奎德神廟。
$LINE_SIDEQUEST_6_GET_100_CHAR	$KNI
$LINE_SIDEQUEST_6_GET_100_TEXT	*$MAG發現了這一點，然後變得有點……那個詞怎麼說來著？
$LINE_SIDEQUEST_6_GET_110_CHAR	$KNI
$LINE_SIDEQUEST_6_GET_110_TEXT	你是個圖書管理員——有沒有一個形容詞是說：
$LINE_SIDEQUEST_6_GET_120_CHAR	$KNI
$LINE_SIDEQUEST_6_GET_120_TEXT	<LQ>丟棄了脆弱的一貫正面的偽裝，而表現出了密封在之下的瘋狂的沸騰的內心？<RQ>
$LINE_SIDEQUEST_6_GET_130_CHAR	$BER
$LINE_SIDEQUEST_6_GET_130_TEXT	*$MCG！
$LINE_SIDEQUEST_6_GET_140_CHAR	$MCG
$LINE_SIDEQUEST_6_GET_140_TEXT	什麼？
$LINE_SIDEQUEST_6_GET_150_CHAR	$BER
$LINE_SIDEQUEST_6_GET_150_TEXT	*這不公平！$MAG不願意分享！
$LINE_SIDEQUEST_6_GET_160_CHAR	$MCG
$LINE_SIDEQUEST_6_GET_160_TEXT	你到底在說什麼？
$LINE_SIDEQUEST_6_GET_170_CHAR	$BER
$LINE_SIDEQUEST_6_GET_170_TEXT	*$MAG發現了這個超級酷的古老聖地，那裡有……十億後面的數字是什麼？
$LINE_SIDEQUEST_6_GET_180_CHAR	$MCG
$LINE_SIDEQUEST_6_GET_180_TEXT	十億零一？
$LINE_SIDEQUEST_6_GET_190_CHAR	$BER
$LINE_SIDEQUEST_6_GET_190_TEXT	*是的，那裡有十億零一個亡者在裡面，但是$MAG不讓我們和它們戰鬥！
$LINE_SIDEQUEST_6_GET_200_CHAR	$MCG
$LINE_SIDEQUEST_6_GET_200_TEXT	你有沒有想過，除非真的有必要，我不想再和更多的怪物戰鬥了？
$LINE_SIDEQUEST_6_GET_210_CHAR	$BER
$LINE_SIDEQUEST_6_GET_210_TEXT	……
$LINE_SIDEQUEST_6_GET_220_CHAR	$BER
$LINE_SIDEQUEST_6_GET_220_TEXT	……無法理解……奇怪的……外國邏輯……
$LINE_SIDEQUEST_6_GET_230_CHAR	$BER
$LINE_SIDEQUEST_6_GET_230_TEXT	*不管怎樣，$MAG說這是她的地盤，誰要進去就殺了誰！
$LINE_SIDEQUEST_6_GET_240_CHAR	$BER
$LINE_SIDEQUEST_6_GET_240_TEXT	這不公平！你應該去融掉她的臉！！！
$LINE_SIDEQUEST_6_GET_250_CHAR	$MCG
$LINE_SIDEQUEST_6_GET_250_TEXT	……總是要融掉別人的臉。
$LINE_SIDEQUEST_6_GET_260_CHAR	$KNI
$LINE_SIDEQUEST_6_GET_260_TEXT	看吧，她是在太瘋狂了，她甚至能恐嚇其他的瘋子。
$LINE_SIDEQUEST_6_GET_270_CHAR	$MCG
$LINE_SIDEQUEST_6_GET_270_TEXT	我想我應該去弄清楚真相。
$SCENE_SIDEQUEST_6_INTRO_TITLE	火焰之僕
$LINE_SIDEQUEST_6_INTRO_00_CHAR	$MAG
$LINE_SIDEQUEST_6_INTRO_00_TEXT	我是火焰之女！
$LINE_SIDEQUEST_6_INTRO_10_CHAR	$BER
$LINE_SIDEQUEST_6_INTRO_10_TEXT	*好吧，$MCG說她不在意你是誰，你必須分享！
$LINE_SIDEQUEST_6_INTRO_20_CHAR	$MCG
$LINE_SIDEQUEST_6_INTRO_20_TEXT	這不是我說的。
$LINE_SIDEQUEST_6_INTRO_30_CHAR	$MAG
$LINE_SIDEQUEST_6_INTRO_30_TEXT	我可以一個人把這些討厭的東西趕出去。我淨化這座神廟可不是為了讓其他敵人進去！
$LINE_SIDEQUEST_6_INTRO_40_CHAR	$MCG
$LINE_SIDEQUEST_6_INTRO_40_TEXT	*$MAG，聽我說。你不能一個人去做這些事。
$LINE_SIDEQUEST_6_INTRO_50_CHAR	$MAG
$LINE_SIDEQUEST_6_INTRO_50_TEXT	*我是$MAG·蘭·蘭世彌！我是火焰女祭司！無論是生是死，我都不能容忍敵人進入火焰之屋！
$LINE_SIDEQUEST_6_INTRO_60_CHAR	$MCG
$LINE_SIDEQUEST_6_INTRO_60_TEXT	*$MAG？讓我——
$LINE_SIDEQUEST_6_INTRO_70_CHAR	$MAG
$LINE_SIDEQUEST_6_INTRO_70_TEXT	*$MCG，不要。我會殺了你。我沒有選擇。沒有人能進去神廟拯救真理知者。
$LINE_SIDEQUEST_6_INTRO_80_CHAR	$MAG
$LINE_SIDEQUEST_6_INTRO_80_TEXT	我曾發誓要竭盡全力地維護信仰和榮耀。不要逼我殺死自己的朋友。
$LINE_SIDEQUEST_6_INTRO_90_CHAR	$MCG
$LINE_SIDEQUEST_6_INTRO_90_TEXT	沒有我，你打算怎麼去殺死那些亡者？
$LINE_SIDEQUEST_6_INTRO_100_CHAR	$MAG
$LINE_SIDEQUEST_6_INTRO_100_TEXT	……我會想辦法。
$LINE_SIDEQUEST_6_INTRO_110_CHAR	$MCG
$LINE_SIDEQUEST_6_INTRO_110_TEXT	*你想死嗎？這就是你的想法嗎，$MAG？
$LINE_SIDEQUEST_6_INTRO_120_CHAR	$MAG
$LINE_SIDEQUEST_6_INTRO_120_TEXT	我只想著要為火焰效命！
$LINE_SIDEQUEST_6_INTRO_130_CHAR	$MCG
$LINE_SIDEQUEST_6_INTRO_130_TEXT	噢，所以你打算犧牲自己來為火焰效命嗎？你打算永遠地斬斷奎德的血脈嗎？
$LINE_SIDEQUEST_6_INTRO_140_CHAR	$MCG
$LINE_SIDEQUEST_6_INTRO_140_TEXT	所以你打算站在審判面前，說：
$LINE_SIDEQUEST_6_INTRO_150_CHAR	$MCG
$LINE_SIDEQUEST_6_INTRO_150_TEXT	<LQ>我害怕眼前的任務，並且蔑視你們贈予的工具，所以我選擇死亡。<RQ>
$LINE_SIDEQUEST_6_INTRO_160_CHAR	$MAG
$LINE_SIDEQUEST_6_INTRO_160_TEXT	不！
$LINE_SIDEQUEST_6_INTRO_170_CHAR	$MCG
$LINE_SIDEQUEST_6_INTRO_170_TEXT	真的嗎？因為這就是我看到的。你的墓誌銘會寫著<LQ>沒有勇氣重建她的王國，所以選擇認輸。<RQ>
$LINE_SIDEQUEST_6_INTRO_180_CHAR	$MAG
$LINE_SIDEQUEST_6_INTRO_180_TEXT	不！！！
$LINE_SIDEQUEST_6_INTRO_190_CHAR	$MCG
$LINE_SIDEQUEST_6_INTRO_190_TEXT	那讓我跟你一起。
$LINE_SIDEQUEST_6_INTRO_200_CHAR	$MAG
$LINE_SIDEQUEST_6_INTRO_200_TEXT	但是……
$LINE_SIDEQUEST_6_INTRO_210_CHAR	$MCG
$LINE_SIDEQUEST_6_INTRO_210_TEXT	你如果一個人進去的話，那你能幫助的只有你的敵人。
$LINE_SIDEQUEST_6_INTRO_220_CHAR	$MCG
$LINE_SIDEQUEST_6_INTRO_220_TEXT	你到底站在哪一邊？
$LINE_SIDEQUEST_6_INTRO_230_CHAR	$MAG
$LINE_SIDEQUEST_6_INTRO_230_TEXT	我……永遠為火焰效命……
$LINE_SIDEQUEST_6_INTRO_240_CHAR	$MCG
$LINE_SIDEQUEST_6_INTRO_240_TEXT	那讓我們去淨化神廟吧。
$SCENE_SIDEQUEST_6_OUTRO_TITLE	收集碎片
$LINE_SIDEQUEST_6_OUTRO_00_CHAR	$MAG
$LINE_SIDEQUEST_6_OUTRO_00_TEXT	你竟敢到這裡來？！
$LINE_SIDEQUEST_6_OUTRO_10_CHAR	$DRA
$LINE_SIDEQUEST_6_OUTRO_10_TEXT	我們忘記了嗎，渺小的人類，在這裡到底是誰掌握著火焰的秘密？
$LINE_SIDEQUEST_6_OUTRO_20_CHAR	$MAG
$LINE_SIDEQUEST_6_OUTRO_20_TEXT	你墮落！扭曲！褻瀆神靈！
$LINE_SIDEQUEST_6_OUTRO_30_CHAR	$MCG
$LINE_SIDEQUEST_6_OUTRO_30_TEXT	*$MAG，她幫了我們。
$LINE_SIDEQUEST_6_OUTRO_40_CHAR	$MAG
$LINE_SIDEQUEST_6_OUTRO_40_TEXT	你的呼吸都玷污了這裡。滾出去。
$LINE_SIDEQUEST_6_OUTRO_50_CHAR	$DRA
$LINE_SIDEQUEST_6_OUTRO_50_TEXT	神願意去哪兒就去哪兒。
$LINE_SIDEQUEST_6_OUTRO_60_CHAR	$MAG
$LINE_SIDEQUEST_6_OUTRO_60_TEXT	滾出去！
$LINE_SIDEQUEST_6_OUTRO_70_CHAR	$MCG
$LINE_SIDEQUEST_6_OUTRO_70_TEXT	……
$LINE_SIDEQUEST_6_OUTRO_80_CHAR	$MCG
$LINE_SIDEQUEST_6_OUTRO_80_TEXT	你想談談嗎？
$LINE_SIDEQUEST_6_OUTRO_90_CHAR	$MAG
$LINE_SIDEQUEST_6_OUTRO_90_TEXT	言語無法解決仍何事。
$LINE_SIDEQUEST_6_OUTRO_100_CHAR	$MCG
$LINE_SIDEQUEST_6_OUTRO_100_TEXT	我希望這不是真的，否則我就選錯職業了。
$LINE_SIDEQUEST_6_OUTRO_110_CHAR	$MAG
$LINE_SIDEQUEST_6_OUTRO_110_TEXT	你有選擇？真<LQ>稀奇<RQ>啊。
$LINE_SIDEQUEST_6_OUTRO_120_CHAR	$MAG
$LINE_SIDEQUEST_6_OUTRO_120_TEXT	……我們去的每一個小屋，在屋子裡拿每一樣東西時，我都覺得有其他倖存者在看著我。他們知道我是誰。
$LINE_SIDEQUEST_6_OUTRO_130_CHAR	$MAG
$LINE_SIDEQUEST_6_OUTRO_130_TEXT	他們以為我會帶他們回到我們的城市，回到一個根本不再存在的世界！
$LINE_SIDEQUEST_6_OUTRO_140_CHAR	$MAG
$LINE_SIDEQUEST_6_OUTRO_140_TEXT	這裡，這裡就是我的歸屬地。神廟已經變成了停屍房。
$LINE_SIDEQUEST_6_OUTRO_150_CHAR	$MAG
$LINE_SIDEQUEST_6_OUTRO_150_TEXT	那些可憐的四散的倖存者指望我來拯救他們，但是除了這座神廟廢墟，我無法再為他們提供任何的保護。
$LINE_SIDEQUEST_6_OUTRO_160_CHAR	$MAG
$LINE_SIDEQUEST_6_OUTRO_160_TEXT	看看我！從小就是一個俘虜，一個囚犯，一個……你不明白……他們對我們做的那些事。
$LINE_SIDEQUEST_6_OUTRO_170_CHAR	$MAG
$LINE_SIDEQUEST_6_OUTRO_170_TEXT	不……是你們對我們做的事！
$LINE_SIDEQUEST_6_OUTRO_180_CHAR	$MAG
$LINE_SIDEQUEST_6_OUTRO_180_TEXT	我的腦海裡總是出現尖叫聲，我知道，這些尖叫聲就是他們的，我閉上眼睛，看見我的姐妹們站在血泊中……
$LINE_SIDEQUEST_6_OUTRO_190_CHAR	$MCG
$LINE_SIDEQUEST_6_OUTRO_190_TEXT	*$MAG……
$LINE_SIDEQUEST_6_OUTRO_200_CHAR	$MAG
$LINE_SIDEQUEST_6_OUTRO_200_TEXT	太陽……慢慢的落了下去，我拿起破碎的箭頭，等著他轉過身……
$LINE_SIDEQUEST_6_OUTRO_210_CHAR	$MAG
$LINE_SIDEQUEST_6_OUTRO_210_TEXT	而現在，我孤身一人。他們都不在了……我是皇室最後的血脈……
$LINE_SIDEQUEST_6_OUTRO_220_CHAR	$MAG
$LINE_SIDEQUEST_6_OUTRO_220_TEXT	我甚至無法控制我自己的思緒！我還怎麼能領導一個國家呢？
$LINE_SIDEQUEST_6_OUTRO_230_CHAR	$MAG
$LINE_SIDEQUEST_6_OUTRO_230_TEXT	我能為我的子民做什麼呢？
$LINE_SIDEQUEST_6_OUTRO_240_CHAR	$MCG
$LINE_SIDEQUEST_6_OUTRO_240_TEXT	*$MAG，我是個圖書管理員。你是奎德的戰士公主。
$LINE_SIDEQUEST_6_OUTRO_250_CHAR	$MCG
$LINE_SIDEQUEST_6_OUTRO_250_TEXT	你生來就是領導者。我生來就是……擺放書本，並且被書吏虎視眈眈的盯著。
$LINE_SIDEQUEST_6_OUTRO_260_CHAR	$MCG
$LINE_SIDEQUEST_6_OUTRO_260_TEXT	我很迷茫，也不知道該如何領導……我幾乎無法控制大局了。有時候，我能做的只有記得呼吸。
$LINE_SIDEQUEST_6_OUTRO_270_CHAR	$MCG
$LINE_SIDEQUEST_6_OUTRO_270_TEXT	我自己都不會追隨自己。
$LINE_SIDEQUEST_6_OUTRO_280_CHAR	$MCG
$LINE_SIDEQUEST_6_OUTRO_280_TEXT	我看著你，我總希望自己能有你十分之一的勇氣和決心。
$LINE_SIDEQUEST_6_OUTRO_290_CHAR	$MCG
$LINE_SIDEQUEST_6_OUTRO_290_TEXT	但也許我沒有也是件好事，否則我就在建立一個帝國，而不是忙著逃亡了。
$LINE_SIDEQUEST_6_OUTRO_300_CHAR	$MAG
$LINE_SIDEQUEST_6_OUTRO_300_TEXT	……
$LINE_SIDEQUEST_6_OUTRO_310_CHAR	$MAG
$LINE_SIDEQUEST_6_OUTRO_310_TEXT	*謝謝你，$MCG。
$LINE_SIDEQUEST_6_OUTRO_320_CHAR	$MAG
$LINE_SIDEQUEST_6_OUTRO_320_TEXT	……也許我之前對於言語的認知是錯誤的。
$LINE_SIDEQUEST_6_OUTRO_330_CHAR	$MCG
$LINE_SIDEQUEST_6_OUTRO_330_TEXT	……你想要擁抱一下嗎？
$LINE_SIDEQUEST_6_OUTRO_340_CHAR	$MAG
$LINE_SIDEQUEST_6_OUTRO_340_TEXT	什麼是<LQ>擁抱<RQ>？
$SCENE_3_10_INTRO_TITLE	皇家檔案室
$LINE_3_10_INTRO_00_CHAR	$DRA
$LINE_3_10_INTRO_00_TEXT	我們到了，人類：皇家檔案室。
$LINE_3_10_INTRO_10_CHAR	$MCG
$LINE_3_10_INTRO_10_TEXT	上面說了什麼？
$LINE_3_10_INTRO_20_CHAR	$HEA
$LINE_3_10_INTRO_20_TEXT	現在流血似乎有意義了……這看起來像是某種儀式的封印……
$LINE_3_10_INTRO_30_CHAR	$HEA
$LINE_3_10_INTRO_30_TEXT	後代……血……長子……
$LINE_3_10_INTRO_40_CHAR	$HEA
$LINE_3_10_INTRO_40_TEXT	用先祖的血解除封印。
$LINE_3_10_INTRO_50_CHAR	$HEA
$LINE_3_10_INTRO_50_TEXT	只有創造封印的人的血才能解除這個<LQ>血印<RQ>——
$LINE_3_10_INTRO_60_CHAR	$MCG
$LINE_3_10_INTRO_60_TEXT	但是他們都早已去世了。
$LINE_3_10_INTRO_70_CHAR	$HEA
$LINE_3_10_INTRO_70_TEXT	是的，但是他們的血液依舊流淌在他們的後人體內。<LQ>長子之血<RQ>。
$LINE_3_10_INTRO_80_CHAR	$MCG
$LINE_3_10_INTRO_80_TEXT	但是，他們封印著什麼呢？舍裡米爾獲得的力量？
$LINE_3_10_INTRO_90_CHAR	$HEA
$LINE_3_10_INTRO_90_TEXT	*我不確定，這種語言非常深奧……也許$MAG能更好的破解它……
$LINE_3_10_INTRO_100_CHAR	$MAG
$LINE_3_10_INTRO_100_TEXT	這比我之前見過的所有奎德人都要古老……
$LINE_3_10_INTRO_110_CHAR	$MAG
$LINE_3_10_INTRO_110_TEXT	<LQ>……自由人民的領導者……聯合……充滿巨大爭端或衝突的領土……<RQ>
$LINE_3_10_INTRO_120_CHAR	$MAG
$LINE_3_10_INTRO_120_TEXT	<LQ>偉大的國王衰落<RQ>，——一定是指奎德國王。
$LINE_3_10_INTRO_130_CHAR	$MAG
$LINE_3_10_INTRO_130_TEXT	<LQ>……衰落……但是他的同盟……<RQ>
$LINE_3_10_INTRO_140_CHAR	$MAG
$LINE_3_10_INTRO_140_TEXT	<LQ>邪惡聯結……被犧牲牽制……犧牲阿散蒂王，他的尊貴的韋齊爾，科納特·科紮爾……<RQ>
$LINE_3_10_INTRO_150_CHAR	$MAG
$LINE_3_10_INTRO_150_TEXT	<LQ>還有一個，在呼喚中向前邁進……步兵……<RQ>
$LINE_3_10_INTRO_160_CHAR	$MAG
$LINE_3_10_INTRO_160_TEXT	<LQ>屬於尼菲爾家族的，現在他們是皇室收集的……新主人？<RQ>
$LINE_3_10_INTRO_170_CHAR	$MAG
$LINE_3_10_INTRO_170_TEXT	<LQ>這三個人用鮮血封住了邪惡……<RQ>
$LINE_3_10_INTRO_180_CHAR	$MAG
$LINE_3_10_INTRO_180_TEXT	<LQ>艾斯裡——特諾奇<RQ>
$LINE_3_10_INTRO_190_CHAR	$MCG
$LINE_3_10_INTRO_190_TEXT	艾斯裡—特諾奇？
$LINE_3_10_INTRO_200_CHAR	$MAG
$LINE_3_10_INTRO_200_TEXT	我不明白……這不是奎德語的詞。
$LINE_3_10_INTRO_210_CHAR	$MCG
$LINE_3_10_INTRO_210_TEXT	這不是我熟悉的語言。
$LINE_3_10_INTRO_220_CHAR	$RAN
$LINE_3_10_INTRO_220_TEXT	你剛剛是說<LQ>艾斯裡—特諾奇<RQ>？
$LINE_3_10_INTRO_230_CHAR	$MAG
$LINE_3_10_INTRO_230_TEXT	你知道？
$LINE_3_10_INTRO_240_CHAR	$RAN
$LINE_3_10_INTRO_240_TEXT	是遠東狂血部落信奉的某個神。
$LINE_3_10_INTRO_250_CHAR	$MAG
$LINE_3_10_INTRO_250_TEXT	血飲教？我爺爺統治時期曾花了很長的時間嘗試驅散過他們。
$LINE_3_10_INTRO_260_CHAR	$RAN
$LINE_3_10_INTRO_260_TEXT	哦，他們不喝血，他們只是……用血當塗料。
$LINE_3_10_INTRO_270_CHAR	$BER
$LINE_3_10_INTRO_270_TEXT	好吧，這非常有趣，但亡者好像在這條路上造成了大混亂……
$LINE_3_10_INTRO_280_CHAR	$BER
$LINE_3_10_INTRO_280_TEXT	哦，你什麼也不需要做。你只要在我一個人力挽狂瀾時，好好的在旁邊看著。
$LINE_3_10_INTRO_290_CHAR	$BER
$LINE_3_10_INTRO_290_TEXT	好吧，不是一個人……真理和正義會給我提供些幫助！
$LINE_3_10_INTRO_300_CHAR	$BER
$LINE_3_10_INTRO_300_TEXT	更不用說雷鳴，閃電，屠殺，混亂，勝利和行刑者。
$LINE_3_10_INTRO_310_CHAR	$RAN
$LINE_3_10_INTRO_310_TEXT	……
$LINE_3_10_INTRO_320_CHAR	$BER
$LINE_3_10_INTRO_320_TEXT	那是我的腹肌。
$LINE_3_10_INTRO_330_CHAR	$BER
$LINE_3_10_INTRO_330_TEXT	你說什麼？我的臀部怎麼了？
$LINE_3_10_INTRO_340_CHAR	$RAN
$LINE_3_10_INTRO_340_TEXT	我可沒問。
$LINE_3_10_INTRO_350_CHAR	$BER
$LINE_3_10_INTRO_350_TEXT	別擔心。可汗和卡麗斯不會袖手旁觀的。
$LINE_3_10_INTRO_360_CHAR	$RAN
$LINE_3_10_INTRO_360_TEXT	卡麗斯？你把你的屁股取名叫卡麗斯？
$LINE_3_10_INTRO_370_CHAR	$BER
$LINE_3_10_INTRO_370_TEXT	只是一半屁股而已。
$LINE_3_10_INTRO_380_CHAR	$BER
$LINE_3_10_INTRO_380_TEXT	另外一半怎怎麼樣？是單獨的一塊肌肉嗎？我是說，如果是，我可不會給它取名，但是……我不太清楚……它感覺……
$LINE_3_10_INTRO_390_CHAR	$RAN
$LINE_3_10_INTRO_390_TEXT	噢，孩子！亡者在這兒呢，謝天謝地！
$SCENE_3_10_OUTRO_TITLE	戲劇性暫停
$LINE_3_10_OUTRO_00_CHAR	$MCG
$LINE_3_10_OUTRO_00_TEXT	我想這是最後一個了。
$LINE_3_10_OUTRO_10_CHAR	$HEA
$LINE_3_10_OUTRO_10_TEXT	這個筆記……
$LINE_3_10_OUTRO_20_CHAR	$HEA
$LINE_3_10_OUTRO_20_TEXT	*$MCG，你家人在皇家圖書館工作了多久？
$LINE_3_10_OUTRO_30_CHAR	$MCG
$LINE_3_10_OUTRO_30_TEXT	……我記得我還是個小女孩的時候，我曾去那裡看過我的曾祖父。
$LINE_3_10_OUTRO_40_CHAR	$MCG
$LINE_3_10_OUTRO_40_TEXT	據我所知，我的家族一直在那裡工作。
$LINE_3_10_OUTRO_50_CHAR	$MCG
$LINE_3_10_OUTRO_50_TEXT	從字面上看，我姓氏意思就是“圖書館”
$LINE_3_10_OUTRO_60_CHAR	$HEA
$LINE_3_10_OUTRO_60_TEXT	這裡說的步兵——
$LINE_3_10_OUTRO_70_CHAR	$BER
$LINE_3_10_OUTRO_70_TEXT	喲，看啊！
$LINE_3_10_OUTRO_80_CHAR	$HEA
$LINE_3_10_OUTRO_80_TEXT	墓坑的地圖！……那是——？
$LINE_3_10_OUTRO_90_CHAR	$BER
$LINE_3_10_OUTRO_90_TEXT	嘿，別偷我的雷電定製圖！
$LINE_3_10_OUTRO_100_CHAR	$BER
$LINE_3_10_OUTRO_100_TEXT	正如我所說，在我被無禮地打斷之前。這是墓坑地圖，包括……
$LINE_3_10_OUTRO_110_CHAR	$BER
$LINE_3_10_OUTRO_110_TEXT	……戲劇性暫停……
$LINE_3_10_OUTRO_120_CHAR	$BER
$LINE_3_10_OUTRO_120_TEXT	出口！
$SCENE_3_11_INTRO_TITLE	舍裡米爾出現
$LINE_3_11_INTRO_00_CHAR	$HEA
$LINE_3_11_INTRO_00_TEXT	*$MCG，你沒發現嗎？你是——
$LINE_3_11_INTRO_10_CHAR	舍裡米爾
$LINE_3_11_INTRO_10_TEXT	最後一塊拼圖。
$LINE_3_11_INTRO_20_CHAR	舍裡米爾
$LINE_3_11_INTRO_20_TEXT	步兵的犧牲拯救了世界。皇室家族懷著感激之情，給他的後人們在宮殿裡設立了榮譽席位。
$LINE_3_11_INTRO_30_CHAR	舍裡米爾
$LINE_3_11_INTRO_30_TEXT	而他最後的一位後人就在這裡。
$LINE_3_11_INTRO_40_CHAR	$MCG
$LINE_3_11_INTRO_40_TEXT	我是……封印的最後一部分。
$LINE_3_11_INTRO_50_CHAR	舍裡米爾
$LINE_3_11_INTRO_50_TEXT	血印的其他兩部分已經被破壞了。
$LINE_3_11_INTRO_60_CHAR	$MCG
$LINE_3_11_INTRO_60_TEXT	是的，正是你的傑作。
$LINE_3_11_INTRO_70_CHAR	舍裡米爾
$LINE_3_11_INTRO_70_TEXT	現在，我打算要修整那個錯誤。
$LINE_3_11_INTRO_80_CHAR	舍裡米爾
$LINE_3_11_INTRO_80_TEXT	而你，是他唯一的障礙。
$LINE_3_11_INTRO_90_CHAR	舍裡米爾
$LINE_3_11_INTRO_90_TEXT	這是他雙手被縛所能做到的事情。你根本無法想像如果他完全重獲自由後會發生什麼。
$LINE_3_11_INTRO_100_CHAR	舍裡米爾
$LINE_3_11_INTRO_100_TEXT	他所要的，只是得到你的一小滴血。
$LINE_3_11_INTRO_110_CHAR	$MCG
$LINE_3_11_INTRO_110_TEXT	他？
$LINE_3_11_INTRO_120_CHAR	$MCG
$LINE_3_11_INTRO_120_TEXT	你是說艾斯裡-特諾奇？
$LINE_3_11_INTRO_130_CHAR	舍裡米爾
$LINE_3_11_INTRO_130_TEXT	你還是不明白，是嗎？我們對付的可不是什麼抽象的力量。
$LINE_3_11_INTRO_140_CHAR	舍裡米爾
$LINE_3_11_INTRO_140_TEXT	他是個人類，一個智者，和你或我一樣真實……而且，非常非常得危險。
$LINE_3_11_INTRO_150_CHAR	舍裡米爾
$LINE_3_11_INTRO_150_TEXT	我們——我用部分自由與他交易一小部分力量。
$LINE_3_11_INTRO_160_CHAR	舍裡米爾
$LINE_3_11_INTRO_160_TEXT	他並不滿意他的牢房。他在尋找你。即使現在，他的僕從們仍在蠻荒之地搜尋著你的鮮血。
$LINE_3_11_INTRO_170_CHAR	舍裡米爾
$LINE_3_11_INTRO_170_TEXT	只有一條路是安全的。
$LINE_3_11_INTRO_180_CHAR	舍裡米爾
$LINE_3_11_INTRO_180_TEXT	你必須死。
$LINE_3_11_INTRO_190_CHAR	$MCG
$LINE_3_11_INTRO_190_TEXT	瘋狂總是令人信服……
$LINE_3_11_INTRO_200_CHAR	$MCG
$LINE_3_11_INTRO_200_TEXT	你只是在追求讓自己力量更強大的方法而已。
$LINE_3_11_INTRO_210_CHAR	$MCG
$LINE_3_11_INTRO_210_TEXT	你削弱封印，現在又指揮那些已死之人。
$LINE_3_11_INTRO_220_CHAR	$MCG
$LINE_3_11_INTRO_220_TEXT	現在你想要通過打破整個封印讓自己獲得更大的力量。
$LINE_3_11_INTRO_230_CHAR	舍裡米爾
$LINE_3_11_INTRO_230_TEXT	你認為這是我所想的？有什麼根據……不……
$LINE_3_11_INTRO_240_CHAR	舍裡米爾
$LINE_3_11_INTRO_240_TEXT	相信你想要的。你必須死。
$LINE_3_11_INTRO_250_CHAR	舍裡米爾
$LINE_3_11_INTRO_250_TEXT	……兄弟，我希望你能明白。
$LINE_3_11_INTRO_260_CHAR	$HEA
$LINE_3_11_INTRO_260_TEXT	不。
$LINE_3_11_INTRO_270_CHAR	$HEA
$LINE_3_11_INTRO_270_TEXT	我不會再讓你殺害其他無辜之人。
$LINE_3_11_INTRO_280_CHAR	舍裡米爾
$LINE_3_11_INTRO_280_TEXT	世界在燃燒，我不會讓無知之人捆綁住我的雙手！
$LINE_3_11_INTRO_290_CHAR	舍裡米爾
$LINE_3_11_INTRO_290_TEXT	亡者大軍！進攻！
$SCENE_3_11_OUTRO_TITLE	僅僅是開始
$LINE_3_11_OUTRO_00_CHAR	$MCG
$LINE_3_11_OUTRO_00_TEXT	好吧，這比我擔心的要簡單得多了。
$LINE_3_11_OUTRO_10_CHAR	$HEA
$LINE_3_11_OUTRO_10_TEXT	相信我，這僅僅是開始。
$LINE_3_11_OUTRO_20_CHAR	$HEA
$LINE_3_11_OUTRO_20_TEXT	我們不能冒風險開戰。尤其是在舍裡米爾領導軍隊的時候。
$LINE_3_11_OUTRO_30_CHAR	$HEA
$LINE_3_11_OUTRO_30_TEXT	我知道穿過下水道有條逃跑路線。
$LINE_3_11_OUTRO_40_CHAR	$HEA
$LINE_3_11_OUTRO_40_TEXT	在敵人找到機會重組前我們必須離開！
$LINE_3_11_OUTRO_50_CHAR	$MCG
$LINE_3_11_OUTRO_50_TEXT	是啊。下水道。
$LINE_3_11_OUTRO_60_CHAR	$MCG
$LINE_3_11_OUTRO_60_TEXT	你們這些傢伙可能忘了，雖然我們已經有段時間沒有跟文明接觸，但是……
$LINE_3_11_OUTRO_70_CHAR	$MCG
$LINE_3_11_OUTRO_70_TEXT	看吧，事實就是，下水道裡滿是汙物。
$LINE_3_11_OUTRO_80_CHAR	$MCG
$LINE_3_11_OUTRO_80_TEXT	所以，關鍵在於詞語讀音的相似性。
$LINE_3_11_OUTRO_90_CHAR	$MCG
$LINE_3_11_OUTRO_90_TEXT	瘋了，我知道，但是你們可以信任我。我是圖書管理員，成天和語言打交道。
$LINE_3_11_OUTRO_100_CHAR	$MCG
$LINE_3_11_OUTRO_100_TEXT	……通常情況下，我不和逝去的文明打交道。
$LINE_3_11_OUTRO_110_CHAR	$MCG
$LINE_3_11_OUTRO_110_TEXT	我只是想以那樣的方式保存。
$LINE_3_11_OUTRO_120_CHAR	$MCG
$LINE_3_11_OUTRO_120_TEXT	總之，我只是說出來，給那些在聽的人……
$LINE_3_11_OUTRO_130_CHAR	$MCG
$LINE_3_11_OUTRO_130_TEXT	好吧，沒人在聽。
$LINE_3_11_OUTRO_140_CHAR	$MCG
$LINE_3_11_OUTRO_140_TEXT	……
$LINE_3_11_OUTRO_150_CHAR	$MCG
$LINE_3_11_OUTRO_150_TEXT	*沒關係，$MCG，我在聽，而且我百分之百地同意。
$LINE_3_11_OUTRO_160_CHAR	$MCG
$LINE_3_11_OUTRO_160_TEXT	*謝謝，$MCG，真高興還有人能在意我的觀點。
$LINE_3_11_OUTRO_170_CHAR	$MCG
$LINE_3_11_OUTRO_170_TEXT	我們應該彼此照應。我們是這裡唯一理智的人了。
$LINE_3_11_OUTRO_180_CHAR	$MCG
$LINE_3_11_OUTRO_180_TEXT	謝謝，有人能說說話可真好。
$LINE_3_11_OUTRO_190_CHAR	$KNI
$LINE_3_11_OUTRO_190_TEXT	……嗯……呃哼。
$LINE_3_11_OUTRO_200_CHAR	$MCG
$LINE_3_11_OUTRO_200_TEXT	*噢，嗨，$KNI！
$LINE_3_11_OUTRO_210_CHAR	$MCG
$LINE_3_11_OUTRO_210_TEXT	……呃……你在這裡站了多久了？
$LINE_3_11_OUTRO_220_CHAR	$KNI
$LINE_3_11_OUTRO_220_TEXT	……很久了，足以聽到整個……對話。
$LINE_3_11_OUTRO_230_CHAR	$MCG
$LINE_3_11_OUTRO_230_TEXT	哦，我只是……嗯……我……
$LINE_3_11_OUTRO_240_CHAR	$MCG
$LINE_3_11_OUTRO_240_TEXT	我打算餘生都躲在衣櫃裡過了，再見！
$LINE_3_11_OUTRO_250_CHAR	$KNI
$LINE_3_11_OUTRO_250_TEXT	總是跟瘋子在一起。為什麼？為什麼是我？
$LINE_3_11_OUTRO_260_CHAR	$KNI
$LINE_3_11_OUTRO_260_TEXT	下次我一定會說“謝謝你救了我的命！在我發誓永遠地忠誠之前——你不會恰好是那種把褲子穿在頭上的瘋子吧，是嗎？”
$LINE_3_11_OUTRO_270_CHAR	$BER
$LINE_3_11_OUTRO_270_TEXT	嘿！別再自言自語了，怪人！
$SCENE_3_12_INTRO_TITLE	進入逃跑地道
$LINE_3_12_INTRO_00_CHAR	$RAN
$LINE_3_12_INTRO_00_TEXT	逃跑路線在下水道裡？
$LINE_3_12_INTRO_10_CHAR	$RAN
$LINE_3_12_INTRO_10_TEXT	到底是誰設計的這座城市？！
$LINE_3_12_INTRO_20_CHAR	$HEA
$LINE_3_12_INTRO_20_TEXT	路線通向礦井。從那裡我們可以——
$LINE_3_12_INTRO_30_CHAR	舍裡米爾
$LINE_3_12_INTRO_30_TEXT	你真的認為我找不到你？
$LINE_3_12_INTRO_40_CHAR	舍裡米爾
$LINE_3_12_INTRO_40_TEXT	你不是唯一一個知道這座城市秘密的人。
$LINE_3_12_INTRO_50_CHAR	舍裡米爾
$LINE_3_12_INTRO_50_TEXT	而且你應該知道，我會不惜一切地保護我的子民。
$LINE_3_12_INTRO_60_CHAR	$HEA
$LINE_3_12_INTRO_60_TEXT	就像我們解除我們那部分血印的時候一樣嗎，王子殿下？
$LINE_3_12_INTRO_70_CHAR	舍裡米爾
$LINE_3_12_INTRO_70_TEXT	我們瀕臨滅絕。奎德帝國為達目的，會不擇手段的。
$LINE_3_12_INTRO_80_CHAR	舍裡米爾
$LINE_3_12_INTRO_80_TEXT	你已經忘記了東部省份的荒廢了嗎？
$LINE_3_12_INTRO_90_CHAR	舍裡米爾
$LINE_3_12_INTRO_90_TEXT	我跪在子民的血泊之中——我們的子民——我發誓我會不惜一切，拯救艾殊王國！
$LINE_3_12_INTRO_100_CHAR	舍裡米爾
$LINE_3_12_INTRO_100_TEXT	我仍然以此誓言為榮。
$LINE_3_12_INTRO_110_CHAR	$HEA
$LINE_3_12_INTRO_110_TEXT	然後呢？你殺了個女孩。
$LINE_3_12_INTRO_120_CHAR	$HEA
$LINE_3_12_INTRO_120_TEXT	如果這次瘟疫真的是黑暗智者一手造成的，那麼當你毀了它唯一的逃跑之路，它會怎麼做？
$LINE_3_12_INTRO_130_CHAR	$HEA
$LINE_3_12_INTRO_130_TEXT	當他絕望時會發生什麼？
$LINE_3_12_INTRO_140_CHAR	舍裡米爾
$LINE_3_12_INTRO_140_TEXT	計畫正在進行，一切都會在適當的時候解決。
$LINE_3_12_INTRO_150_CHAR	舍裡米爾
$LINE_3_12_INTRO_150_TEXT	但是首先，她必須被除掉。
$SCENE_3_12_OUTRO_TITLE	百萬亡者的哭聲
$LINE_3_12_OUTRO_00_CHAR	$HEA
$LINE_3_12_OUTRO_00_TEXT	它們又被打回來了。我們必須走！
$LINE_3_12_OUTRO_10_CHAR	$MAG
$LINE_3_12_OUTRO_10_TEXT	舍裡米爾。
$LINE_3_12_OUTRO_20_CHAR	$HEA
$LINE_3_12_OUTRO_20_TEXT	他做了自認為必要的選擇。
$LINE_3_12_OUTRO_30_CHAR	$MAG
$LINE_3_12_OUTRO_30_TEXT	他會為此而死。
$LINE_3_12_OUTRO_40_CHAR	$HEA
$LINE_3_12_OUTRO_40_TEXT	*$MAG，復仇從來不是這樣的。
$LINE_3_12_OUTRO_50_CHAR	$MAG
$LINE_3_12_OUTRO_50_TEXT	不是復仇。是正義。是榮譽。
$LINE_3_12_OUTRO_60_CHAR	$MAG
$LINE_3_12_OUTRO_60_TEXT	我不能放任不管這樣的一個帝國的罪犯。
$LINE_3_12_OUTRO_70_CHAR	$MAG
$LINE_3_12_OUTRO_70_TEXT	不取捨裡米爾的鮮血，我無顏再面對宇宙之焰。
$LINE_3_12_OUTRO_80_CHAR	$MAG
$LINE_3_12_OUTRO_80_TEXT	數百萬的生命都在迫切渴求他的鮮血。
$LINE_3_12_OUTRO_90_CHAR	$HEA
$LINE_3_12_OUTRO_90_TEXT	那就為了將來去拯救正義。
$LINE_3_12_OUTRO_100_CHAR	$HEA
$LINE_3_12_OUTRO_100_TEXT	而現在，趁我們還有時間，我們必須逃離這裡！
$LINE_3_12_OUTRO_110_CHAR	$KNI
$LINE_3_12_OUTRO_110_TEXT	女士？
$LINE_3_12_OUTRO_120_CHAR	$MCG
$LINE_3_12_OUTRO_120_TEXT	什麼？
$LINE_3_12_OUTRO_130_CHAR	$KNI
$LINE_3_12_OUTRO_130_TEXT	我們要被敵人包圍了……
$LINE_3_12_OUTRO_140_CHAR	$KNI
$LINE_3_12_OUTRO_140_TEXT	我不知道這對你是否有用……但是應該有所幫助。
$LINE_3_12_OUTRO_150_CHAR	$KNI
$LINE_3_12_OUTRO_150_TEXT	我認識的最聰明的軍人曾經告訴我：
$LINE_3_12_OUTRO_160_CHAR	$KNI
$LINE_3_12_OUTRO_160_TEXT	<LQ>不要使用手臂的力量去攻擊，而要使用精神的力量，然後，身心合一，擊退敵人。<RQ>
$LINE_3_12_OUTRO_170_CHAR	$KNI
$LINE_3_12_OUTRO_170_TEXT	我很多年後才理解。
$LINE_3_12_OUTRO_180_CHAR	$KNI
$LINE_3_12_OUTRO_180_TEXT	我以為他——
$LINE_3_12_OUTRO_190_CHAR	$MCG
$LINE_3_12_OUTRO_190_TEXT	等等……<LQ>精神的力量<RQ>……<LQ>擊退敵人<RQ>……
$LINE_3_12_OUTRO_200_CHAR	$MCG
$LINE_3_12_OUTRO_200_TEXT	我明白了！
$LINE_3_12_OUTRO_210_CHAR	$KNI
$LINE_3_12_OUTRO_210_TEXT	哇哦。那可花了我三年時間。
$LINE_3_12_OUTRO_220_CHAR	$KNI
$LINE_3_12_OUTRO_220_TEXT	我不想撒謊……我現在有點討厭你了。
$SCENE_3_13_INTRO_TITLE	絕望逃亡
$LINE_3_13_INTRO_00_CHAR	$RAN
$LINE_3_13_INTRO_00_TEXT	所以我直說了：逃跑的地道——就是當你遇到危險想逃進去的那地方——全是爆炸物？
$LINE_3_13_INTRO_10_CHAR	$RAN
$LINE_3_13_INTRO_10_TEXT	到底是誰設計的這座城市？！！
$LINE_3_13_INTRO_20_CHAR	$RAN
$LINE_3_13_INTRO_20_TEXT	我是認真的，我要他的地址。我要去找到他，然後狠狠揍他一頓。
$LINE_3_13_INTRO_30_CHAR	$BER
$LINE_3_13_INTRO_30_TEXT	我不知道，我認為這是座了不起的城市。
$LINE_3_13_INTRO_40_CHAR	$RAN
$LINE_3_13_INTRO_40_TEXT	聽著，有一個率領僵屍的滅族瘋子跟在我們屁股後面，並且拼命想要致我們於死地。
$LINE_3_13_INTRO_50_CHAR	$RAN
$LINE_3_13_INTRO_50_TEXT	而我們被爆炸物包圍了！！
$LINE_3_13_INTRO_60_CHAR	$HEA
$LINE_3_13_INTRO_60_TEXT	這也許是我們唯一的出路。
$LINE_3_13_INTRO_70_CHAR	$RAN
$LINE_3_13_INTRO_70_TEXT	我希望你說的是別的方法。
$LINE_3_13_INTRO_80_CHAR	$HEA
$LINE_3_13_INTRO_80_TEXT	如果你們能給爭取我充足時間，我應該能觸發一次貫穿整個礦井的爆炸。
$LINE_3_13_INTRO_90_CHAR	$HEA
$LINE_3_13_INTRO_90_TEXT	在舍裡米爾跟著我們出去之前，地道就會砸在他頭上。
$SCENE_3_13_OUTRO_TITLE	更為強大的敵人
$NARR_3_13_OUTRO_00_TEXT	第六幕
$NARR_3_13_OUTRO_00_SUB_TEXT	*在一個男人心中，光榮和驕傲也有著細微的差別。一個是良好服務後的巨大愉悅，另外一個是奪取榮譽的火焰，致人死亡。
$NARR_3_13_OUTRO_00_SUB_SUB_TEXT	*$N$N$N$N$N——摘自隱士阿拉克蘭的作品集
$LINE_3_13_OUTRO_00_CHAR	$MAG
$LINE_3_13_OUTRO_00_TEXT	他死了。
$LINE_3_13_OUTRO_10_CHAR	$HEA
$LINE_3_13_OUTRO_10_TEXT	是的。
$LINE_3_13_OUTRO_20_CHAR	$HEA
$LINE_3_13_OUTRO_20_TEXT	或者我希望如此。……來自老友為數不多的希望。
$LINE_3_13_OUTRO_30_CHAR	$HEA
$LINE_3_13_OUTRO_30_TEXT	願他找到此生無處尋求的平靜。
$LINE_3_13_OUTRO_40_CHAR	$MAG
$LINE_3_13_OUTRO_40_TEXT	你為那只殺人狗哀悼？和魔鬼有協議的那個？
$LINE_3_13_OUTRO_50_CHAR	$HEA
$LINE_3_13_OUTRO_50_TEXT	他對我而言就像個兄弟，曾經如此，很久以前。
$LINE_3_13_OUTRO_60_CHAR	$MAG
$LINE_3_13_OUTRO_60_TEXT	他現在是個敵人了。
$LINE_3_13_OUTRO_70_CHAR	$MAG
$LINE_3_13_OUTRO_70_TEXT	他是罪有應得。
$LINE_3_13_OUTRO_80_CHAR	$MAG
$LINE_3_13_OUTRO_80_TEXT	我們的對手被摧毀了。
$LINE_3_13_OUTRO_90_CHAR	$MAG
$LINE_3_13_OUTRO_90_TEXT	願他的屍體在邪惡的土地上發黴。
$LINE_3_13_OUTRO_100_CHAR	$HEA
$LINE_3_13_OUTRO_100_TEXT	我們不應該淪落到祈禱虛假的安全感。
$LINE_3_13_OUTRO_110_CHAR	$HEA
$LINE_3_13_OUTRO_110_TEXT	墓坑裡仍有很多危險。沒有必要的話，我們不應該一直等下去。
$LINE_3_13_OUTRO_120_CHAR	$MAG
$LINE_3_13_OUTRO_120_TEXT	有必要暫停我們的勝利喜悅了，但是我們的光榮將是永久。
$LINE_3_13_OUTRO_130_CHAR	$MCG
$LINE_3_13_OUTRO_130_TEXT	你認為他說的是事實麼？如果這樣……
$LINE_3_13_OUTRO_140_CHAR	$HEA
$LINE_3_13_OUTRO_140_TEXT	*$MCG，我們不知道。舍裡米爾……在結束前就失去了思想。
$LINE_3_13_OUTRO_150_CHAR	$MCG
$LINE_3_13_OUTRO_150_TEXT	但如果是真的……那麼我的血就真的可以釋放他。
$LINE_3_13_OUTRO_160_CHAR	$HEA
$LINE_3_13_OUTRO_160_TEXT	你要怎麼做，殺了自己？
$LINE_3_13_OUTRO_170_CHAR	$MCG
$LINE_3_13_OUTRO_170_TEXT	如果這意味著世界上的其他人將得到安全……不這麼做的話就太自私了。
$LINE_3_13_OUTRO_180_CHAR	$HEA
$LINE_3_13_OUTRO_180_TEXT	如果血印是真的，那麼我們唯一想做的，就是把你的血濺到墓坑裡。
$LINE_3_13_OUTRO_190_CHAR	$HEA
$LINE_3_13_OUTRO_190_TEXT	舍裡米爾說僕從們正在找你。
$LINE_3_13_OUTRO_200_CHAR	$HEA
$LINE_3_13_OUTRO_200_TEXT	我認為死亡無法阻止他們搜尋你的血液。
$LINE_3_13_OUTRO_210_CHAR	$MCG
$LINE_3_13_OUTRO_210_TEXT	很好……但是這同樣很自私。
$LINE_3_13_OUTRO_220_CHAR	$HEA
$LINE_3_13_OUTRO_220_TEXT	當你為別人活著時，生命就不再自私。
$LINE_3_13_OUTRO_230_CHAR	$HEA
$LINE_3_13_OUTRO_230_TEXT	沒有你，你的朋友仍會被困在這裡，或者死去。
$LINE_3_13_OUTRO_240_CHAR	$HEA
$LINE_3_13_OUTRO_240_TEXT	他們需要你。我需要你。
$LINE_3_13_OUTRO_250_CHAR	$MCG
$LINE_3_13_OUTRO_250_TEXT	謝謝你，老者。
$LINE_3_13_OUTRO_260_CHAR	$MCG
$LINE_3_13_OUTRO_260_TEXT	……你認為他們說的僕從是什麼意思？
$LINE_3_13_OUTRO_270_CHAR	$HEA
$LINE_3_13_OUTRO_270_TEXT	我不知道……
$LINE_3_13_OUTRO_280_CHAR	$HEA
$LINE_3_13_OUTRO_280_TEXT	……但是我想我們得儘快查明真相。
$SCENE_GHOST_TOWN_INTRO_TITLE	鬼鎮
$LINE_GHOST_TOWN_INTRO_00_CHAR	村民
$LINE_GHOST_TOWN_INTRO_00_TEXT	歡迎來到我們的……村子。
$LINE_GHOST_TOWN_INTRO_10_CHAR	$MCG
$LINE_GHOST_TOWN_INTRO_10_TEXT	大家都去哪兒了？
$LINE_GHOST_TOWN_INTRO_20_CHAR	村民
$LINE_GHOST_TOWN_INTRO_20_TEXT	……死了，或者……被轉化了……
$LINE_GHOST_TOWN_INTRO_30_CHAR	村民
$LINE_GHOST_TOWN_INTRO_30_TEXT	現在，我們還在開採水晶……和往常一樣……
$LINE_GHOST_TOWN_INTRO_40_CHAR	$MCG
$LINE_GHOST_TOWN_INTRO_40_TEXT	那種爆炸水晶？
$LINE_GHOST_TOWN_INTRO_50_CHAR	村民
$LINE_GHOST_TOWN_INTRO_50_TEXT	……帝國的……榮耀就靠……我們了。
$LINE_GHOST_TOWN_INTRO_60_CHAR	村民
$LINE_GHOST_TOWN_INTRO_60_TEXT	……面對……狂血教……我們仍然……在服役。
$SCENE_4_1_INTRO_TITLE	熱烈歡迎
$LINE_4_1_INTRO_00_CHAR	朝聖者
$LINE_4_1_INTRO_00_TEXT	歡迎你們，陌生人，歡迎！
$LINE_4_1_INTRO_10_CHAR	朝聖者
$LINE_4_1_INTRO_10_TEXT	在沙漠裡遇到其他朝聖者總是件好事情。
$LINE_4_1_INTRO_20_CHAR	$MCG
$LINE_4_1_INTRO_20_TEXT	朋友，你要去哪裡？
$LINE_4_1_INTRO_30_CHAR	朝聖者
$LINE_4_1_INTRO_30_TEXT	啊，你是問哪裡在召喚我嗎？
$LINE_4_1_INTRO_40_CHAR	朝聖者
$LINE_4_1_INTRO_40_TEXT	去供奉的……巨石那裡。
$LINE_4_1_INTRO_50_CHAR	$RAN
$LINE_4_1_INTRO_50_TEXT	*$MCG，我們必須離開這裡。現在。
$LINE_4_1_INTRO_60_CHAR	朝聖者
$LINE_4_1_INTRO_60_TEXT	*你說的是$MCG？
$LINE_4_1_INTRO_70_CHAR	朝聖者
$LINE_4_1_INTRO_70_TEXT	我們之前怎麼沒有見過呢？
$LINE_4_1_INTRO_80_CHAR	狂血教徒
$LINE_4_1_INTRO_80_TEXT	她的血……她的血！
$LINE_4_1_INTRO_90_CHAR	狂血教徒
$LINE_4_1_INTRO_90_TEXT	主人的熱誠情填滿我的內心！
$LINE_4_1_INTRO_100_CHAR	狂血教徒
$LINE_4_1_INTRO_100_TEXT	我會謹遵您的意願！<N>為了巨石！
$LINE_4_1_INTRO_101_CHAR	狂血教徒
$LINE_4_1_INTRO_101_TEXT	讓我成為您的部下之一！
$SCENE_4_1_OUTRO_TITLE	強大自身
$LINE_4_1_OUTRO_00_CHAR	$MCG
$LINE_4_1_OUTRO_00_TEXT	那到底是什麼？
$LINE_4_1_OUTRO_10_CHAR	$MCG
$LINE_4_1_OUTRO_10_TEXT	他們剛剛把自己轉化成亡者了嗎？
$LINE_4_1_OUTRO_20_CHAR	$MCG
$LINE_4_1_OUTRO_20_TEXT	而且和之前不同……感覺不一樣……有一種力量在驅動他們。
$LINE_4_1_OUTRO_30_CHAR	$RAN
$LINE_4_1_OUTRO_30_TEXT	我之前見過這些面具……
$LINE_4_1_OUTRO_40_CHAR	$RAN
$LINE_4_1_OUTRO_40_TEXT	塗著血跡，鑲嵌著水晶顆粒……
$LINE_4_1_OUTRO_50_CHAR	$RAN
$LINE_4_1_OUTRO_50_TEXT	他們是狂血邪教徒，來自遠東的咒逐部落。
$LINE_4_1_OUTRO_60_CHAR	$RAN
$LINE_4_1_OUTRO_60_TEXT	*幸虧我們和你在一起， $MCG。
$LINE_4_1_OUTRO_70_CHAR	$RAN
$LINE_4_1_OUTRO_70_TEXT	沒有你，我們就要被獻祭給他們的神了。
$LINE_4_1_OUTRO_80_CHAR	$MCG
$LINE_4_1_OUTRO_80_TEXT	……變成艾斯裡-特諾奇的僕從。
$LINE_4_1_OUTRO_90_CHAR	$MCG
$LINE_4_1_OUTRO_90_TEXT	舍裡米爾說的是真的。
$LINE_4_1_OUTRO_100_CHAR	$RAN
$LINE_4_1_OUTRO_100_TEXT	他們遍佈東部的沙漠……搶劫過路遊客……
$LINE_4_1_OUTRO_110_CHAR	$RAN
$LINE_4_1_OUTRO_110_TEXT	……只是我從來沒有想過會在墓坑裡遇到他們。
$LINE_4_1_OUTRO_120_CHAR	$HEA
$LINE_4_1_OUTRO_120_TEXT	他們在追捕我們。
$LINE_4_1_OUTRO_130_CHAR	$HEA
$LINE_4_1_OUTRO_130_TEXT	我們唯一的選擇就是尋找出口。
$LINE_4_1_OUTRO_140_CHAR	$MCG
$LINE_4_1_OUTRO_140_TEXT	然後呢？
$LINE_4_1_OUTRO_150_CHAR	$HEA
$LINE_4_1_OUTRO_150_TEXT	我們隨後再議。
$LINE_4_1_OUTRO_160_CHAR	$HEA
$LINE_4_1_OUTRO_160_TEXT	現在最重要的事情就是擺脫他們。
$LINE_4_1_OUTRO_170_CHAR	$MCG
$LINE_4_1_OUTRO_170_TEXT	他們到……
$LINE_4_1_OUTRO_180_CHAR	$HEA
$LINE_4_1_OUTRO_180_TEXT	如果這都是真的，那我們就面臨著比舍裡米爾更強大的敵人了。
$LINE_4_1_OUTRO_190_CHAR	$HEA
$LINE_4_1_OUTRO_190_TEXT	強大自身。對手只會越來越強大的。
$SCENE_4_2_INTRO_TITLE	術士領地
$LINE_4_2_INTRO_00_CHAR	$MCG
$LINE_4_2_INTRO_00_TEXT	這是哪裡？另一個奎德城市？
$LINE_4_2_INTRO_10_CHAR	$MAG
$LINE_4_2_INTRO_10_TEXT	不，這和我們的建築完全不同。
$LINE_4_2_INTRO_20_CHAR	$MAG
$LINE_4_2_INTRO_20_TEXT	語言也聽不懂。
$LINE_4_2_INTRO_30_CHAR	$MCG
$LINE_4_2_INTRO_30_TEXT	從未有過的一種……古樸的感覺。
$LINE_4_2_INTRO_40_CHAR	$MCG
$LINE_4_2_INTRO_40_TEXT	為什麼之前沒有人注意到呢？這個地方是對外開放的啊。
$LINE_4_2_INTRO_50_CHAR	$MAG
$LINE_4_2_INTRO_50_TEXT	很多年之前，我來過這裡，這裡是一片沙漠。沒有看到這些遺跡。
$LINE_4_2_INTRO_60_CHAR	$MAG
$LINE_4_2_INTRO_60_TEXT	這些一定被深埋在沙子之下。
$LINE_4_2_INTRO_70_CHAR	$MCG
$LINE_4_2_INTRO_70_TEXT	看這些符號。
$LINE_4_2_INTRO_80_CHAR	$MCG
$LINE_4_2_INTRO_80_TEXT	……你覺得會不會是亡者們把這些挖出來的？
$LINE_4_2_INTRO_90_CHAR	$MAG
$LINE_4_2_INTRO_90_TEXT	小心點！貌似這個陵墓裡還有人。
$SCENE_4_2_OUTRO_TITLE	深入虎穴
$LINE_4_2_OUTRO_00_CHAR	$MCG
$LINE_4_2_OUTRO_00_TEXT	你認識這牆上的銘文嗎？
$LINE_4_2_OUTRO_10_CHAR	$MCG
$LINE_4_2_OUTRO_10_TEXT	也許能讓我們知道自己在哪裡。
$LINE_4_2_OUTRO_20_CHAR	$HEA
$LINE_4_2_OUTRO_20_TEXT	這裡的語言和北方語言很相似，不過是古老得多。
$LINE_4_2_OUTRO_30_CHAR	$HEA
$LINE_4_2_OUTRO_30_TEXT	我可以看懂一些詞……
$LINE_4_2_OUTRO_40_CHAR	$MCG
$LINE_4_2_OUTRO_40_TEXT	說了什麼？
$LINE_4_2_OUTRO_50_CHAR	$HEA
$LINE_4_2_OUTRO_50_TEXT	<LQ>這裡設有……力量之座……<RQ>
$LINE_4_2_OUTRO_60_CHAR	$HEA
$LINE_4_2_OUTRO_60_TEXT	然後有個我不理解的詞語……接下來是……
$LINE_4_2_OUTRO_70_CHAR	$HEA
$LINE_4_2_OUTRO_70_TEXT	<LQ>……來自天堂……<RQ>
$LINE_4_2_OUTRO_80_CHAR	$HEA
$LINE_4_2_OUTRO_80_TEXT	<LQ>艾斯裡-特諾奇<RQ>
$LINE_4_2_OUTRO_90_CHAR	$MCG
$LINE_4_2_OUTRO_90_TEXT	我們在他家裡。
$LINE_4_2_OUTRO_100_CHAR	$HEA
$LINE_4_2_OUTRO_100_TEXT	小心腳下。
$LINE_4_2_OUTRO_110_CHAR	$HEA
$LINE_4_2_OUTRO_110_TEXT	還有一些他的老僕從在這裡。
$SCENE_4_3_INTRO_TITLE	神王之廳
$LINE_4_3_INTRO_00_CHAR	$BER
$LINE_4_3_INTRO_00_TEXT	這裡發生了什麼？
$LINE_4_3_INTRO_10_CHAR	$MCG
$LINE_4_3_INTRO_10_TEXT	這裡似乎曾經是正殿。
$LINE_4_3_INTRO_20_CHAR	$BER
$LINE_4_3_INTRO_20_TEXT	有人把這裡完全搗毀了。
$LINE_4_3_INTRO_30_CHAR	$MCG
$LINE_4_3_INTRO_30_TEXT	然後在牆上雕下了他們的名字……
$LINE_4_3_INTRO_40_CHAR	$BER
$LINE_4_3_INTRO_40_TEXT	王權主義！
$LINE_4_3_INTRO_50_CHAR	$MCG
$LINE_4_3_INTRO_50_TEXT	是用古代艾殊語寫的。
$LINE_4_3_INTRO_60_CHAR	$MCG
$LINE_4_3_INTRO_60_TEXT	<LQ>……這裡眾人……朝聖……<RQ>
$LINE_4_3_INTRO_70_CHAR	$MCG
$LINE_4_3_INTRO_70_TEXT	<LQ>惡魔被打倒，然後被犧牲品封印……<RQ>
$LINE_4_3_INTRO_80_CHAR	$MCG
$LINE_4_3_INTRO_80_TEXT	<LQ>……他的城市被摧毀了<RQ>
$LINE_4_3_INTRO_90_CHAR	$RAN
$LINE_4_3_INTRO_90_TEXT	*$MCG，我們正在被追殺。
$LINE_4_3_INTRO_100_CHAR	$RAN
$LINE_4_3_INTRO_100_TEXT	有多少人還不清楚……
$LINE_4_3_INTRO_110_CHAR	$RAN
$LINE_4_3_INTRO_110_TEXT	但是有好多……非常多。
$LINE_4_3_INTRO_120_CHAR	$MCG
$LINE_4_3_INTRO_120_TEXT	大家做好準備。我們就在這裡迎戰。
$LINE_4_3_INTRO_130_CHAR	狂血邪教徒
$LINE_4_3_INTRO_130_TEXT	你們聽不到召喚嗎？
$LINE_4_3_INTRO_140_CHAR	狂血邪教徒
$LINE_4_3_INTRO_140_TEXT	在這麼多年的沉寂之後。
$LINE_4_3_INTRO_150_CHAR	狂血邪教徒
$LINE_4_3_INTRO_150_TEXT	他召喚我們去巨石那裡。
$LINE_4_3_INTRO_160_CHAR	狂血邪教徒
$LINE_4_3_INTRO_160_TEXT	你們必須解放他。
$LINE_4_3_INTRO_170_CHAR	狂血邪教徒
$LINE_4_3_INTRO_170_TEXT	我們會幫助你們感知到自己的召喚。
$SCENE_4_3_OUTRO_TITLE	說話的聲音
$LINE_4_3_OUTRO_00_CHAR	$MCG
$LINE_4_3_OUTRO_00_TEXT	還有嗎？
$LINE_4_3_OUTRO_10_CHAR	$RAN
$LINE_4_3_OUTRO_10_TEXT	我想我們已經清理乾淨了……至少現在是的。
$LINE_4_3_OUTRO_20_CHAR	$RAN
$LINE_4_3_OUTRO_20_TEXT	我去周圍查看下，確保萬無一失。
$LINE_4_3_OUTRO_30_CHAR	神秘的聲音
$LINE_4_3_OUTRO_30_TEXT	這麼多年了……
$LINE_4_3_OUTRO_40_CHAR	$MCG
$LINE_4_3_OUTRO_40_TEXT	那個聲音！
$LINE_4_3_OUTRO_50_CHAR	艾斯裡-特諾奇
$LINE_4_3_OUTRO_50_TEXT	被囚禁了這麼多年，無人陪伴，只有思想伴隨著自己。
$LINE_4_3_OUTRO_60_CHAR	$MCG
$LINE_4_3_OUTRO_60_TEXT	那個……金人……
$LINE_4_3_OUTRO_61_CHAR	艾斯裡-特諾奇
$LINE_4_3_OUTRO_61_TEXT	被我的女王拋棄
$LINE_4_3_OUTRO_70_CHAR	艾斯裡-特諾奇
$LINE_4_3_OUTRO_70_TEXT	被拋棄……但是現在……你的血脈幫助了我，你的雙手也幫助了我。這是一種二元性……
$LINE_4_3_OUTRO_80_CHAR	艾斯裡-特諾奇
$LINE_4_3_OUTRO_80_TEXT	但是我怎麼能選擇死亡呢？怎麼能……
$LINE_4_3_OUTRO_90_CHAR	艾斯裡-特諾奇
$LINE_4_3_OUTRO_90_TEXT	我不能放棄我的神威！
$LINE_4_3_OUTRO_91_CHAR	艾斯裡-特諾奇
$LINE_4_3_OUTRO_91_TEXT	你會死的！
$LINE_4_3_OUTRO_100_CHAR	$MCG
$LINE_4_3_OUTRO_100_TEXT	離我遠點！
$LINE_4_3_OUTRO_110_CHAR	$MCG
$LINE_4_3_OUTRO_110_TEXT	從我的腦袋裡出來！
$LINE_4_3_OUTRO_120_CHAR	$MCG
$LINE_4_3_OUTRO_120_TEXT	……
$LINE_4_3_OUTRO_130_CHAR	$BER
$LINE_4_3_OUTRO_130_TEXT	*嘿，你還好麼， $MCG？
$LINE_4_3_OUTRO_140_CHAR	$MCG
$LINE_4_3_OUTRO_140_TEXT	我剛剛又看見他了……艾斯裡-特諾奇。
$LINE_4_3_OUTRO_150_CHAR	$MCG
$LINE_4_3_OUTRO_150_TEXT	不大戰一場他是不會放我們走的……
$LINE_4_3_OUTRO_160_CHAR	$MCG
$LINE_4_3_OUTRO_160_TEXT	那我們就滿足他。
$LINE_4_3_OUTRO_170_CHAR	$BER
$LINE_4_3_OUTRO_170_TEXT	……！
$SCENE_TREASURE_CHAMBER_INTRO_TITLE	真愛
$LINE_TREASURE_CHAMBER_INTRO_00_CHAR	$DRA
$LINE_TREASURE_CHAMBER_INTRO_00_TEXT	凡人……附近有什麼東西……
$LINE_TREASURE_CHAMBER_INTRO_10_CHAR	$DRA
$LINE_TREASURE_CHAMBER_INTRO_10_TEXT	我可以聞到。
$LINE_TREASURE_CHAMBER_INTRO_20_CHAR	$MCG
$LINE_TREASURE_CHAMBER_INTRO_20_TEXT	亡者？做好作戰準備！
$LINE_TREASURE_CHAMBER_INTRO_30_CHAR	$DRA
$LINE_TREASURE_CHAMBER_INTRO_30_TEXT	不……是……其他東西……
$LINE_TREASURE_CHAMBER_INTRO_40_CHAR	$MCG
$LINE_TREASURE_CHAMBER_INTRO_40_TEXT	什麼？
$LINE_TREASURE_CHAMBER_INTRO_50_CHAR	$DRA
$LINE_TREASURE_CHAMBER_INTRO_50_TEXT	寶藏！
$LINE_TREASURE_CHAMBER_INTRO_60_CHAR	$BER
$LINE_TREASURE_CHAMBER_INTRO_60_TEXT	哇哦！看看這些！
$LINE_TREASURE_CHAMBER_INTRO_70_CHAR	$DRA
$LINE_TREASURE_CHAMBER_INTRO_70_TEXT	小心點，凡人。
$LINE_TREASURE_CHAMBER_INTRO_80_CHAR	$BER
$LINE_TREASURE_CHAMBER_INTRO_80_TEXT	什麼？
$LINE_TREASURE_CHAMBER_INTRO_90_CHAR	$DRA
$LINE_TREASURE_CHAMBER_INTRO_90_TEXT	作為發現者，這些理應屬於我。
$LINE_TREASURE_CHAMBER_INTRO_100_CHAR	$BER
$LINE_TREASURE_CHAMBER_INTRO_100_TEXT	但是你都不要用武器！
$LINE_TREASURE_CHAMBER_INTRO_110_CHAR	$BER
$LINE_TREASURE_CHAMBER_INTRO_110_TEXT	我們已經綁定了！我叫她：
$LINE_TREASURE_CHAMBER_INTRO_120_CHAR	$BER
$LINE_TREASURE_CHAMBER_INTRO_120_TEXT	超級碎骨機，非凡剜眼者，敵人胃囔切割機，對手去勢器……
$LINE_TREASURE_CHAMBER_INTRO_130_CHAR	$BER
$LINE_TREASURE_CHAMBER_INTRO_130_TEXT	她嘗過成千上萬個人的血！
$LINE_TREASURE_CHAMBER_INTRO_140_CHAR	$BER
$LINE_TREASURE_CHAMBER_INTRO_140_TEXT	或者叫伊夫尼，簡稱。
$LINE_TREASURE_CHAMBER_INTRO_150_CHAR	$BER
$LINE_TREASURE_CHAMBER_INTRO_150_TEXT	你不會插足進來吧，對嗎？我們是……真愛……
$LINE_TREASURE_CHAMBER_INTRO_160_CHAR	$DRA
$LINE_TREASURE_CHAMBER_INTRO_160_TEXT	好吧……價格合適的話，我可以考慮一下。
$SCENE_TREASURE_CHAMBER_OUTRO_TITLE	觸手可及
$LINE_TREASURE_CHAMBER_OUTRO_00_CHAR	$MCG
$LINE_TREASURE_CHAMBER_OUTRO_00_TEXT	從這裡我可以看到山口！我們快出去了！
$LINE_TREASURE_CHAMBER_OUTRO_10_CHAR	$HEA
$LINE_TREASURE_CHAMBER_OUTRO_10_TEXT	*$MCG……我要待在這裡。
$LINE_TREASURE_CHAMBER_OUTRO_20_CHAR	$MCG
$LINE_TREASURE_CHAMBER_OUTRO_20_TEXT	什麼？
$LINE_TREASURE_CHAMBER_OUTRO_30_CHAR	$HEA
$LINE_TREASURE_CHAMBER_OUTRO_30_TEXT	勝利已經觸手可及了。沒有我你也一樣能做到。
$LINE_TREASURE_CHAMBER_OUTRO_40_CHAR	$HEA
$LINE_TREASURE_CHAMBER_OUTRO_40_TEXT	我根本沒有想過活著結束這段旅程。
$LINE_TREASURE_CHAMBER_OUTRO_50_CHAR	$HEA
$LINE_TREASURE_CHAMBER_OUTRO_50_TEXT	這座墮落之城就像個完美的墳墓。
$LINE_TREASURE_CHAMBER_OUTRO_60_CHAR	$MCG
$LINE_TREASURE_CHAMBER_OUTRO_60_TEXT	你答應過我領我出去的。我不允許你現在食言。
$LINE_TREASURE_CHAMBER_OUTRO_70_CHAR	$HEA
$LINE_TREASURE_CHAMBER_OUTRO_70_TEXT	*$MCG，我手上粘上了數百萬人的鮮血。
$LINE_TREASURE_CHAMBER_OUTRO_80_CHAR	$HEA
$LINE_TREASURE_CHAMBER_OUTRO_80_TEXT	舍裡米爾已經付出了代價。
$LINE_TREASURE_CHAMBER_OUTRO_90_CHAR	$HEA
$LINE_TREASURE_CHAMBER_OUTRO_90_TEXT	現在輪到我了。
$LINE_TREASURE_CHAMBER_OUTRO_100_CHAR	$MCG
$LINE_TREASURE_CHAMBER_OUTRO_100_TEXT	我……
$LINE_TREASURE_CHAMBER_OUTRO_110_CHAR	$HEA
$LINE_TREASURE_CHAMBER_OUTRO_110_TEXT	沒什麼可說的了。快走。
$LINE_TREASURE_CHAMBER_OUTRO_120_CHAR	$MCG
$LINE_TREASURE_CHAMBER_OUTRO_120_TEXT	……
$LINE_TREASURE_CHAMBER_OUTRO_130_CHAR	$MAG
$LINE_TREASURE_CHAMBER_OUTRO_130_TEXT	長老……
$LINE_TREASURE_CHAMBER_OUTRO_140_CHAR	$HEA
$LINE_TREASURE_CHAMBER_OUTRO_140_TEXT	*$MAG……你想讓舍裡米爾死。而我和他一樣罪行累累。
$LINE_TREASURE_CHAMBER_OUTRO_150_CHAR	$MAG
$LINE_TREASURE_CHAMBER_OUTRO_150_TEXT	我知道……
$LINE_TREASURE_CHAMBER_OUTRO_160_CHAR	$HEA
$LINE_TREASURE_CHAMBER_OUTRO_160_TEXT	那就讓我去死吧。
$LINE_TREASURE_CHAMBER_OUTRO_170_CHAR	$MAG
$LINE_TREASURE_CHAMBER_OUTRO_170_TEXT	在沒有人願意幫助我的時候，你幫助了我。我……
$LINE_TREASURE_CHAMBER_OUTRO_180_CHAR	$HEA
$LINE_TREASURE_CHAMBER_OUTRO_180_TEXT	*$MAG，我殺了你的人民。
$LINE_TREASURE_CHAMBER_OUTRO_190_CHAR	$HEA
$LINE_TREASURE_CHAMBER_OUTRO_190_TEXT	讓我付出代價吧。
$LINE_TREASURE_CHAMBER_OUTRO_200_CHAR	$MAG
$LINE_TREASURE_CHAMBER_OUTRO_200_TEXT	不。
$LINE_TREASURE_CHAMBER_OUTRO_210_CHAR	$MAG
$LINE_TREASURE_CHAMBER_OUTRO_210_TEXT	不，你不能輕易捨棄你的生命！
$LINE_TREASURE_CHAMBER_OUTRO_220_CHAR	$MAG
$LINE_TREASURE_CHAMBER_OUTRO_220_TEXT	你的命屬於我，你要償還我人民的性命。你沒有自殺這麼奢侈的權利！
$LINE_TREASURE_CHAMBER_OUTRO_230_CHAR	$HEA
$LINE_TREASURE_CHAMBER_OUTRO_230_TEXT	就這樣吧。
$LINE_TREASURE_CHAMBER_OUTRO_240_CHAR	$HEA
$LINE_TREASURE_CHAMBER_OUTRO_240_TEXT	奪走我的性命吧。這樣才對。
$LINE_TREASURE_CHAMBER_OUTRO_250_CHAR	$MAG
$LINE_TREASURE_CHAMBER_OUTRO_250_TEXT	……
$LINE_TREASURE_CHAMBER_OUTRO_260_CHAR	$MAG
$LINE_TREASURE_CHAMBER_OUTRO_260_TEXT	我才是做決定的人，不是你。
$LINE_TREASURE_CHAMBER_OUTRO_270_CHAR	$MAG
$LINE_TREASURE_CHAMBER_OUTRO_270_TEXT	我會自己選擇什麼時候應該結束它。
$LINE_TREASURE_CHAMBER_OUTRO_280_CHAR	$MAG
$LINE_TREASURE_CHAMBER_OUTRO_280_TEXT	現在起來，跟我們走。
$SCENE_4_4_INTRO_TITLE	陷入絕境
$LINE_4_4_INTRO_00_CHAR	$RAN
$LINE_4_4_INTRO_00_TEXT	嘿大夥兒？我想我知道為什麼城裡沒有亡者了。
$LINE_4_4_INTRO_10_CHAR	$RAN
$LINE_4_4_INTRO_10_TEXT	它們都在這裡等著我們。
$LINE_4_4_INTRO_20_CHAR	$MCG
$LINE_4_4_INTRO_20_TEXT	這裡一定有成千上百。
$LINE_4_4_INTRO_30_CHAR	$RAN
$LINE_4_4_INTRO_30_TEXT	是的。
$LINE_4_4_INTRO_40_CHAR	$BER
$LINE_4_4_INTRO_40_TEXT	我從來沒想著會這樣死……
$LINE_4_4_INTRO_50_CHAR	$BER
$LINE_4_4_INTRO_50_TEXT	但是我希望如此！
$LINE_4_4_INTRO_60_CHAR	$BER
$LINE_4_4_INTRO_60_TEXT	鮮血！！
$LINE_4_4_INTRO_70_CHAR	$RAN
$LINE_4_4_INTRO_70_TEXT	好吧……
$LINE_4_4_INTRO_80_CHAR	$MCG
$LINE_4_4_INTRO_80_TEXT	要做的事情並不多了。
$LINE_4_4_INTRO_90_CHAR	$RAN
$LINE_4_4_INTRO_90_TEXT	很高興能認識你。
$LINE_4_4_INTRO_100_CHAR	$DRA
$LINE_4_4_INTRO_100_TEXT	凡人……
$LINE_4_4_INTRO_110_CHAR	$MCG
$LINE_4_4_INTRO_110_TEXT	我想我們的協議不是那麼美好了……
$LINE_4_4_INTRO_120_CHAR	$DRA
$LINE_4_4_INTRO_120_TEXT	我想教你一些事。
$LINE_4_4_INTRO_130_CHAR	$MCG
$LINE_4_4_INTRO_130_TEXT	什麼？
$LINE_4_4_INTRO_140_CHAR	$DRA
$LINE_4_4_INTRO_140_TEXT	在我們的歷史上...還沒有凡人學過這個。
$LINE_4_4_INTRO_150_CHAR	$DRA
$LINE_4_4_INTRO_150_TEXT	我想現在正是時候。
$SCENE_4_4_OUTRO_TITLE	獨自一人
$LINE_4_4_OUTRO_00_CHAR	$RAN
$LINE_4_4_OUTRO_00_TEXT	我不信。
$LINE_4_4_OUTRO_10_CHAR	$MCG
$LINE_4_4_OUTRO_10_TEXT	我們住的地方？
$LINE_4_4_OUTRO_20_CHAR	$RAN
$LINE_4_4_OUTRO_20_TEXT	好吧，那裡也是。
$LINE_4_4_OUTRO_30_CHAR	$RAN
$LINE_4_4_OUTRO_30_TEXT	但是周圍什麼也沒有。
$LINE_4_4_OUTRO_40_CHAR	$RAN
$LINE_4_4_OUTRO_40_TEXT	一個亡者都沒有。
$LINE_4_4_OUTRO_50_CHAR	$RAN
$LINE_4_4_OUTRO_50_TEXT	沒人跟著我們。
$SCENE_4_5_INTRO_TITLE	艾斯裡-特諾奇的右手
$LINE_4_5_INTRO_00_CHAR	$RAN
$LINE_4_5_INTRO_00_TEXT	哦神啊，我從來沒想過會發生這樣的事情。
$LINE_4_5_INTRO_10_CHAR	$RAN
$LINE_4_5_INTRO_10_TEXT	我們在出口了！
$LINE_4_5_INTRO_20_CHAR	$RAN
$LINE_4_5_INTRO_20_TEXT	
$LINE_4_5_INTRO_30_CHAR	$RAN
$LINE_4_5_INTRO_30_TEXT	*$MCG！再也沒有亡者了！
$LINE_4_5_INTRO_40_CHAR	狂血教徒
$LINE_4_5_INTRO_40_TEXT	*啊，這個叫$MCG的確實是最幸運的一個了。
$LINE_4_5_INTRO_50_CHAR	狂血教徒
$LINE_4_5_INTRO_50_TEXT	很少有人能看到艾斯裡-特諾奇伸出榮耀的右手……
$LINE_4_5_INTRO_60_CHAR	狂血教徒
$LINE_4_5_INTRO_60_TEXT	然後取走……
$LINE_4_5_INTRO_70_CHAR	狂血教徒
$LINE_4_5_INTRO_70_TEXT	這個人的性命。
$SCENE_4_5_OUTRO_TITLE	舍裡米爾的代價
$NARR_4_5_OUTRO_00_TEXT	第七幕
$NARR_4_5_OUTRO_00_SUB_TEXT	常言道人都怕死，但根據我的經驗，他們真正懼怕的是死後的未知性。在所有的疼苦中，當死亡是唯一可以想像的結果，我心內感受到前所未有的平靜。$N$N那唯一可以生存的機會$N$N才是我真正懼怕的。
$NARR_4_5_OUTRO_00_SUB_SUB_TEXT	*$N$N$N$N$N$N$N——摘自箭神哥德蒙達拉巴的回憶錄：$N伺奉艾殊王的冒險和探險經歷。
$LINE_4_5_OUTRO_00_CHAR	$MCG
$LINE_4_5_OUTRO_00_TEXT	如果戰鬥是你所想要的——
$LINE_4_5_OUTRO_10_CHAR	舍裡米爾
$LINE_4_5_OUTRO_10_TEXT	我來這裡的唯一原因就是防止你落到敵人的手裡。
$LINE_4_5_OUTRO_20_CHAR	舍裡米爾
$LINE_4_5_OUTRO_20_TEXT	既然確信你已經逃脫了，我沒有理由阻止你。
$LINE_4_5_OUTRO_30_CHAR	舍裡米爾
$LINE_4_5_OUTRO_30_TEXT	事實上，你會成功地分散敵人的注意力。
$LINE_4_5_OUTRO_40_CHAR	$DRA
$LINE_4_5_OUTRO_40_TEXT	你對我的孩子做了什麼，卑鄙的傢伙？
$LINE_4_5_OUTRO_50_CHAR	舍裡米爾
$LINE_4_5_OUTRO_50_TEXT	我給了他更好的安排，防止他變成像你那樣的可憐蟲。
$LINE_4_5_OUTRO_60_CHAR	$DRA
$LINE_4_5_OUTRO_60_TEXT	你殺了我的孩子們！
$LINE_4_5_OUTRO_70_CHAR	舍裡米爾
$LINE_4_5_OUTRO_70_TEXT	他們的犧牲會拯救世界。
$LINE_4_5_OUTRO_80_CHAR	舍裡米爾
$LINE_4_5_OUTRO_80_TEXT	現在，你的孩子還分散在墓坑下面的礦井裡，等待我的指示。
$LINE_4_5_OUTRO_90_CHAR	舍裡米爾
$LINE_4_5_OUTRO_90_TEXT	只要我發出命令，這些亡者就會啟動炸彈。
$LINE_4_5_OUTRO_100_CHAR	舍裡米爾
$LINE_4_5_OUTRO_100_TEXT	墓坑會崩塌……
$LINE_4_5_OUTRO_110_CHAR	舍裡米爾
$LINE_4_5_OUTRO_110_TEXT	一切都將不復存在。
$LINE_4_5_OUTRO_120_CHAR	舍裡米爾
$LINE_4_5_OUTRO_120_TEXT	利用這大量的死亡，我就可以創建一個新的血印。
$LINE_4_5_OUTRO_130_CHAR	舍裡米爾
$LINE_4_5_OUTRO_130_TEXT	一個強大數千倍的血印。
$LINE_4_5_OUTRO_140_CHAR	舍裡米爾
$LINE_4_5_OUTRO_140_TEXT	所有的繼承者都將死去。
$LINE_4_5_OUTRO_150_CHAR	舍裡米爾
$LINE_4_5_OUTRO_150_TEXT	艾斯裡-特諾奇會永遠被困住。
$LINE_4_5_OUTRO_160_CHAR	$DRA
$LINE_4_5_OUTRO_160_TEXT	我要燒死你！
$LINE_4_5_OUTRO_170_CHAR	舍裡米爾
$LINE_4_5_OUTRO_170_TEXT	我不這樣認為。
$LINE_4_5_OUTRO_180_CHAR	舍裡米爾
$LINE_4_5_OUTRO_180_TEXT	要知道，一旦你跟著我，你就會被摧毀。
$LINE_4_5_OUTRO_190_CHAR	舍裡米爾
$LINE_4_5_OUTRO_190_TEXT	*再見了，$MCG。
$LINE_4_5_OUTRO_200_CHAR	舍裡米爾
$LINE_4_5_OUTRO_200_TEXT	很快，一切都會結束。
$LINE_4_5_OUTRO_210_CHAR	$DRA
$LINE_4_5_OUTRO_210_TEXT	這個懦夫跑到了中途世界！
$LINE_4_5_OUTRO_220_CHAR	$DRA
$LINE_4_5_OUTRO_220_TEXT	快點！拉我們過去追上他！
$LINE_4_5_OUTRO_230_CHAR	$RAN
$LINE_4_5_OUTRO_230_TEXT	哇哦，讓我們等一下。
$LINE_4_5_OUTRO_240_CHAR	$RAN
$LINE_4_5_OUTRO_240_TEXT	我是唯一一個記得出口的人嗎？
$LINE_4_5_OUTRO_250_CHAR	$RAN
$LINE_4_5_OUTRO_250_TEXT	你們知道的，讓我們能夠逃離的那個出口？
$LINE_4_5_OUTRO_260_CHAR	$DRA
$LINE_4_5_OUTRO_260_TEXT	沒時間畏畏縮縮了！
$LINE_4_5_OUTRO_270_CHAR	$RAN
$LINE_4_5_OUTRO_270_TEXT	沒時間自殺了！
$LINE_4_5_OUTRO_280_CHAR	$RAN
$LINE_4_5_OUTRO_280_TEXT	*$MCG？
$SCENE_4_6_INTRO_TITLE	出路
$LINE_4_6_INTRO_00_CHAR	$MAG
$LINE_4_6_INTRO_00_TEXT	所以你決定就這麼走了？
$LINE_4_6_INTRO_10_CHAR	$MCG
$LINE_4_6_INTRO_10_TEXT	我別無選擇。
$LINE_4_6_INTRO_20_CHAR	$MAG
$LINE_4_6_INTRO_20_TEXT	我不會眼睜睜地看著我們中的最後一個人犧牲！
$LINE_4_6_INTRO_30_CHAR	$MAG
$LINE_4_6_INTRO_30_TEXT	虧我還把你當作朋友……
$LINE_4_6_INTRO_40_CHAR	$MAG
$LINE_4_6_INTRO_40_TEXT	……終有一天，你會知道，和戰友一起死，比獨自一人苟延殘喘要好得多。
$LINE_4_6_INTRO_50_CHAR	$MAG
$LINE_4_6_INTRO_50_TEXT	願你到時候能感受到教訓的苦澀。
$LINE_4_6_INTRO_60_CHAR	$MCG
$LINE_4_6_INTRO_60_TEXT	……
$LINE_4_6_INTRO_70_CHAR	$HEA
$LINE_4_6_INTRO_70_TEXT	*你做出了最明智的選擇， $MCG。
$LINE_4_6_INTRO_80_CHAR	$MCG
$LINE_4_6_INTRO_80_TEXT	是嗎？
$LINE_4_6_INTRO_90_CHAR	$HEA
$LINE_4_6_INTRO_90_TEXT	你必須走，未來靠你了。
$LINE_4_6_INTRO_100_CHAR	$HEA
$LINE_4_6_INTRO_100_TEXT	我必須和我創造的一切一起死。
$LINE_4_6_INTRO_110_CHAR	$MCG
$LINE_4_6_INTRO_110_TEXT	再見，朋友。
$LINE_4_6_INTRO_120_CHAR	$HEA
$LINE_4_6_INTRO_120_TEXT	瑟連達之路指引著你。
$LINE_4_6_INTRO_130_CHAR	$DRA
$LINE_4_6_INTRO_130_TEXT	我告訴過你火的秘密！
$LINE_4_6_INTRO_140_CHAR	$DRA
$LINE_4_6_INTRO_140_TEXT	你竟然要背叛我們？
$LINE_4_6_INTRO_150_CHAR	$DRA
$LINE_4_6_INTRO_150_TEXT	凡人就是不可靠……
$LINE_4_6_INTRO_160_CHAR	$MCG
$LINE_4_6_INTRO_160_TEXT	*$DRA，世界危在旦夕。
$LINE_4_6_INTRO_170_CHAR	$DRA
$LINE_4_6_INTRO_170_TEXT	我不關心什麼世界！
$LINE_4_6_INTRO_180_CHAR	$DRA
$LINE_4_6_INTRO_180_TEXT	我要為我的孩子報仇。
$LINE_4_6_INTRO_190_CHAR	$DRA
$LINE_4_6_INTRO_190_TEXT	凡人的懦弱.……
$LINE_4_6_INTRO_200_CHAR	$BER
$LINE_4_6_INTRO_200_TEXT	*喲， $MCG！
$LINE_4_6_INTRO_210_CHAR	$MCG
$LINE_4_6_INTRO_210_TEXT	你也在？
$LINE_4_6_INTRO_220_CHAR	$BER
$LINE_4_6_INTRO_220_TEXT	一切都很有趣，但是我剛剛放棄了一個與世界上最恐怖的巫師決鬥的機會。
$LINE_4_6_INTRO_230_CHAR	$BER
$LINE_4_6_INTRO_230_TEXT	我從不當逃兵的。
$LINE_4_6_INTRO_240_CHAR	$MCG
$LINE_4_6_INTRO_240_TEXT	這不是戰鬥，是自殺！
$LINE_4_6_INTRO_250_CHAR	$BER
$LINE_4_6_INTRO_250_TEXT	噢，我不是很瞭解情況。酸甜苦辣我都品嘗過，死而無憾了。
$LINE_4_6_INTRO_260_CHAR	$BER
$LINE_4_6_INTRO_260_TEXT	特別是那段時光，吃的炸水餃竟然不是炸水餃……
$LINE_4_6_INTRO_270_CHAR	$BER
$LINE_4_6_INTRO_270_TEXT	無論如何，只要我能把某人剁成肉醬，別的都無所謂了。
$LINE_4_6_INTRO_280_CHAR	$BER
$LINE_4_6_INTRO_280_TEXT	再見！
$LINE_4_6_INTRO_290_CHAR	$MCG
$LINE_4_6_INTRO_290_TEXT	……再見。
$LINE_4_6_INTRO_300_CHAR	$MCG
$LINE_4_6_INTRO_300_TEXT	……
$LINE_4_6_INTRO_310_CHAR	$MCG
$LINE_4_6_INTRO_310_TEXT	還有人嗎？
$LINE_4_6_INTRO_320_CHAR	$KNI
$LINE_4_6_INTRO_320_TEXT	我被我的債務綁定了。
$LINE_4_6_INTRO_330_CHAR	$KNI
$LINE_4_6_INTRO_330_TEXT	不管你做出什麼選擇，我都會跟隨你。
$LINE_4_6_INTRO_340_CHAR	$MCG
$LINE_4_6_INTRO_340_TEXT	*謝謝你，$KNI。
$LINE_4_6_INTRO_350_CHAR	$MCG
$LINE_4_6_INTRO_350_TEXT	*$RAN？
$LINE_4_6_INTRO_360_CHAR	$RAN
$LINE_4_6_INTRO_360_TEXT	嘿，別看我。我要從這裡出去。
$LINE_4_6_INTRO_370_CHAR	$RAN
$LINE_4_6_INTRO_370_TEXT	我大老遠跑來，不是為了回去被人殺掉的。
$LINE_4_6_INTRO_380_CHAR	$MCG
$LINE_4_6_INTRO_380_TEXT	好吧，那我們最好現在出去。
$LINE_4_6_INTRO_390_CHAR	$RAN
$LINE_4_6_INTRO_390_TEXT	……
$LINE_4_6_INTRO_400_CHAR	$RAN
$LINE_4_6_INTRO_400_TEXT	*嗨， $BER！
$LINE_4_6_INTRO_410_CHAR	$BER
$LINE_4_6_INTRO_410_TEXT	喲。
$LINE_4_6_INTRO_420_CHAR	$RAN
$LINE_4_6_INTRO_420_TEXT	你知道自己要死了，是吧？
$LINE_4_6_INTRO_430_CHAR	$BER
$LINE_4_6_INTRO_430_TEXT	當然。
$LINE_4_6_INTRO_440_CHAR	$RAN
$LINE_4_6_INTRO_440_TEXT	那……這樣你也不再重新考慮一下整件事情嗎？
$LINE_4_6_INTRO_450_CHAR	$BER
$LINE_4_6_INTRO_450_TEXT	*嘿，$RAN，你和我都成功逃生了。
$LINE_4_6_INTRO_460_CHAR	$BER
$LINE_4_6_INTRO_460_TEXT	但是你不可能永遠都這麼幸運。總有一天，你會死去。
$LINE_4_6_INTRO_470_CHAR	$BER
$LINE_4_6_INTRO_470_TEXT	這是個給生命賦予意義的機會。
$LINE_4_6_INTRO_480_CHAR	$RAN
$LINE_4_6_INTRO_480_TEXT	*$BER……
$LINE_4_6_INTRO_490_CHAR	$BER
$LINE_4_6_INTRO_490_TEXT	還有，欠你那些東西我再也不用還了。
$LINE_4_6_INTRO_500_CHAR	$BER
$LINE_4_6_INTRO_500_TEXT	回頭見！
$LINE_4_6_INTRO_510_CHAR	$RAN
$LINE_4_6_INTRO_510_TEXT	……再見……
$LINE_4_6_INTRO_520_CHAR	$MCG
$LINE_4_6_INTRO_520_TEXT	*$RAN？
$LINE_4_6_INTRO_530_CHAR	$RAN
$LINE_4_6_INTRO_530_TEXT	好吧，讓我們出去
$SCENE_ENDING_4_6_OUTRO_TITLE	現在呢？
$LINE_ENDING_4_6_OUTRO_00_CHAR	$MCG
$LINE_ENDING_4_6_OUTRO_00_TEXT	我們出來了。
$LINE_ENDING_4_6_OUTRO_10_CHAR	$RAN
$LINE_ENDING_4_6_OUTRO_10_TEXT	我們自由了。
$LINE_ENDING_4_6_OUTRO_20_CHAR	$KNI
$LINE_ENDING_4_6_OUTRO_20_TEXT	現在呢，女士？
$LINE_ENDING_4_6_OUTRO_30_CHAR	$MCG
$LINE_ENDING_4_6_OUTRO_30_TEXT	我不知道……
$LINE_ENDING_4_6_OUTRO_40_CHAR	$MCG
$LINE_ENDING_4_6_OUTRO_40_TEXT	墓坑……
$LINE_ENDING_4_6_OUTRO_50_CHAR	$KNI
$LINE_ENDING_4_6_OUTRO_50_TEXT	我們做了必須要做的事情。
$LINE_ENDING_4_6_OUTRO_60_CHAR	$KNI
$LINE_ENDING_4_6_OUTRO_60_TEXT	我們無法阻止舍裡米爾……
$LINE_ENDING_4_6_OUTRO_70_CHAR	$KNI
$LINE_ENDING_4_6_OUTRO_70_TEXT	如果你死了，艾斯裡-特諾奇就自由了。
$LINE_ENDING_4_6_OUTRO_80_CHAR	$MCG
$LINE_ENDING_4_6_OUTRO_80_TEXT	那也不會讓情況好轉。
$LINE_ENDING_4_6_OUTRO_90_CHAR	$MCG
$LINE_ENDING_4_6_OUTRO_90_TEXT	所有的那些人……
$LINE_ENDING_4_6_OUTRO_100_CHAR	$KNI
$LINE_ENDING_4_6_OUTRO_100_TEXT	這是個悲劇……
$LINE_ENDING_4_6_OUTRO_110_CHAR	$KNI
$LINE_ENDING_4_6_OUTRO_110_TEXT	不要因為生存而責備自己。
$LINE_ENDING_4_6_OUTRO_120_CHAR	$MCG
$LINE_ENDING_4_6_OUTRO_120_TEXT	……
$LINE_ENDING_4_6_OUTRO_121_TEXT	當我閉上眼睛，我仍能感受到墓坑坍塌的迴響，以及無數受害者的尖叫。
$LINE_ENDING_4_6_OUTRO_122_TEXT	兩個月的時間對這種強烈的感受沒有任何的緩解作用。我嘴裡的血腥味再也不會消失了。
$LINE_ENDING_4_6_OUTRO_123_TEXT	我也不想這樣。
$LINE_ENDING_4_6_OUTRO_124_TEXT	在這場殘酷的冒險之中，他們揮灑了無數的鮮血，而我，困在我自己的牢籠之中，無法將我的血也撒進其中。
$LINE_ENDING_4_6_OUTRO_125_TEXT	我的回憶就是我的參與。在我這借來的餘生之中，我會永遠將我的思緒沉浸其中。
$LINE_ENDING_4_6_OUTRO_126_TEXT	*$RAN埋葬了她的狐狸。這對於一個諾曼來說意味著什麼，我並不知道。
$LINE_ENDING_4_6_OUTRO_127_TEXT	我本可以問她，這種無聊的好奇心已經給我的生活帶來了很多，但這次它並沒有像以前一樣牢牢抓住抓住我的思緒。
$LINE_ENDING_4_6_OUTRO_128_TEXT	最終，這也已經不重要了。一天早上，她走了，這是一個結論，我們共同的冒險將永遠存在。
$LINE_ENDING_4_6_OUTRO_129_TEXT	我認為*$KNI應該會留下的，如果我去問他的話。但似乎這也是不對的。
$LINE_ENDING_4_6_OUTRO_130_TEXT	我解放了他，這個世界正在慢慢重建，我讓他去做他自己想做的事情。在這裡，我還需要一個保鏢嗎？
$LINE_ENDING_4_6_OUTRO_131_TEXT	瘟疫退散了。奎德也滅亡了。
$LINE_ENDING_4_6_OUTRO_132_TEXT	再也沒有邪惡了，除了我們自己的。
$LINE_ENDING_4_6_OUTRO_133_TEXT	*——$MCG·雅琪·利佛巴
$SCENE_4_7_INTRO_TITLE	跟隨舍裡米爾
$LINE_4_7_INTRO_00_CHAR	$MCG
$LINE_4_7_INTRO_00_TEXT	我知道那樣可以拯救世界……
$LINE_4_7_INTRO_10_CHAR	$MCG
$LINE_4_7_INTRO_10_TEXT	但是我不能對舍裡米爾的所作所為置之不理。
$LINE_4_7_INTRO_20_CHAR	$MCG
$LINE_4_7_INTRO_20_TEXT	代價太沉重了。
$LINE_4_7_INTRO_30_CHAR	$HEA
$LINE_4_7_INTRO_30_TEXT	你知道去那裡的風險有多大嗎？
$LINE_4_7_INTRO_40_CHAR	$HEA
$LINE_4_7_INTRO_40_TEXT	我不會允許他的計畫得逞的，但是你的到來把一切都置於危險的境地。
$LINE_4_7_INTRO_50_CHAR	$MCG
$LINE_4_7_INTRO_50_TEXT	你的唯一的一線希望就是我，你知道的。
$LINE_4_7_INTRO_60_CHAR	$HEA
$LINE_4_7_INTRO_60_TEXT	很好，這是你的選擇。
$LINE_4_7_INTRO_70_CHAR	$BER
$LINE_4_7_INTRO_70_TEXT	好吧！自殺衝擊時間！
$LINE_4_7_INTRO_80_CHAR	$BER
$LINE_4_7_INTRO_80_TEXT	我喜歡暴力！
$LINE_4_7_INTRO_90_CHAR	$MAG
$LINE_4_7_INTRO_90_TEXT	我和你一起。不會讓這個野獸毀掉剩下的人。
$LINE_4_7_INTRO_100_CHAR	$DRA
$LINE_4_7_INTRO_100_TEXT	勇氣可嘉，凡人。幹得好。
$LINE_4_7_INTRO_110_CHAR	$DRA
$LINE_4_7_INTRO_110_TEXT	我的孩子們不應該去復仇。
$LINE_4_7_INTRO_120_CHAR	$RAN
$LINE_4_7_INTRO_120_TEXT	我很欣賞你的道德原則和其他品質，但是我要出去。
$LINE_4_7_INTRO_130_CHAR	$RAN
$LINE_4_7_INTRO_130_TEXT	我千辛萬苦來到出口前，我不會回去再被人殺死的。
$LINE_4_7_INTRO_140_CHAR	$MCG
$LINE_4_7_INTRO_140_TEXT	我知道。
$LINE_4_7_INTRO_150_CHAR	$RAN
$LINE_4_7_INTRO_150_TEXT	好吧……再見。
$LINE_4_7_INTRO_160_CHAR	$MCG
$LINE_4_7_INTRO_160_TEXT	*再見了， $RAN。
$LINE_4_7_INTRO_170_CHAR	$RAN
$LINE_4_7_INTRO_170_TEXT	……
$LINE_4_7_INTRO_180_CHAR	$RAN
$LINE_4_7_INTRO_180_TEXT	*$BER！
$LINE_4_7_INTRO_190_CHAR	$BER
$LINE_4_7_INTRO_190_TEXT	喲。
$LINE_4_7_INTRO_200_CHAR	$RAN
$LINE_4_7_INTRO_200_TEXT	你知道自己要死了，是吧？
$LINE_4_7_INTRO_210_CHAR	$BER
$LINE_4_7_INTRO_210_TEXT	當然。
$LINE_4_7_INTRO_220_CHAR	$RAN
$LINE_4_7_INTRO_220_TEXT	那……這樣你也不再重新考慮一下整件事情嗎？
$LINE_4_7_INTRO_230_CHAR	$BER
$LINE_4_7_INTRO_230_TEXT	*嘿，$RAN，你和我都成功逃生了。
$LINE_4_7_INTRO_240_CHAR	$BER
$LINE_4_7_INTRO_240_TEXT	但是你不可能永遠都這麼幸運。總有一天，你會死去。
$LINE_4_7_INTRO_250_CHAR	$BER
$LINE_4_7_INTRO_250_TEXT	這是個給生命賦予意義的機會。
$LINE_4_7_INTRO_260_CHAR	$RAN
$LINE_4_7_INTRO_260_TEXT	*$BER……
$LINE_4_7_INTRO_270_CHAR	$BER
$LINE_4_7_INTRO_270_TEXT	還有，欠你那些東西我再也不用還了。
$LINE_4_7_INTRO_280_CHAR	$BER
$LINE_4_7_INTRO_280_TEXT	回頭見！
$LINE_4_7_INTRO_290_CHAR	$RAN
$LINE_4_7_INTRO_290_TEXT	……再見……
$SCENE_4_7_OUTRO_TITLE	許多
$LINE_4_7_OUTRO_00_CHAR	$KNI
$LINE_4_7_OUTRO_00_TEXT	先鋒倒下了，但是大部隊在包抄我們。
$LINE_4_7_OUTRO_10_CHAR	$KNI
$LINE_4_7_OUTRO_10_TEXT	要是我們對付他們，可能就無法立刻跟上舍裡米爾了。
$LINE_4_7_OUTRO_20_CHAR	$MCG
$LINE_4_7_OUTRO_20_TEXT	你有什麼建議？
$LINE_4_7_OUTRO_30_CHAR	$KNI
$LINE_4_7_OUTRO_30_TEXT	嗯……
$LINE_4_7_OUTRO_40_CHAR	$KNI
$LINE_4_7_OUTRO_40_TEXT	老實說？直接突入敵人內部，殺掉所有會動的。
$LINE_4_7_OUTRO_50_CHAR	$MCG
$LINE_4_7_OUTRO_50_TEXT	聽起來不錯。
$LINE_4_7_OUTRO_60_CHAR	$BER
$LINE_4_7_OUTRO_60_TEXT	不錯啊，好傢伙！
$LINE_4_7_OUTRO_70_CHAR	$BER
$LINE_4_7_OUTRO_70_TEXT	好主意！
$LINE_4_7_OUTRO_80_CHAR	$KNI
$LINE_4_7_OUTRO_80_TEXT	那是什麼？你在幹什麼？
$LINE_4_7_OUTRO_90_CHAR	$BER
$LINE_4_7_OUTRO_90_TEXT	來一個男子漢的頂拳儀式啊！
$LINE_4_7_OUTRO_100_CHAR	$KNI
$LINE_4_7_OUTRO_100_TEXT	不，不要。
$LINE_4_7_OUTRO_110_CHAR	$KNI
$LINE_4_7_OUTRO_110_TEXT	別碰我。
$LINE_4_7_OUTRO_120_CHAR	$KNI
$LINE_4_7_OUTRO_120_TEXT	還有，如果你不介意的話，請待在我的下風向就更好了。
$SCENE_4_8_INTRO_TITLE	舍裡米爾的軍隊
$LINE_4_8_INTRO_00_CHAR	$MAG
$LINE_4_8_INTRO_00_TEXT	我們到了
$LINE_4_8_INTRO_10_CHAR	$MAG
$LINE_4_8_INTRO_10_TEXT	敵人大部隊。
$LINE_4_8_INTRO_20_CHAR	$BER
$LINE_4_8_INTRO_20_TEXT	真的好多人啊。
$LINE_4_8_INTRO_30_CHAR	$MAG
$LINE_4_8_INTRO_30_TEXT	我是火的女兒，對抗我的人都會被燒死。
$LINE_4_8_INTRO_40_CHAR	$BER
$LINE_4_8_INTRO_40_TEXT	噢，我也希望自己能有帥氣的戰吼……
$LINE_4_8_INTRO_50_CHAR	$BER
$LINE_4_8_INTRO_50_TEXT	<LQ>哇啊啊啊嗷嗷嗷<RQ>聽起來不太盡如人意。
$LINE_4_8_INTRO_60_CHAR	$RAN
$LINE_4_8_INTRO_60_TEXT	我不知道，我還挺喜歡<LQ>哇啊啊啊嗷嗷嗷<RQ>的。
$LINE_4_8_INTRO_70_CHAR	$RAN
$LINE_4_8_INTRO_70_TEXT	你應該保持。
$LINE_4_8_INTRO_80_CHAR	$BER
$LINE_4_8_INTRO_80_TEXT	嘿，你回來了。
$LINE_4_8_INTRO_90_CHAR	$RAN
$LINE_4_8_INTRO_90_TEXT	嘿，我回來了。
$LINE_4_8_INTRO_100_CHAR	$BER
$LINE_4_8_INTRO_100_TEXT	你知道我還是不會還你的，對吧？
$LINE_4_8_INTRO_110_CHAR	$RAN
$LINE_4_8_INTRO_110_TEXT	讓我們先好好應付這次自殺式衝鋒，好嗎？
$LINE_4_8_INTRO_120_CHAR	$BER
$LINE_4_8_INTRO_120_TEXT	是的，但是首先。
$LINE_4_8_INTRO_130_CHAR	$RAN
$LINE_4_8_INTRO_130_TEXT	什麼，那是什麼？
$LINE_4_8_INTRO_140_CHAR	$BER
$LINE_4_8_INTRO_140_TEXT	男子漢的頂拳！
$LINE_4_8_INTRO_150_CHAR	$RAN
$LINE_4_8_INTRO_150_TEXT	我為什麼要這麼做？
$LINE_4_8_INTRO_160_CHAR	$BER
$LINE_4_8_INTRO_160_TEXT	因為我們這麼了不起，我們應該把頂拳作為打招呼的方式！
$LINE_4_8_INTRO_170_CHAR	$RAN
$LINE_4_8_INTRO_170_TEXT	好吧，我回來了—— 希望不要頂走你的運氣。
$LINE_4_8_INTRO_180_CHAR	$BER
$LINE_4_8_INTRO_180_TEXT	……太爛了。
$LINE_4_8_INTRO_190_CHAR	$RAN
$LINE_4_8_INTRO_190_TEXT	讓我們去赴死吧，準備好了嗎？
$LINE_4_8_INTRO_200_CHAR	$BER
$LINE_4_8_INTRO_200_TEXT	哇啊啊嗷嗷。
$SCENE_4_8_OUTRO_TITLE	還有一人
$LINE_4_8_OUTRO_00_CHAR	$MAG
$LINE_4_8_OUTRO_00_TEXT	最後一個敵人倒下了。
$LINE_4_8_OUTRO_10_CHAR	$DRA
$LINE_4_8_OUTRO_10_TEXT	不，不是最後一個。
$LINE_4_8_OUTRO_20_CHAR	$DRA
$LINE_4_8_OUTRO_20_TEXT	還有一個。
$LINE_4_8_OUTRO_30_CHAR	$DRA
$LINE_4_8_OUTRO_30_TEXT	還有一個將直面我復仇的人
$LINE_4_8_OUTRO_40_CHAR	$MAG
$LINE_4_8_OUTRO_40_TEXT	以及直面宇宙之焰的正義。
$LINE_4_8_OUTRO_50_CHAR	$MAG
$LINE_4_8_OUTRO_50_TEXT	舍裡米爾
$SCENE_4_9_INTRO_TITLE	直面瘋狂
$LINE_4_9_INTRO_00_CHAR	舍裡米爾
$LINE_4_9_INTRO_00_TEXT	鮮血已經溢出了了，如果現在還不凝固——
$LINE_4_9_INTRO_10_CHAR	$MCG
$LINE_4_9_INTRO_10_TEXT	住手！
$LINE_4_9_INTRO_20_CHAR	舍裡米爾
$LINE_4_9_INTRO_20_TEXT	*……$MCG。
$LINE_4_9_INTRO_30_CHAR	舍裡米爾
$LINE_4_9_INTRO_30_TEXT	你看到了，多虧了我們的英勇戰鬥——可惡的男巫被囚禁了。
$LINE_4_9_INTRO_40_CHAR	舍裡米爾
$LINE_4_9_INTRO_40_TEXT	事到如今，他還想負隅頑抗。
$LINE_4_9_INTRO_50_CHAR	舍裡米爾
$LINE_4_9_INTRO_50_TEXT	他知道，自己會永久地被鎖起來。
$LINE_4_9_INTRO_60_CHAR	$MCG
$LINE_4_9_INTRO_60_TEXT	我才不會讓你動手。
$LINE_4_9_INTRO_70_CHAR	舍裡米爾
$LINE_4_9_INTRO_70_TEXT	我不想這樣做。
$LINE_4_9_INTRO_80_CHAR	舍裡米爾
$LINE_4_9_INTRO_80_TEXT	但是，如果你自己選擇死亡，新血印會更加威力強大的。
$LINE_4_9_INTRO_90_CHAR	$MCG
$LINE_4_9_INTRO_90_TEXT	我不會讓你殺掉這些人的。
$LINE_4_9_INTRO_100_CHAR	舍裡米爾
$LINE_4_9_INTRO_100_TEXT	*$MCG，我已經殺了成千上萬人了……
$LINE_4_9_INTRO_110_CHAR	舍裡米爾
$LINE_4_9_INTRO_110_TEXT	還剩幾千人，我就能停止這一切。我就能阻止他。
$LINE_4_9_INTRO_120_CHAR	舍裡米爾
$LINE_4_9_INTRO_120_TEXT	這些生命，相對於已經死在我手上的來說，只是九牛一毛。
$LINE_4_9_INTRO_130_CHAR	$MCG
$LINE_4_9_INTRO_130_TEXT	我不會容許你這樣做的！
$SCENE_4_9_OUTRO_TITLE	為時已晚
$LINE_4_9_OUTRO_00_CHAR	舍裡米爾
$LINE_4_9_OUTRO_00_TEXT	*幹的不錯， $MCG。
$LINE_4_9_OUTRO_10_CHAR	舍裡米爾
$LINE_4_9_OUTRO_10_TEXT	但是太遲了。
$LINE_4_9_OUTRO_20_CHAR	舍裡米爾
$LINE_4_9_OUTRO_20_TEXT	信號燈已經熄滅……
$LINE_4_9_OUTRO_30_CHAR	舍裡米爾
$LINE_4_9_OUTRO_30_TEXT	現在……
$LINE_4_9_OUTRO_40_CHAR	舍裡米爾
$LINE_4_9_OUTRO_40_TEXT	墓坑崩塌……
$LINE_4_9_OUTRO_50_CHAR	舍裡米爾
$LINE_4_9_OUTRO_50_TEXT	……我們為了永遠囚禁艾斯裡-特諾奇付出了生命。
$LINE_4_9_OUTRO_60_CHAR	$MCG
$LINE_4_9_OUTRO_60_TEXT	你不能殺掉這些人……
$LINE_4_9_OUTRO_70_CHAR	$MCG
$LINE_4_9_OUTRO_70_TEXT	……不……
$LINE_4_9_OUTRO_80_CHAR	$MCG
$LINE_4_9_OUTRO_80_TEXT	不！
$SCENE_FINAL_INTRO_TITLE	艾斯裡-特諾奇
$LINE_FINAL_INTRO_00_CHAR	$KNI
$LINE_FINAL_INTRO_00_TEXT	剛才發生了什麼？
$LINE_FINAL_INTRO_10_CHAR	$MCG
$LINE_FINAL_INTRO_10_TEXT	我們在……半……中途世界...
$LINE_FINAL_INTRO_20_CHAR	$KNI
$LINE_FINAL_INTRO_20_TEXT	其他人呢？
$LINE_FINAL_INTRO_30_CHAR	$MCG
$LINE_FINAL_INTRO_30_TEXT	他們……在這裡。
$LINE_FINAL_INTRO_40_CHAR	$KNI
$LINE_FINAL_INTRO_40_TEXT	什麼？所有人？
$LINE_FINAL_INTRO_50_CHAR	$MCG
$LINE_FINAL_INTRO_50_TEXT	墓坑裡的所有人……我把他們拉進來了……他們……安全了……
$LINE_FINAL_INTRO_60_CHAR	$KNI
$LINE_FINAL_INTRO_60_TEXT	那可是好幾千人啊！怎麼能……
$LINE_FINAL_INTRO_70_CHAR	$KNI
$LINE_FINAL_INTRO_70_TEXT	*$MCG，你受傷了。
$LINE_FINAL_INTRO_80_CHAR	$KNI
$LINE_FINAL_INTRO_80_TEXT	你在流血！
$LINE_FINAL_INTRO_90_CHAR	舍裡米爾
$LINE_FINAL_INTRO_90_TEXT	不……血！
$LINE_FINAL_INTRO_100_CHAR	舍裡米爾
$LINE_FINAL_INTRO_100_TEXT	新封印還沒有完成！你不能讓血……
$LINE_FINAL_INTRO_110_CHAR	艾斯裡-特諾奇
$LINE_FINAL_INTRO_110_TEXT	終於，我自由了。
$SCENE_GAMEOVER_A_TITLE	一切盡失
$LINE_GAMEOVER_A_00_CHAR	艾斯裡-特諾奇
$LINE_GAMEOVER_A_00_TEXT	終於。
$LINE_GAMEOVER_A_10_CHAR	艾斯裡-特諾奇
$LINE_GAMEOVER_A_10_TEXT	世界終於回到了我的手中。
$SCENE_ENDING_ZELEMIR_DEAD_TITLE	痛苦的結局
$NARR_ENDING_ZELEMIR_DEAD_00_TEXT	我們忙著逃跑。
$NARR_ENDING_ZELEMIR_DEAD_10_TEXT	岩石不斷崩塌。
$NARR_ENDING_ZELEMIR_DEAD_20_TEXT	很多人死了。
$NARR_ENDING_ZELEMIR_DEAD_30_TEXT	我們討論了好幾天。
$NARR_ENDING_ZELEMIR_DEAD_40_TEXT	諾曼商隊斷斷續續地買我們的廢料。
$NARR_ENDING_ZELEMIR_DEAD_50_TEXT	我們中很多人都食不果腹。
$NARR_ENDING_ZELEMIR_DEAD_60_TEXT	難民裡出現了各種領導者。
$NARR_ENDING_ZELEMIR_DEAD_70_TEXT	但是誰也懶得管了。
$NARR_ENDING_ZELEMIR_DEAD_80_TEXT	呼吸新鮮空氣對我而言依舊是很奇怪的感覺。
$NARR_ENDING_ZELEMIR_DEAD_90_TEXT	最終一切都達成了一致。
$NARR_ENDING_ZELEMIR_DEAD_100_TEXT	我的命運永遠地發生了改變。
$NARR_ENDING_ZELEMIR_DEAD_110_TEXT	世界也永遠地發生改變了。
$LINE_ENDING_ZELEMIR_DEAD_00_CHAR	$HEA
$LINE_ENDING_ZELEMIR_DEAD_00_TEXT	……我們可能追不上他……
$LINE_ENDING_ZELEMIR_DEAD_10_CHAR	$HEA
$LINE_ENDING_ZELEMIR_DEAD_10_TEXT	……但是我們可以困住他！
$LINE_ENDING_ZELEMIR_DEAD_20_CHAR	$MCG
$LINE_ENDING_ZELEMIR_DEAD_20_TEXT	長老？
$LINE_ENDING_ZELEMIR_DEAD_30_CHAR	$HEA
$LINE_ENDING_ZELEMIR_DEAD_30_TEXT	一個新的血印，把他囚禁在他撤退到的地方。
$LINE_ENDING_ZELEMIR_DEAD_40_CHAR	$MCG
$LINE_ENDING_ZELEMIR_DEAD_40_TEXT	長老，不！
$LINE_ENDING_ZELEMIR_DEAD_50_CHAR	$HEA
$LINE_ENDING_ZELEMIR_DEAD_50_TEXT	事情本該如此。
$LINE_ENDING_ZELEMIR_DEAD_60_CHAR	$HEA
$LINE_ENDING_ZELEMIR_DEAD_60_TEXT	舍裡米爾啟動的咒語仍然有效。
$LINE_ENDING_ZELEMIR_DEAD_70_CHAR	$HEA
$LINE_ENDING_ZELEMIR_DEAD_70_TEXT	舍裡米爾已經死了……
$LINE_ENDING_ZELEMIR_DEAD_80_CHAR	$HEA
$LINE_ENDING_ZELEMIR_DEAD_80_TEXT	用他的血和我的血，我們能再次封住這個邪惡的男巫！
$LINE_ENDING_ZELEMIR_DEAD_90_CHAR	艾斯裡-特諾奇
$LINE_ENDING_ZELEMIR_DEAD_90_TEXT	蠢貨！我會逃走的。這麼多年……終有一天，你的血會會自己來找到我的。
$LINE_ENDING_ZELEMIR_DEAD_100_CHAR	艾斯裡-特諾奇
$LINE_ENDING_ZELEMIR_DEAD_100_TEXT	你的兒子，你的孫子。我會等著的。世世代代中誰能夠戰勝我？
$LINE_ENDING_ZELEMIR_DEAD_110_CHAR	$HEA
$LINE_ENDING_ZELEMIR_DEAD_110_TEXT	但是你應該被囚禁。現在人們該接受教訓了，他們應該時刻做好準備。
$LINE_ENDING_ZELEMIR_DEAD_120_CHAR	艾斯裡-特諾奇
$LINE_ENDING_ZELEMIR_DEAD_120_TEXT	你已有通過謊言才能忍受真相了。
$LINE_ENDING_ZELEMIR_DEAD_130_CHAR	$HEA
$LINE_ENDING_ZELEMIR_DEAD_130_TEXT	你低估了這個世界。
$LINE_ENDING_ZELEMIR_DEAD_140_CHAR	艾斯裡-特諾奇
$LINE_ENDING_ZELEMIR_DEAD_140_TEXT	你的世界需要我，僧侶。終有一天，會有人把我救出去，求我拯救他們。
$LINE_ENDING_ZELEMIR_DEAD_150_CHAR	艾斯裡-特諾奇
$LINE_ENDING_ZELEMIR_DEAD_150_TEXT	你的後代同樣會灑下他們的鮮血，就像你一樣。
$LINE_ENDING_ZELEMIR_DEAD_160_CHAR	$KNI
$LINE_ENDING_ZELEMIR_DEAD_160_TEXT	我沒結婚，沒孩子。
$LINE_ENDING_ZELEMIR_DEAD_170_CHAR	$KNI
$LINE_ENDING_ZELEMIR_DEAD_170_TEXT	這一輩子都不會有了。
$LINE_ENDING_ZELEMIR_DEAD_180_CHAR	$MCG
$LINE_ENDING_ZELEMIR_DEAD_180_TEXT	*$KNI？
$LINE_ENDING_ZELEMIR_DEAD_190_CHAR	$KNI
$LINE_ENDING_ZELEMIR_DEAD_190_TEXT	要封住這個野獸，一個血印還不夠。
$LINE_ENDING_ZELEMIR_DEAD_200_CHAR	$KNI
$LINE_ENDING_ZELEMIR_DEAD_200_TEXT	原來的血印是一般的三倍效果……而我們已經看到了，當它削弱到一倍的時候發生了什麼。
$LINE_ENDING_ZELEMIR_DEAD_210_CHAR	$KNI
$LINE_ENDING_ZELEMIR_DEAD_210_TEXT	*再會，$MCG。帶領我的人去安全的地方吧。
$LINE_ENDING_ZELEMIR_DEAD_220_CHAR	$MCG
$LINE_ENDING_ZELEMIR_DEAD_220_TEXT	不！
$LINE_ENDING_ZELEMIR_DEAD_230_CHAR	$HEA
$LINE_ENDING_ZELEMIR_DEAD_230_TEXT	現在我們要揮灑我們的血液，將你永遠的封印。
$LINE_ENDING_ZELEMIR_DEAD_240_CHAR	$MCG
$LINE_ENDING_ZELEMIR_DEAD_240_TEXT	長老，求求你了！
$LINE_ENDING_ZELEMIR_DEAD_250_CHAR	$HEA
$LINE_ENDING_ZELEMIR_DEAD_250_TEXT	綁定，封印，隱藏。完成了。
$LINE_ENDING_ZELEMIR_DEAD_260_CHAR	$MCG
$LINE_ENDING_ZELEMIR_DEAD_260_TEXT	……
$LINE_ENDING_ZELEMIR_DEAD_270_CHAR	艾斯裡-特諾奇
$LINE_ENDING_ZELEMIR_DEAD_270_TEXT	什麼是一千多年？
$LINE_ENDING_ZELEMIR_DEAD_280_CHAR	艾斯裡-特諾奇
$LINE_ENDING_ZELEMIR_DEAD_280_TEXT	十萬年？人心都是一樣的！我會——
$LINE_ENDING_ZELEMIR_DEAD_290_CHAR	$MCG
$LINE_ENDING_ZELEMIR_DEAD_290_TEXT	……
$LINE_ENDING_ZELEMIR_DEAD_300_CHAR	$RAN
$LINE_ENDING_ZELEMIR_DEAD_300_TEXT	*$MCG，墓坑在崩塌！
$LINE_ENDING_ZELEMIR_DEAD_310_CHAR	$RAN
$LINE_ENDING_ZELEMIR_DEAD_310_TEXT	我們現在必須離開這兒！
$LINE_ENDING_ZELEMIR_DEAD_320_CHAR	$MCG
$LINE_ENDING_ZELEMIR_DEAD_320_TEXT	大家都跟我來！
$LINE_ENDING_ZELEMIR_DEAD_330_CHAR	$MCG
$LINE_ENDING_ZELEMIR_DEAD_330_TEXT	去出口那裡！
$LINE_ENDING_ZELEMIR_DEAD_340_CHAR	$MCG
$LINE_ENDING_ZELEMIR_DEAD_340_TEXT	所以幾乎沒有人跟我們逃出來……
$LINE_ENDING_ZELEMIR_DEAD_350_CHAR	$RAN
$LINE_ENDING_ZELEMIR_DEAD_350_TEXT	已經很多了，如果舍裡米爾得逞的話，只有更少。
$LINE_ENDING_ZELEMIR_DEAD_360_CHAR	$MCG
$LINE_ENDING_ZELEMIR_DEAD_360_TEXT	*好多人死了……還有$HEA和$KNI。
$LINE_ENDING_ZELEMIR_DEAD_370_CHAR	$RAN
$LINE_ENDING_ZELEMIR_DEAD_370_TEXT	*你做了件勇敢的事，$MCG。
$LINE_ENDING_ZELEMIR_DEAD_380_CHAR	$RAN
$LINE_ENDING_ZELEMIR_DEAD_380_TEXT	如果你不試試，他們現在都會死。
$LINE_ENDING_ZELEMIR_DEAD_390_CHAR	$RAN
$LINE_ENDING_ZELEMIR_DEAD_390_TEXT	我們得關注當下。
$LINE_ENDING_ZELEMIR_DEAD_400_CHAR	$RAN
$LINE_ENDING_ZELEMIR_DEAD_400_TEXT	我們現在得考慮更多人了。
$LINE_ENDING_ZELEMIR_DEAD_410_CHAR	$RAN
$LINE_ENDING_ZELEMIR_DEAD_410_TEXT	我們該怎麼對付他們？
$LINE_ENDING_ZELEMIR_DEAD_420_CHAR	$MAG
$LINE_ENDING_ZELEMIR_DEAD_420_TEXT	朋友，這是一段漫長的旅程。
$LINE_ENDING_ZELEMIR_DEAD_430_CHAR	$MCG
$LINE_ENDING_ZELEMIR_DEAD_430_TEXT	確實。你們確定準備好了麼？
$LINE_ENDING_ZELEMIR_DEAD_440_CHAR	$MCG
$LINE_ENDING_ZELEMIR_DEAD_440_TEXT	你們只剩這麼幾個人了……
$LINE_ENDING_ZELEMIR_DEAD_450_CHAR	$MAG
$LINE_ENDING_ZELEMIR_DEAD_450_TEXT	我們是奎德帝國最後的殘存者了。
$LINE_ENDING_ZELEMIR_DEAD_460_CHAR	$MAG
$LINE_ENDING_ZELEMIR_DEAD_460_TEXT	我們將帶回光榮，否則我們應該在我們人民的屍體堆中死去。
$LINE_ENDING_ZELEMIR_DEAD_470_CHAR	$MAG
$LINE_ENDING_ZELEMIR_DEAD_470_TEXT	我們沒有其他選擇了。
$LINE_ENDING_ZELEMIR_DEAD_480_CHAR	$MCG
$LINE_ENDING_ZELEMIR_DEAD_480_TEXT	但是沒有任何力量了……
$LINE_ENDING_ZELEMIR_DEAD_490_CHAR	$MAG
$LINE_ENDING_ZELEMIR_DEAD_490_TEXT	我很高興能夠擺脫冰霜……儘管這感覺……很奇怪……這麼久我已經太過習慣它了。
$LINE_ENDING_ZELEMIR_DEAD_500_CHAR	$MCG
$LINE_ENDING_ZELEMIR_DEAD_500_TEXT	是的，失去了力量，我幾乎覺得自己已經不完整了。
$LINE_ENDING_ZELEMIR_DEAD_510_CHAR	$MCG
$LINE_ENDING_ZELEMIR_DEAD_510_TEXT	我想艾斯裡-特諾奇的魔法已經隨他而去了。
$LINE_ENDING_ZELEMIR_DEAD_520_CHAR	$MCG
$LINE_ENDING_ZELEMIR_DEAD_520_TEXT	儘管我們的身體裡還殘留一些。
$LINE_ENDING_ZELEMIR_DEAD_530_CHAR	$MCG
$LINE_ENDING_ZELEMIR_DEAD_530_TEXT	*我相信長老$HEA知道為什麼會這樣……
$LINE_ENDING_ZELEMIR_DEAD_540_CHAR	$MAG
$LINE_ENDING_ZELEMIR_DEAD_540_TEXT	*他是個偉大的人，$MCG。
$LINE_ENDING_ZELEMIR_DEAD_550_CHAR	$MAG
$LINE_ENDING_ZELEMIR_DEAD_550_TEXT	他應該在被火焰大廳被銘記。
$LINE_ENDING_ZELEMIR_DEAD_560_CHAR	$MCG
$LINE_ENDING_ZELEMIR_DEAD_560_TEXT	那麼祝你旅途愉快。
$LINE_ENDING_ZELEMIR_DEAD_570_CHAR	$MAG
$LINE_ENDING_ZELEMIR_DEAD_570_TEXT	也祝福你。
$LINE_ENDING_ZELEMIR_DEAD_580_CHAR	$MCG
$LINE_ENDING_ZELEMIR_DEAD_580_TEXT	希望再見時情形會好點。
$LINE_ENDING_ZELEMIR_DEAD_590_CHAR	$RAN
$LINE_ENDING_ZELEMIR_DEAD_590_TEXT	嘿。
$LINE_ENDING_ZELEMIR_DEAD_600_CHAR	$MCG
$LINE_ENDING_ZELEMIR_DEAD_600_TEXT	你和其他諾曼人一起離開？
$LINE_ENDING_ZELEMIR_DEAD_610_CHAR	$RAN
$LINE_ENDING_ZELEMIR_DEAD_610_TEXT	不，我想我會自己走。
$LINE_ENDING_ZELEMIR_DEAD_620_CHAR	$RAN
$LINE_ENDING_ZELEMIR_DEAD_620_TEXT	我真的從沒想過這麼遠……
$LINE_ENDING_ZELEMIR_DEAD_630_CHAR	$RAN
$LINE_ENDING_ZELEMIR_DEAD_630_TEXT	我想我會去北方……誰知道呢，或許有其他革卡人仍然在那。
$LINE_ENDING_ZELEMIR_DEAD_640_CHAR	$MCG
$LINE_ENDING_ZELEMIR_DEAD_640_TEXT	朋友，旅途愉快。
$LINE_ENDING_ZELEMIR_DEAD_650_CHAR	$RAN
$LINE_ENDING_ZELEMIR_DEAD_650_TEXT	也祝福你。
$LINE_ENDING_ZELEMIR_DEAD_660_CHAR	$DRA
$LINE_ENDING_ZELEMIR_DEAD_660_TEXT	*$MCG。
$LINE_ENDING_ZELEMIR_DEAD_670_CHAR	$MCG
$LINE_ENDING_ZELEMIR_DEAD_670_TEXT	*$DRA。
$LINE_ENDING_ZELEMIR_DEAD_680_CHAR	$DRA
$LINE_ENDING_ZELEMIR_DEAD_680_TEXT	我們已滿足了彼此的需求，我們的合作就此結束了。
$LINE_ENDING_ZELEMIR_DEAD_690_CHAR	$DRA
$LINE_ENDING_ZELEMIR_DEAD_690_TEXT	或許我已經在崩塌中失去了我的寶庫寶庫，但是我和剩下的孩子們仍然活著……
$LINE_ENDING_ZELEMIR_DEAD_700_CHAR	$DRA
$LINE_ENDING_ZELEMIR_DEAD_700_TEXT	……這可不是什麼討價還價的事情……
$LINE_ENDING_ZELEMIR_DEAD_710_CHAR	$MCG
$LINE_ENDING_ZELEMIR_DEAD_710_TEXT	你打算去哪兒？
$LINE_ENDING_ZELEMIR_DEAD_720_CHAR	$DRA
$LINE_ENDING_ZELEMIR_DEAD_720_TEXT	一年的時間裡，我已經看盡凡人所做的一切。
$LINE_ENDING_ZELEMIR_DEAD_730_CHAR	$DRA
$LINE_ENDING_ZELEMIR_DEAD_730_TEXT	我會尋找我的同類。
$LINE_ENDING_ZELEMIR_DEAD_740_CHAR	$MCG
$LINE_ENDING_ZELEMIR_DEAD_740_TEXT	那麼旅途愉快。
$LINE_ENDING_ZELEMIR_DEAD_750_CHAR	$DRA
$LINE_ENDING_ZELEMIR_DEAD_750_TEXT	如果你想成為火焰師的一員，那麼就去找我們吧。
$LINE_ENDING_ZELEMIR_DEAD_760_CHAR	$MCG
$LINE_ENDING_ZELEMIR_DEAD_760_TEXT	謝謝你。
$LINE_ENDING_ZELEMIR_DEAD_770_CHAR	$BER
$LINE_ENDING_ZELEMIR_DEAD_770_TEXT	喲。
$LINE_ENDING_ZELEMIR_DEAD_780_CHAR	$MCG
$LINE_ENDING_ZELEMIR_DEAD_780_TEXT	*你的計畫是什麼，$BER？
$LINE_ENDING_ZELEMIR_DEAD_790_CHAR	$BER
$LINE_ENDING_ZELEMIR_DEAD_790_TEXT	當然是開始另一段冒險！
$LINE_ENDING_ZELEMIR_DEAD_800_CHAR	$BER
$LINE_ENDING_ZELEMIR_DEAD_800_TEXT	我需要一些東西來讓我忘記嘴巴裡的味道……
$LINE_ENDING_ZELEMIR_DEAD_810_CHAR	$BER
$LINE_ENDING_ZELEMIR_DEAD_810_TEXT	所有的……犧牲的味道……
$LINE_ENDING_ZELEMIR_DEAD_820_CHAR	$BER
$LINE_ENDING_ZELEMIR_DEAD_820_TEXT	這不是我擅長的事情。
$LINE_ENDING_ZELEMIR_DEAD_830_CHAR	$BER
$LINE_ENDING_ZELEMIR_DEAD_830_TEXT	我得回到自己的家鄉……
$LINE_ENDING_ZELEMIR_DEAD_840_CHAR	$BER
$LINE_ENDING_ZELEMIR_DEAD_840_TEXT	尋找寶藏！
$LINE_ENDING_ZELEMIR_DEAD_850_CHAR	$BER
$LINE_ENDING_ZELEMIR_DEAD_850_TEXT	但是我需要一個可靠的搭檔……
$LINE_ENDING_ZELEMIR_DEAD_860_CHAR	$MCG
$LINE_ENDING_ZELEMIR_DEAD_860_TEXT	*……$RAN正在往北走。如果你現在出發，或許還能追上她。
$LINE_ENDING_ZELEMIR_DEAD_870_CHAR	$BER
$LINE_ENDING_ZELEMIR_DEAD_870_TEXT	太棒了！
$LINE_ENDING_ZELEMIR_DEAD_880_CHAR	$BER
$LINE_ENDING_ZELEMIR_DEAD_880_TEXT	她那裡大概有好幾噸寶藏我可以偷！
$LINE_ENDING_ZELEMIR_DEAD_890_CHAR	$MCG
$LINE_ENDING_ZELEMIR_DEAD_890_TEXT	我可沒有——
$LINE_ENDING_ZELEMIR_DEAD_900_CHAR	$BER
$LINE_ENDING_ZELEMIR_DEAD_900_TEXT	太晚了！計畫已經進行了！
$LINE_ENDING_ZELEMIR_DEAD_910_CHAR	$MCG
$LINE_ENDING_ZELEMIR_DEAD_910_TEXT	*……再見，$BER。
$LINE_ENDING_ZELEMIR_DEAD_920_CHAR	艾殊難民
$LINE_ENDING_ZELEMIR_DEAD_920_TEXT	女士，如果我們想一天之內到達，現在必須出發了。
$LINE_ENDING_ZELEMIR_DEAD_930_CHAR	$MCG
$LINE_ENDING_ZELEMIR_DEAD_930_TEXT	我知道……
$LINE_ENDING_ZELEMIR_DEAD_940_CHAR	$MCG
$LINE_ENDING_ZELEMIR_DEAD_940_TEXT	給我點時間。
$LINE_ENDING_ZELEMIR_DEAD_950_CHAR	$MCG
$LINE_ENDING_ZELEMIR_DEAD_950_TEXT	……
$SCENE_ENDING_ZELEMIR_WOUNDED_TITLE	苦樂參半的結局
$NARR_ENDING_ZELEMIR_WOUNDED_00_TEXT	我們討論了很多天。
$NARR_ENDING_ZELEMIR_WOUNDED_10_TEXT	諾曼商隊很樂意用食物交換我們的金幣。
$NARR_ENDING_ZELEMIR_WOUNDED_20_TEXT	聽說難民中有各種各樣的領導者。
$NARR_ENDING_ZELEMIR_WOUNDED_30_TEXT	但是每個人都因為活著而高興，因此不會爭吵。
$NARR_ENDING_ZELEMIR_WOUNDED_40_TEXT	呼吸新鮮空氣對我而言依舊是很奇怪的感覺。
$NARR_ENDING_ZELEMIR_WOUNDED_50_TEXT	最終所有一切都達成了一致。
$LINE_ENDING_ZELEMIR_WOUNDED_00_CHAR	$RAN
$LINE_ENDING_ZELEMIR_WOUNDED_00_TEXT	*$MCG，墓坑塌陷了！
$LINE_ENDING_ZELEMIR_WOUNDED_10_CHAR	$RAN
$LINE_ENDING_ZELEMIR_WOUNDED_10_TEXT	在這樣的中途世界裡，我們還能安全多久？
$LINE_ENDING_ZELEMIR_WOUNDED_20_CHAR	$MCG
$LINE_ENDING_ZELEMIR_WOUNDED_20_TEXT	不會太久——而且，如果一個巨石壓到我，我們全完蛋！
$LINE_ENDING_ZELEMIR_WOUNDED_30_CHAR	$MCG
$LINE_ENDING_ZELEMIR_WOUNDED_30_TEXT	*等等！如果我把舍裡米爾和$HEA送去另一個世界……
$LINE_ENDING_ZELEMIR_WOUNDED_40_CHAR	$MCG
$LINE_ENDING_ZELEMIR_WOUNDED_40_TEXT	或許我可以把我們大家……都送過去……
$LINE_ENDING_ZELEMIR_WOUNDED_50_CHAR	$RAN
$LINE_ENDING_ZELEMIR_WOUNDED_50_TEXT	什麼，所有的路都通向……另一邊？
$LINE_ENDING_ZELEMIR_WOUNDED_60_CHAR	$RAN
$LINE_ENDING_ZELEMIR_WOUNDED_60_TEXT	謝謝，但是我寧願在塌陷中被壓扁。
$LINE_ENDING_ZELEMIR_WOUNDED_70_CHAR	$MCG
$LINE_ENDING_ZELEMIR_WOUNDED_70_TEXT	不，是另一個方向！我可以把我們大家送出……墓坑……但仍然在我們的世界……
$LINE_ENDING_ZELEMIR_WOUNDED_80_CHAR	$RAN
$LINE_ENDING_ZELEMIR_WOUNDED_80_TEXT	好吧，你最好快點——
$LINE_ENDING_ZELEMIR_WOUNDED_90_CHAR	$RAN
$LINE_ENDING_ZELEMIR_WOUNDED_90_TEXT	——因為一切都……啊。
$LINE_ENDING_ZELEMIR_WOUNDED_100_CHAR	$RAN
$LINE_ENDING_ZELEMIR_WOUNDED_100_TEXT	*就這麼做吧，$MCG！
$LINE_ENDING_ZELEMIR_WOUNDED_110_CHAR	$MCG
$LINE_ENDING_ZELEMIR_WOUNDED_110_TEXT	這裡有沒有人知道怎麼……把四肢接上？因為我的手臂感覺像是……不再是我身體的一部分了。
$LINE_ENDING_ZELEMIR_WOUNDED_120_CHAR	$MAG
$LINE_ENDING_ZELEMIR_WOUNDED_120_TEXT	沒有苦難，就沒有光榮。
$LINE_ENDING_ZELEMIR_WOUNDED_121_CHAR	$MCG
$LINE_ENDING_ZELEMIR_WOUNDED_121_TEXT	……現在真的是非常、非常得光榮……
$LINE_ENDING_ZELEMIR_WOUNDED_130_CHAR	$MAG
$LINE_ENDING_ZELEMIR_WOUNDED_130_TEXT	……這樣暫時應該就可以了，一會兒我們得把它吊起來再用夾板固定。
$LINE_ENDING_ZELEMIR_WOUNDED_140_CHAR	$MAG
$LINE_ENDING_ZELEMIR_WOUNDED_140_TEXT	當我在醫院的時候，他們告訴我疼痛……疼痛是我們對於完美的渴望……
$LINE_ENDING_ZELEMIR_WOUNDED_150_CHAR	$MAG
$LINE_ENDING_ZELEMIR_WOUNDED_150_TEXT	...
$LINE_ENDING_ZELEMIR_WOUNDED_160_CHAR	$MCG
$LINE_ENDING_ZELEMIR_WOUNDED_160_TEXT	*$MAG？
$LINE_ENDING_ZELEMIR_WOUNDED_170_CHAR	$MAG
$LINE_ENDING_ZELEMIR_WOUNDED_170_TEXT	他死了……
$LINE_ENDING_ZELEMIR_WOUNDED_180_CHAR	$MCG
$LINE_ENDING_ZELEMIR_WOUNDED_180_TEXT	他們兩個都死了。
$LINE_ENDING_ZELEMIR_WOUNDED_190_CHAR	$MAG
$LINE_ENDING_ZELEMIR_WOUNDED_190_TEXT	這是正義的……然而我感覺……
$LINE_ENDING_ZELEMIR_WOUNDED_200_CHAR	$MCG
$LINE_ENDING_ZELEMIR_WOUNDED_200_TEXT	正義必然遠不及慈悲的感受。
$LINE_ENDING_ZELEMIR_WOUNDED_210_CHAR	$MAG
$LINE_ENDING_ZELEMIR_WOUNDED_210_TEXT	……
$LINE_ENDING_ZELEMIR_WOUNDED_220_CHAR	$MAG
$LINE_ENDING_ZELEMIR_WOUNDED_220_TEXT	*$MCG，我們現在該怎麼對付這些人？
$LINE_ENDING_ZELEMIR_WOUNDED_230_CHAR	$MAG
$LINE_ENDING_ZELEMIR_WOUNDED_230_TEXT	有成千上萬人呢。
$LINE_ENDING_ZELEMIR_WOUNDED_240_CHAR	$MAG
$LINE_ENDING_ZELEMIR_WOUNDED_240_TEXT	我們得供養整個軍隊。
$LINE_ENDING_ZELEMIR_WOUNDED_250_CHAR	$MAG
$LINE_ENDING_ZELEMIR_WOUNDED_250_TEXT	當地的諾曼人不會交易廢鐵的。
$LINE_ENDING_ZELEMIR_WOUNDED_260_CHAR	$DRA
$LINE_ENDING_ZELEMIR_WOUNDED_260_TEXT	你！人類！
$LINE_ENDING_ZELEMIR_WOUNDED_270_CHAR	$MAG
$LINE_ENDING_ZELEMIR_WOUNDED_270_TEXT	……
$LINE_ENDING_ZELEMIR_WOUNDED_280_CHAR	$DRA
$LINE_ENDING_ZELEMIR_WOUNDED_280_TEXT	我命令你把這些噁心的凡人小玩意兒拿走！
$LINE_ENDING_ZELEMIR_WOUNDED_290_CHAR	$DRA
$LINE_ENDING_ZELEMIR_WOUNDED_290_TEXT	它們聞起來向你們一樣臭。
$LINE_ENDING_ZELEMIR_WOUNDED_300_CHAR	$DRA
$LINE_ENDING_ZELEMIR_WOUNDED_300_TEXT	他們在神的周圍可沒容身之地。
$LINE_ENDING_ZELEMIR_WOUNDED_310_CHAR	$MAG
$LINE_ENDING_ZELEMIR_WOUNDED_310_TEXT	……謝謝你……
$LINE_ENDING_ZELEMIR_WOUNDED_320_CHAR	$DRA
$LINE_ENDING_ZELEMIR_WOUNDED_320_TEXT	什麼？你誤會了，人類！那是命令！
$LINE_ENDING_ZELEMIR_WOUNDED_330_CHAR	$DRA
$LINE_ENDING_ZELEMIR_WOUNDED_330_TEXT	馬上把這些討厭的東西拿開！
$LINE_ENDING_ZELEMIR_WOUNDED_340_CHAR	$MCG
$LINE_ENDING_ZELEMIR_WOUNDED_340_TEXT	當然，大人。
$LINE_ENDING_ZELEMIR_WOUNDED_350_CHAR	$MCG
$LINE_ENDING_ZELEMIR_WOUNDED_350_TEXT	……那麼，你現在要做什麼？
$LINE_ENDING_ZELEMIR_WOUNDED_360_CHAR	$DRA
$LINE_ENDING_ZELEMIR_WOUNDED_360_TEXT	我已經受夠了凡人所做的愚行。
$LINE_ENDING_ZELEMIR_WOUNDED_370_CHAR	$DRA
$LINE_ENDING_ZELEMIR_WOUNDED_370_TEXT	我要回到我的種族中去……
$LINE_ENDING_ZELEMIR_WOUNDED_380_CHAR	$DRA
$LINE_ENDING_ZELEMIR_WOUNDED_380_TEXT	我得找個伴侶教我的孩子。
$LINE_ENDING_ZELEMIR_WOUNDED_390_CHAR	$DRA
$LINE_ENDING_ZELEMIR_WOUNDED_390_TEXT	這些殘廢的翅膀，無法傳遞飛行的榮耀了。
$LINE_ENDING_ZELEMIR_WOUNDED_400_CHAR	$MAG
$LINE_ENDING_ZELEMIR_WOUNDED_400_TEXT	再見，大人。願你永遠能感覺到火焰的溫暖。
$LINE_ENDING_ZELEMIR_WOUNDED_410_CHAR	$DRA
$LINE_ENDING_ZELEMIR_WOUNDED_410_TEXT	也祝福你……
$LINE_ENDING_ZELEMIR_WOUNDED_420_CHAR	$MAG
$LINE_ENDING_ZELEMIR_WOUNDED_420_TEXT	……火焰之子，我錯怪你了。
$LINE_ENDING_ZELEMIR_WOUNDED_430_CHAR	$MCG
$LINE_ENDING_ZELEMIR_WOUNDED_430_TEXT	她剛剛是不是……？
$LINE_ENDING_ZELEMIR_WOUNDED_440_CHAR	$MAG
$LINE_ENDING_ZELEMIR_WOUNDED_440_TEXT	好吧，我們不會再挨餓了，那是肯定的。
$LINE_ENDING_ZELEMIR_WOUNDED_450_CHAR	$MCG
$LINE_ENDING_ZELEMIR_WOUNDED_450_TEXT	*$MAG。
$LINE_ENDING_ZELEMIR_WOUNDED_460_CHAR	$MAG
$LINE_ENDING_ZELEMIR_WOUNDED_460_TEXT	*$MCG。
$LINE_ENDING_ZELEMIR_WOUNDED_470_CHAR	$MAG
$LINE_ENDING_ZELEMIR_WOUNDED_470_TEXT	把他丟下真是太奇怪了……
$LINE_ENDING_ZELEMIR_WOUNDED_480_CHAR	$MAG
$LINE_ENDING_ZELEMIR_WOUNDED_480_TEXT	我欠他一條命。
$LINE_ENDING_ZELEMIR_WOUNDED_490_CHAR	$MAG
$LINE_ENDING_ZELEMIR_WOUNDED_490_TEXT	而現在他去世了，我永遠無法償還這份債。
$LINE_ENDING_ZELEMIR_WOUNDED_500_CHAR	$MCG
$LINE_ENDING_ZELEMIR_WOUNDED_500_TEXT	最好的償還便是治好他造成的傷害……
$LINE_ENDING_ZELEMIR_WOUNDED_510_CHAR	$MCG
$LINE_ENDING_ZELEMIR_WOUNDED_510_TEXT	……這也是他希望的。
$LINE_ENDING_ZELEMIR_WOUNDED_520_CHAR	$MAG
$LINE_ENDING_ZELEMIR_WOUNDED_520_TEXT	哦，朋友，我們會重建城市的。
$LINE_ENDING_ZELEMIR_WOUNDED_530_CHAR	$MAG
$LINE_ENDING_ZELEMIR_WOUNDED_530_TEXT	火焰榮耀的要求可是很高的。
$LINE_ENDING_ZELEMIR_WOUNDED_540_CHAR	$MAG
$LINE_ENDING_ZELEMIR_WOUNDED_540_TEXT	我將把剩下的人帶領到我們的土地，然後將榮耀帶回奎德帝國。
$LINE_ENDING_ZELEMIR_WOUNDED_550_CHAR	$MCG
$LINE_ENDING_ZELEMIR_WOUNDED_550_TEXT	你失去了……力量，這沒事嗎？
$LINE_ENDING_ZELEMIR_WOUNDED_560_CHAR	$MAG
$LINE_ENDING_ZELEMIR_WOUNDED_560_TEXT	*$MCG，我是火的女兒！我之前可是參加過弓術和劍術的訓練的。
$LINE_ENDING_ZELEMIR_WOUNDED_570_CHAR	$MAG
$LINE_ENDING_ZELEMIR_WOUNDED_570_TEXT	但是……我失去了……能力……感覺跟奇怪……但我很高興看到我的心中已經沒有冰霜了。
$LINE_ENDING_ZELEMIR_WOUNDED_580_CHAR	$MAG
$LINE_ENDING_ZELEMIR_WOUNDED_580_TEXT	那你自己怎麼辦？
$LINE_ENDING_ZELEMIR_WOUNDED_590_CHAR	$MCG
$LINE_ENDING_ZELEMIR_WOUNDED_590_TEXT	失去了力量……我幾乎覺得自己已經不完整了。
$LINE_ENDING_ZELEMIR_WOUNDED_600_CHAR	$MCG
$LINE_ENDING_ZELEMIR_WOUNDED_600_TEXT	但是……再次做回自己還是很不錯的。
$LINE_ENDING_ZELEMIR_WOUNDED_610_CHAR	$MCG
$LINE_ENDING_ZELEMIR_WOUNDED_610_TEXT	我想艾斯裡-特諾奇的魔法已經隨他而去了。
$LINE_ENDING_ZELEMIR_WOUNDED_620_CHAR	$MCG
$LINE_ENDING_ZELEMIR_WOUNDED_620_TEXT	儘管我們的身體裡還殘留一些。
$LINE_ENDING_ZELEMIR_WOUNDED_630_CHAR	$MCG
$LINE_ENDING_ZELEMIR_WOUNDED_630_TEXT	*我相信長老$HEA知道為什麼會這樣……
$LINE_ENDING_ZELEMIR_WOUNDED_640_CHAR	$MAG
$LINE_ENDING_ZELEMIR_WOUNDED_640_TEXT	*他是個偉大的人，$MCG。
$LINE_ENDING_ZELEMIR_WOUNDED_650_CHAR	$MAG
$LINE_ENDING_ZELEMIR_WOUNDED_650_TEXT	他應該在被火焰大廳被銘記。
$LINE_ENDING_ZELEMIR_WOUNDED_660_CHAR	$MCG
$LINE_ENDING_ZELEMIR_WOUNDED_660_TEXT	希望你所有的努力都能有好的結果。
$LINE_ENDING_ZELEMIR_WOUNDED_670_CHAR	$MAG
$LINE_ENDING_ZELEMIR_WOUNDED_670_TEXT	也祝願你，火焰之友。
$LINE_ENDING_ZELEMIR_WOUNDED_680_CHAR	$MAG
$LINE_ENDING_ZELEMIR_WOUNDED_680_TEXT	我將永遠記住我的恩人們……
$LINE_ENDING_ZELEMIR_WOUNDED_690_CHAR	$MAG
$LINE_ENDING_ZELEMIR_WOUNDED_690_TEXT	希望還能再見。
$LINE_ENDING_ZELEMIR_WOUNDED_700_CHAR	$MCG
$LINE_ENDING_ZELEMIR_WOUNDED_700_TEXT	再見！
$LINE_ENDING_ZELEMIR_WOUNDED_710_CHAR	$BER
$LINE_ENDING_ZELEMIR_WOUNDED_710_TEXT	喲。
$LINE_ENDING_ZELEMIR_WOUNDED_720_CHAR	$MCG
$LINE_ENDING_ZELEMIR_WOUNDED_720_TEXT	*所以你的計畫是什麼，$BER？
$LINE_ENDING_ZELEMIR_WOUNDED_730_CHAR	$MCG
$LINE_ENDING_ZELEMIR_WOUNDED_730_TEXT	你會和我們一起回到艾殊麼？
$LINE_ENDING_ZELEMIR_WOUNDED_740_CHAR	$BER
$LINE_ENDING_ZELEMIR_WOUNDED_740_TEXT	不，我有些事情必須先照顧一下……
$LINE_ENDING_ZELEMIR_WOUNDED_750_CHAR	$BER
$LINE_ENDING_ZELEMIR_WOUNDED_750_TEXT	*$HEA是個偉人……
$LINE_ENDING_ZELEMIR_WOUNDED_760_CHAR	$MCG
$LINE_ENDING_ZELEMIR_WOUNDED_760_TEXT	是的，他是的。
$LINE_ENDING_ZELEMIR_WOUNDED_770_CHAR	$BER
$LINE_ENDING_ZELEMIR_WOUNDED_770_TEXT	我得以傳統的方式……紀念他……的離去。
$LINE_ENDING_ZELEMIR_WOUNDED_780_CHAR	$MCG
$LINE_ENDING_ZELEMIR_WOUNDED_780_TEXT	傳統方式？
$LINE_ENDING_ZELEMIR_WOUNDED_790_CHAR	$BER
$LINE_ENDING_ZELEMIR_WOUNDED_790_TEXT	殺死一堆東西。喝得爛醉如泥。殺死更多東西。
$LINE_ENDING_ZELEMIR_WOUNDED_800_CHAR	$BER
$LINE_ENDING_ZELEMIR_WOUNDED_800_TEXT	脫光衣服。把自己塗成藍色。殺死更多東西。
$LINE_ENDING_ZELEMIR_WOUNDED_810_CHAR	$MCG
$LINE_ENDING_ZELEMIR_WOUNDED_810_TEXT	呃……這個，我不覺得他想要這個。
$LINE_ENDING_ZELEMIR_WOUNDED_820_CHAR	$BER
$LINE_ENDING_ZELEMIR_WOUNDED_820_TEXT	我說過他曾是個偉人，但我沒說他總是對的！
$LINE_ENDING_ZELEMIR_WOUNDED_830_CHAR	$BER
$LINE_ENDING_ZELEMIR_WOUNDED_830_TEXT	現在，來點暴力吧！
$LINE_ENDING_ZELEMIR_WOUNDED_840_CHAR	$MCG
$LINE_ENDING_ZELEMIR_WOUNDED_840_TEXT	我想我幾乎已經開始想念他了。
$LINE_ENDING_ZELEMIR_WOUNDED_850_CHAR	$RAN
$LINE_ENDING_ZELEMIR_WOUNDED_850_TEXT	喂。
$LINE_ENDING_ZELEMIR_WOUNDED_860_CHAR	$MCG
$LINE_ENDING_ZELEMIR_WOUNDED_860_TEXT	喂。我以為你和諾曼人一起走了？
$LINE_ENDING_ZELEMIR_WOUNDED_870_CHAR	$RAN
$LINE_ENDING_ZELEMIR_WOUNDED_870_TEXT	不……我還是決定不去了。
$LINE_ENDING_ZELEMIR_WOUNDED_880_CHAR	$RAN
$LINE_ENDING_ZELEMIR_WOUNDED_880_TEXT	我只是……
$LINE_ENDING_ZELEMIR_WOUNDED_890_CHAR	$RAN
$LINE_ENDING_ZELEMIR_WOUNDED_890_TEXT	世界大著呢。
$LINE_ENDING_ZELEMIR_WOUNDED_900_CHAR	$RAN
$LINE_ENDING_ZELEMIR_WOUNDED_900_TEXT	或許有其他革卡人還活著。
$LINE_ENDING_ZELEMIR_WOUNDED_910_CHAR	$RAN
$LINE_ENDING_ZELEMIR_WOUNDED_910_TEXT	如果是這樣，那他們肯定需要一切説明。
$LINE_ENDING_ZELEMIR_WOUNDED_920_CHAR	$RAN
$LINE_ENDING_ZELEMIR_WOUNDED_920_TEXT	或者我只是要，你知道的，去遊蕩一會兒。
$LINE_ENDING_ZELEMIR_WOUNDED_930_CHAR	$MCG
$LINE_ENDING_ZELEMIR_WOUNDED_930_TEXT	*……我想$BER正在尋求冒險。
$LINE_ENDING_ZELEMIR_WOUNDED_940_CHAR	$RAN
$LINE_ENDING_ZELEMIR_WOUNDED_940_TEXT	真的麼？他……呃……
$LINE_ENDING_ZELEMIR_WOUNDED_950_CHAR	$RAN
$LINE_ENDING_ZELEMIR_WOUNDED_950_TEXT	他是是個還可以接受的戰友。
$LINE_ENDING_ZELEMIR_WOUNDED_960_CHAR	$RAN
$LINE_ENDING_ZELEMIR_WOUNDED_960_TEXT	而且他還欠我錢……
$LINE_ENDING_ZELEMIR_WOUNDED_970_CHAR	$MCG
$LINE_ENDING_ZELEMIR_WOUNDED_970_TEXT	他向那邊去了。
$LINE_ENDING_ZELEMIR_WOUNDED_980_CHAR	$RAN
$LINE_ENDING_ZELEMIR_WOUNDED_980_TEXT	*謝謝你，$MCG。
$LINE_ENDING_ZELEMIR_WOUNDED_990_CHAR	$MCG
$LINE_ENDING_ZELEMIR_WOUNDED_990_TEXT	隨時找我。
$LINE_ENDING_ZELEMIR_WOUNDED_1000_CHAR	$KNI
$LINE_ENDING_ZELEMIR_WOUNDED_1000_TEXT	女士。
$LINE_ENDING_ZELEMIR_WOUNDED_1010_CHAR	$MCG
$LINE_ENDING_ZELEMIR_WOUNDED_1010_TEXT	*$KNI。
$LINE_ENDING_ZELEMIR_WOUNDED_1020_CHAR	$KNI
$LINE_ENDING_ZELEMIR_WOUNDED_1020_TEXT	艾殊難民準備好隨時跟你離開。
$LINE_ENDING_ZELEMIR_WOUNDED_1030_CHAR	$MCG
$LINE_ENDING_ZELEMIR_WOUNDED_1030_TEXT	*你呢，$KNI？你想回到首都麼？
$LINE_ENDING_ZELEMIR_WOUNDED_1040_CHAR	$KNI
$LINE_ENDING_ZELEMIR_WOUNDED_1040_TEXT	這是我的子民。而且，我的債務依然束縛著我，女士。
$LINE_ENDING_ZELEMIR_WOUNDED_1050_CHAR	$KNI
$LINE_ENDING_ZELEMIR_WOUNDED_1050_TEXT	我會一直陪著你，直到我償清債務。
$LINE_ENDING_ZELEMIR_WOUNDED_1060_CHAR	$MCG
$LINE_ENDING_ZELEMIR_WOUNDED_1060_TEXT	朋友，你的債務已經償清。我會遵守諾言，還你自由。
$LINE_ENDING_ZELEMIR_WOUNDED_1070_CHAR	$KNI
$LINE_ENDING_ZELEMIR_WOUNDED_1070_TEXT	那麼我能以朋友的身份陪著你麼？
$LINE_ENDING_ZELEMIR_WOUNDED_1080_CHAR	$MCG
$LINE_ENDING_ZELEMIR_WOUNDED_1080_TEXT	當然。這是一次漫長而又危險的旅程……我——大家都很高興你能和我們一起。
$LINE_ENDING_ZELEMIR_WOUNDED_1090_CHAR	$KNI
$LINE_ENDING_ZELEMIR_WOUNDED_1090_TEXT	我也很高興能和他們一起，女士。
$LINE_ENDING_ZELEMIR_WOUNDED_1100_CHAR	$MCG
$LINE_ENDING_ZELEMIR_WOUNDED_1100_TEXT	*你知道嗎，你可以叫我$MCG。
$LINE_ENDING_ZELEMIR_WOUNDED_1110_CHAR	$KNI
$LINE_ENDING_ZELEMIR_WOUNDED_1110_TEXT	*好的，$MCG女士。
$LINE_ENDING_ZELEMIR_WOUNDED_1120_CHAR	$MCG
$LINE_ENDING_ZELEMIR_WOUNDED_1120_TEXT	好吧，現在再試一遍，這次去掉<LQ>女士<RQ>兩個字。
$LINE_ENDING_ZELEMIR_WOUNDED_1130_CHAR	$KNI
$LINE_ENDING_ZELEMIR_WOUNDED_1130_TEXT	不要貪得無厭。
$SCENE_ENDING_ZELEMIR_UNSCATHED_TITLE	榮耀的結局
$NARR_ENDING_ZELEMIR_UNSCATHED_00_TEXT	我們討論了很多天。
$NARR_ENDING_ZELEMIR_UNSCATHED_10_TEXT	諾曼商隊很樂意用食物交換我們的金幣。
$NARR_ENDING_ZELEMIR_UNSCATHED_20_TEXT	聽說難民中有各種各樣的領導者。
$NARR_ENDING_ZELEMIR_UNSCATHED_30_TEXT	但是每個人都因為活著而高興，因此不會爭吵。
$NARR_ENDING_ZELEMIR_UNSCATHED_40_TEXT	呼吸新鮮空氣對我而言依舊是很奇怪的感覺。
$NARR_ENDING_ZELEMIR_UNSCATHED_50_TEXT	最終所有一切都達成了一致。
$LINE_ENDING_ZELEMIR_UNSCATHED_00_CHAR	$RAN
$LINE_ENDING_ZELEMIR_UNSCATHED_00_TEXT	*$MCG，墓坑塌陷了！
$LINE_ENDING_ZELEMIR_UNSCATHED_10_CHAR	$RAN
$LINE_ENDING_ZELEMIR_UNSCATHED_10_TEXT	在這樣的中途世界裡，我們還能安全多久？
$LINE_ENDING_ZELEMIR_UNSCATHED_20_CHAR	$MCG
$LINE_ENDING_ZELEMIR_UNSCATHED_20_TEXT	不會太久——而且，如果一個巨石壓到我，我們全完蛋！
$LINE_ENDING_ZELEMIR_UNSCATHED_30_CHAR	$MCG
$LINE_ENDING_ZELEMIR_UNSCATHED_30_TEXT	*等等！如果我把舍裡米爾和$HEA送去另一個世界……
$LINE_ENDING_ZELEMIR_UNSCATHED_40_CHAR	$MCG
$LINE_ENDING_ZELEMIR_UNSCATHED_40_TEXT	或許我可以把我們大家……都送過去……
$LINE_ENDING_ZELEMIR_UNSCATHED_50_CHAR	$RAN
$LINE_ENDING_ZELEMIR_UNSCATHED_50_TEXT	什麼，所有的路都通向……另一邊？
$LINE_ENDING_ZELEMIR_UNSCATHED_60_CHAR	$RAN
$LINE_ENDING_ZELEMIR_UNSCATHED_60_TEXT	謝謝，但是我寧願在塌陷中被壓扁。
$LINE_ENDING_ZELEMIR_UNSCATHED_70_CHAR	$MCG
$LINE_ENDING_ZELEMIR_UNSCATHED_70_TEXT	不，是另一個方向！我可以把我們大家送出……墓坑……但仍然在我們的世界……
$LINE_ENDING_ZELEMIR_UNSCATHED_80_CHAR	$RAN
$LINE_ENDING_ZELEMIR_UNSCATHED_80_TEXT	好吧，你最好快點——
$LINE_ENDING_ZELEMIR_UNSCATHED_90_CHAR	$RAN
$LINE_ENDING_ZELEMIR_UNSCATHED_90_TEXT	——因為一切都……啊。
$LINE_ENDING_ZELEMIR_UNSCATHED_100_CHAR	$RAN
$LINE_ENDING_ZELEMIR_UNSCATHED_100_TEXT	*就這麼做吧，$MCG！
$LINE_ENDING_ZELEMIR_UNSCATHED_110_CHAR	$MCG
$LINE_ENDING_ZELEMIR_UNSCATHED_110_TEXT	這裡有沒有人知道怎麼……把四肢接上？因為我的手臂感覺像是……不再是我身體的一部分了。
$LINE_ENDING_ZELEMIR_UNSCATHED_120_CHAR	$MAG
$LINE_ENDING_ZELEMIR_UNSCATHED_120_TEXT	拜託，我在十歲的時候雙臂就都經歷過這樣的情況……但我依然依靠一系列時機正好的腳踢和我鞋頭藏著的小刀，贏得了一場戰鬥。
$LINE_ENDING_ZELEMIR_UNSCATHED_121_CHAR	$MAG
$LINE_ENDING_ZELEMIR_UNSCATHED_121_TEXT	梆！鞋刃，弱者！打賭你一定沒有看到它過來的樣子！
$LINE_ENDING_ZELEMIR_UNSCATHED_122_CHAR	$MAG
$LINE_ENDING_ZELEMIR_UNSCATHED_122_TEXT	或者其實你根本沒看到任何東西！你知道的……因為你正好被一個十歲的孩子用鞋子裡的小刀踢飛了眼球。
$LINE_ENDING_ZELEMIR_UNSCATHED_123_CHAR	$MAG
$LINE_ENDING_ZELEMIR_UNSCATHED_123_TEXT	……
$LINE_ENDING_ZELEMIR_UNSCATHED_124_CHAR	$MAG
$LINE_ENDING_ZELEMIR_UNSCATHED_124_TEXT	……有什麼問題嗎？
$LINE_ENDING_ZELEMIR_UNSCATHED_125_CHAR	$MAG
$LINE_ENDING_ZELEMIR_UNSCATHED_125_TEXT	嗯，比如我的手臂還斷著？
$LINE_ENDING_ZELEMIR_UNSCATHED_130_CHAR	$DRA
$LINE_ENDING_ZELEMIR_UNSCATHED_130_TEXT	對！
$LINE_ENDING_ZELEMIR_UNSCATHED_131_CHAR	$MAG
$LINE_ENDING_ZELEMIR_UNSCATHED_131_TEXT	……這樣暫時應該就可以了，一會兒我們得把它吊起來再用夾板固定。
$LINE_ENDING_ZELEMIR_UNSCATHED_140_CHAR	$MAG
$LINE_ENDING_ZELEMIR_UNSCATHED_140_TEXT	*$MCG，我們現在該怎麼對付這些人？
$LINE_ENDING_ZELEMIR_UNSCATHED_150_CHAR	$MAG
$LINE_ENDING_ZELEMIR_UNSCATHED_150_TEXT	有成千上萬人呢。
$LINE_ENDING_ZELEMIR_UNSCATHED_160_CHAR	$MAG
$LINE_ENDING_ZELEMIR_UNSCATHED_160_TEXT	我們得供養整個軍隊。
$LINE_ENDING_ZELEMIR_UNSCATHED_170_CHAR	$MAG
$LINE_ENDING_ZELEMIR_UNSCATHED_170_TEXT	當地諾曼人不會交易廢鐵的。
$LINE_ENDING_ZELEMIR_UNSCATHED_180_CHAR	$DRA
$LINE_ENDING_ZELEMIR_UNSCATHED_180_TEXT	你！人類！
$LINE_ENDING_ZELEMIR_UNSCATHED_190_CHAR	$MAG
$LINE_ENDING_ZELEMIR_UNSCATHED_190_TEXT	……
$LINE_ENDING_ZELEMIR_UNSCATHED_200_CHAR	$DRA
$LINE_ENDING_ZELEMIR_UNSCATHED_200_TEXT	我命令你把這些噁心的凡人小玩意兒拿走！
$LINE_ENDING_ZELEMIR_UNSCATHED_210_CHAR	$DRA
$LINE_ENDING_ZELEMIR_UNSCATHED_210_TEXT	它們聞起來向你們一樣臭。
$LINE_ENDING_ZELEMIR_UNSCATHED_220_CHAR	$DRA
$LINE_ENDING_ZELEMIR_UNSCATHED_220_TEXT	他們在神的周圍可沒容身之地。
$LINE_ENDING_ZELEMIR_UNSCATHED_230_CHAR	$MAG
$LINE_ENDING_ZELEMIR_UNSCATHED_230_TEXT	……謝謝你……
$LINE_ENDING_ZELEMIR_UNSCATHED_240_CHAR	$DRA
$LINE_ENDING_ZELEMIR_UNSCATHED_240_TEXT	什麼？你誤會了，人類！那是命令！
$LINE_ENDING_ZELEMIR_UNSCATHED_250_CHAR	$DRA
$LINE_ENDING_ZELEMIR_UNSCATHED_250_TEXT	馬上把這些討厭的東西拿開！
$LINE_ENDING_ZELEMIR_UNSCATHED_260_CHAR	$MCG
$LINE_ENDING_ZELEMIR_UNSCATHED_260_TEXT	當然，大人。
$LINE_ENDING_ZELEMIR_UNSCATHED_270_CHAR	$MCG
$LINE_ENDING_ZELEMIR_UNSCATHED_270_TEXT	……那麼，你現在要做什麼？
$LINE_ENDING_ZELEMIR_UNSCATHED_280_CHAR	$DRA
$LINE_ENDING_ZELEMIR_UNSCATHED_280_TEXT	我已經受夠了凡人所做的愚行。
$LINE_ENDING_ZELEMIR_UNSCATHED_290_CHAR	$DRA
$LINE_ENDING_ZELEMIR_UNSCATHED_290_TEXT	我要回到我的種族中去……
$LINE_ENDING_ZELEMIR_UNSCATHED_300_CHAR	$DRA
$LINE_ENDING_ZELEMIR_UNSCATHED_300_TEXT	我得找個伴侶教我的孩子。
$LINE_ENDING_ZELEMIR_UNSCATHED_310_CHAR	$DRA
$LINE_ENDING_ZELEMIR_UNSCATHED_310_TEXT	這些殘廢的翅膀，無法傳遞飛行的榮耀了。
$LINE_ENDING_ZELEMIR_UNSCATHED_320_CHAR	$MAG
$LINE_ENDING_ZELEMIR_UNSCATHED_320_TEXT	再見，大人。願你永遠能感覺到火焰的溫暖。
$LINE_ENDING_ZELEMIR_UNSCATHED_330_CHAR	$DRA
$LINE_ENDING_ZELEMIR_UNSCATHED_330_TEXT	也祝福你……
$LINE_ENDING_ZELEMIR_UNSCATHED_340_CHAR	$MAG
$LINE_ENDING_ZELEMIR_UNSCATHED_340_TEXT	……火焰之子，我錯怪你了。
$LINE_ENDING_ZELEMIR_UNSCATHED_350_CHAR	$MCG
$LINE_ENDING_ZELEMIR_UNSCATHED_350_TEXT	她剛剛是不是……？
$LINE_ENDING_ZELEMIR_UNSCATHED_360_CHAR	$MAG
$LINE_ENDING_ZELEMIR_UNSCATHED_360_TEXT	好吧，我們不會再挨餓了，那是肯定的。
$LINE_ENDING_ZELEMIR_UNSCATHED_370_CHAR	$MCG
$LINE_ENDING_ZELEMIR_UNSCATHED_370_TEXT	長老，你願意跟我們一起回去麼？
$LINE_ENDING_ZELEMIR_UNSCATHED_380_CHAR	$HEA
$LINE_ENDING_ZELEMIR_UNSCATHED_380_TEXT	我不知道……
$LINE_ENDING_ZELEMIR_UNSCATHED_390_CHAR	$HEA
$LINE_ENDING_ZELEMIR_UNSCATHED_390_TEXT	看到這一天，可真是苦樂參半。
$LINE_ENDING_ZELEMIR_UNSCATHED_400_CHAR	$HEA
$LINE_ENDING_ZELEMIR_UNSCATHED_400_TEXT	我……我從來沒打算活這麼久。
$LINE_ENDING_ZELEMIR_UNSCATHED_410_CHAR	$MCG
$LINE_ENDING_ZELEMIR_UNSCATHED_410_TEXT	或許你的償還不是一時的，而是一生。
$LINE_ENDING_ZELEMIR_UNSCATHED_420_CHAR	$HEA
$LINE_ENDING_ZELEMIR_UNSCATHED_420_TEXT	*……你擁有超越年齡的指揮，$MCG。
$LINE_ENDING_ZELEMIR_UNSCATHED_430_CHAR	$HEA
$LINE_ENDING_ZELEMIR_UNSCATHED_430_TEXT	世界仍有苦難和吵鬧……
$LINE_ENDING_ZELEMIR_UNSCATHED_440_CHAR	$HEA
$LINE_ENDING_ZELEMIR_UNSCATHED_440_TEXT	同樣，瑟連裡也有很多機會。
$LINE_ENDING_ZELEMIR_UNSCATHED_450_CHAR	$HEA
$LINE_ENDING_ZELEMIR_UNSCATHED_450_TEXT	*但是，你怎麼辦，$MCG？你能回到圖書館麼？
$LINE_ENDING_ZELEMIR_UNSCATHED_460_CHAR	$MCG
$LINE_ENDING_ZELEMIR_UNSCATHED_460_TEXT	我在圖書館的舊生活對於這些冒險經歷而言是個很受歡迎的避難所。
$LINE_ENDING_ZELEMIR_UNSCATHED_470_CHAR	$MCG
$LINE_ENDING_ZELEMIR_UNSCATHED_470_TEXT	而且失去了我的……力量……感覺很奇怪……
$LINE_ENDING_ZELEMIR_UNSCATHED_480_CHAR	$MCG
$LINE_ENDING_ZELEMIR_UNSCATHED_480_TEXT	我很高興能再次感覺到我自己。
$LINE_ENDING_ZELEMIR_UNSCATHED_490_CHAR	$HEA
$LINE_ENDING_ZELEMIR_UNSCATHED_490_TEXT	是的……我一直很想知道這種奇怪的能力是來自哪裡。
$LINE_ENDING_ZELEMIR_UNSCATHED_500_CHAR	$HEA
$LINE_ENDING_ZELEMIR_UNSCATHED_500_TEXT	我相信當艾斯裡-特諾奇試圖腐化你的時候，他將自己精神的一小部分灌注到了你的體內。
$LINE_ENDING_ZELEMIR_UNSCATHED_510_CHAR	$HEA
$LINE_ENDING_ZELEMIR_UNSCATHED_510_TEXT	為了不被腐化，你使用了他的力量來對抗他。
$LINE_ENDING_ZELEMIR_UNSCATHED_520_CHAR	$HEA
$LINE_ENDING_ZELEMIR_UNSCATHED_520_TEXT	現在他死了，魔法也隨他而去。
$LINE_ENDING_ZELEMIR_UNSCATHED_530_CHAR	$MCG
$LINE_ENDING_ZELEMIR_UNSCATHED_530_TEXT	感覺很奇怪，但看見它消失我也並不會覺得難過。
$LINE_ENDING_ZELEMIR_UNSCATHED_540_CHAR	$MCG
$LINE_ENDING_ZELEMIR_UNSCATHED_540_TEXT	此時此刻，簡單的生活是無法想像的奢侈。
$LINE_ENDING_ZELEMIR_UNSCATHED_550_CHAR	$HEA
$LINE_ENDING_ZELEMIR_UNSCATHED_550_TEXT	願我們都能遇見這種奢侈。
$LINE_ENDING_ZELEMIR_UNSCATHED_560_CHAR	$HEA
$LINE_ENDING_ZELEMIR_UNSCATHED_560_TEXT	但是我留你太久了。你的旅程還很長。
$LINE_ENDING_ZELEMIR_UNSCATHED_570_CHAR	$HEA
$LINE_ENDING_ZELEMIR_UNSCATHED_570_TEXT	*再見，$MCG，直到我們再次相見。
$LINE_ENDING_ZELEMIR_UNSCATHED_580_CHAR	$MCG
$LINE_ENDING_ZELEMIR_UNSCATHED_580_TEXT	長老，希望很快能再見。
$LINE_ENDING_ZELEMIR_UNSCATHED_590_CHAR	$MAG
$LINE_ENDING_ZELEMIR_UNSCATHED_590_TEXT	尊敬的長老，我欠你太多了。
$LINE_ENDING_ZELEMIR_UNSCATHED_600_CHAR	$MAG
$LINE_ENDING_ZELEMIR_UNSCATHED_600_TEXT	如果你願意接受我的感激——
$LINE_ENDING_ZELEMIR_UNSCATHED_610_CHAR	$HEA
$LINE_ENDING_ZELEMIR_UNSCATHED_610_TEXT	*$MAG，你的子民比我更需要這個寶物。
$LINE_ENDING_ZELEMIR_UNSCATHED_620_CHAR	$MAG
$LINE_ENDING_ZELEMIR_UNSCATHED_620_TEXT	那麼請接受我的邀請。當火焰大廳再次燃燒的時候，過來看看我們。
$LINE_ENDING_ZELEMIR_UNSCATHED_630_CHAR	$MAG
$LINE_ENDING_ZELEMIR_UNSCATHED_630_TEXT	或許你那種瑟林達的智慧將使宇宙之焰越燃越旺。
$LINE_ENDING_ZELEMIR_UNSCATHED_640_CHAR	$HEA
$LINE_ENDING_ZELEMIR_UNSCATHED_640_TEXT	我很榮幸，火的女兒。
$LINE_ENDING_ZELEMIR_UNSCATHED_650_CHAR	$HEA
$LINE_ENDING_ZELEMIR_UNSCATHED_650_TEXT	我現在必須走了。遵從瑟林達的道路正在召喚我去歷經苦難。
$LINE_ENDING_ZELEMIR_UNSCATHED_660_CHAR	$HEA
$LINE_ENDING_ZELEMIR_UNSCATHED_660_TEXT	但是我們還會再見。
$LINE_ENDING_ZELEMIR_UNSCATHED_670_CHAR	$MAG
$LINE_ENDING_ZELEMIR_UNSCATHED_670_TEXT	再見，尊敬的長老。願你永遠能感覺到火焰的溫暖。
$LINE_ENDING_ZELEMIR_UNSCATHED_680_CHAR	$MAG
$LINE_ENDING_ZELEMIR_UNSCATHED_680_TEXT	*$MCG。
$LINE_ENDING_ZELEMIR_UNSCATHED_690_CHAR	$MCG
$LINE_ENDING_ZELEMIR_UNSCATHED_690_TEXT	*$MAG。
$LINE_ENDING_ZELEMIR_UNSCATHED_700_CHAR	$MAG
$LINE_ENDING_ZELEMIR_UNSCATHED_700_TEXT	你確定沒有我們你會很好？
$LINE_ENDING_ZELEMIR_UNSCATHED_710_CHAR	$MAG
$LINE_ENDING_ZELEMIR_UNSCATHED_710_TEXT	沒有奎德勢力，我很擔心你的安全。
$LINE_ENDING_ZELEMIR_UNSCATHED_720_CHAR	$MAG
$LINE_ENDING_ZELEMIR_UNSCATHED_720_TEXT	到艾殊還有很長的路要走。
$LINE_ENDING_ZELEMIR_UNSCATHED_730_CHAR	$MAG
$LINE_ENDING_ZELEMIR_UNSCATHED_730_TEXT	土匪，狼群，或者可能是輕微的一陣風都能將你摧毀。
$LINE_ENDING_ZELEMIR_UNSCATHED_740_CHAR	$MCG
$LINE_ENDING_ZELEMIR_UNSCATHED_740_TEXT	那你怎麼辦？你也沒有力量了。
$LINE_ENDING_ZELEMIR_UNSCATHED_750_CHAR	$MAG
$LINE_ENDING_ZELEMIR_UNSCATHED_750_TEXT	我是奎德公主，生來就手握利劍！
$LINE_ENDING_ZELEMIR_UNSCATHED_760_CHAR	$MAG
$LINE_ENDING_ZELEMIR_UNSCATHED_760_TEXT	我一直都在練習戰爭之術。
$LINE_ENDING_ZELEMIR_UNSCATHED_770_CHAR	$MAG
$LINE_ENDING_ZELEMIR_UNSCATHED_770_TEXT	儘管冰霜……很有用……但當看見它離開了我的心，我還是很高興。
$LINE_ENDING_ZELEMIR_UNSCATHED_780_CHAR	$MAG
$LINE_ENDING_ZELEMIR_UNSCATHED_780_TEXT	我們將把一直以來的榮耀帶回給火焰：用劍和弓和軍隊的力量！
$LINE_ENDING_ZELEMIR_UNSCATHED_790_CHAR	$MAG
$LINE_ENDING_ZELEMIR_UNSCATHED_790_TEXT	我和剩下的子民將回到家鄉。
$LINE_ENDING_ZELEMIR_UNSCATHED_800_CHAR	$MAG
$LINE_ENDING_ZELEMIR_UNSCATHED_800_TEXT	我們會找到剩餘的世界……
$LINE_ENDING_ZELEMIR_UNSCATHED_810_CHAR	$MAG
$LINE_ENDING_ZELEMIR_UNSCATHED_810_TEXT	然後在那之上，建立一個更偉大的世界。
$LINE_ENDING_ZELEMIR_UNSCATHED_820_CHAR	$MCG
$LINE_ENDING_ZELEMIR_UNSCATHED_820_TEXT	朋友，看見你絲毫未變真是高興。
$LINE_ENDING_ZELEMIR_UNSCATHED_830_CHAR	$MCG
$LINE_ENDING_ZELEMIR_UNSCATHED_830_TEXT	希望你所有的努力都能有好的結果。
$LINE_ENDING_ZELEMIR_UNSCATHED_840_CHAR	$MAG
$LINE_ENDING_ZELEMIR_UNSCATHED_840_TEXT	也祝願你，火焰之友。
$LINE_ENDING_ZELEMIR_UNSCATHED_850_CHAR	$MAG
$LINE_ENDING_ZELEMIR_UNSCATHED_850_TEXT	希望我們會再次相見。
$LINE_ENDING_ZELEMIR_UNSCATHED_860_CHAR	$MCG
$LINE_ENDING_ZELEMIR_UNSCATHED_860_TEXT	再見！
$LINE_ENDING_ZELEMIR_UNSCATHED_870_CHAR	$BER
$LINE_ENDING_ZELEMIR_UNSCATHED_870_TEXT	喲。
$LINE_ENDING_ZELEMIR_UNSCATHED_880_CHAR	$MCG
$LINE_ENDING_ZELEMIR_UNSCATHED_880_TEXT	*所以你的計畫是什麼，$BER？
$LINE_ENDING_ZELEMIR_UNSCATHED_890_CHAR	$MCG
$LINE_ENDING_ZELEMIR_UNSCATHED_890_TEXT	你會和我們一起回到艾殊嗎？
$LINE_ENDING_ZELEMIR_UNSCATHED_900_CHAR	$BER
$LINE_ENDING_ZELEMIR_UNSCATHED_900_TEXT	你在開玩笑嗎？過上有錢又奢侈的生活？
$LINE_ENDING_ZELEMIR_UNSCATHED_910_CHAR	$BER
$LINE_ENDING_ZELEMIR_UNSCATHED_910_TEXT	現在還不行，因為還有殺戮要進行！
$LINE_ENDING_ZELEMIR_UNSCATHED_920_CHAR	$BER
$LINE_ENDING_ZELEMIR_UNSCATHED_920_TEXT	我一直在和諾曼難民聊天，他們告訴我遙遠的北邊有個怪獸叫做“岩石之眼”！
$LINE_ENDING_ZELEMIR_UNSCATHED_930_CHAR	$BER
$LINE_ENDING_ZELEMIR_UNSCATHED_930_TEXT	他有大概，七個腦袋，每個腦袋上有七隻眼睛！
$LINE_ENDING_ZELEMIR_UNSCATHED_940_CHAR	$BER
$LINE_ENDING_ZELEMIR_UNSCATHED_940_TEXT	我可從來沒有讓七個腦袋的東西身首異處過！
$LINE_ENDING_ZELEMIR_UNSCATHED_950_CHAR	$BER
$LINE_ENDING_ZELEMIR_UNSCATHED_950_TEXT	而且，那之後我可以向東走，把血腥邪教徒打得屁滾尿流！
$LINE_ENDING_ZELEMIR_UNSCATHED_960_CHAR	$BER
$LINE_ENDING_ZELEMIR_UNSCATHED_960_TEXT	我只需要三個以上的浴血的斗篷來完成我的……
$LINE_ENDING_ZELEMIR_UNSCATHED_970_CHAR	$BER
$LINE_ENDING_ZELEMIR_UNSCATHED_970_TEXT	……史詩暴力頭巾！
$LINE_ENDING_ZELEMIR_UNSCATHED_980_CHAR	$MCG
$LINE_ENDING_ZELEMIR_UNSCATHED_980_TEXT	看到你有個計畫，我很高興。
$LINE_ENDING_ZELEMIR_UNSCATHED_990_CHAR	$BER
$LINE_ENDING_ZELEMIR_UNSCATHED_990_TEXT	但是看看我，在這個世界隨時都可能發生暴力的時候還在聊天！
$LINE_ENDING_ZELEMIR_UNSCATHED_1000_CHAR	$MCG
$LINE_ENDING_ZELEMIR_UNSCATHED_1000_TEXT	保持聯繫！
$LINE_ENDING_ZELEMIR_UNSCATHED_1010_CHAR	$MCG
$LINE_ENDING_ZELEMIR_UNSCATHED_1010_TEXT	我想我幾乎已經開始想念他了。
$LINE_ENDING_ZELEMIR_UNSCATHED_1020_CHAR	$RAN
$LINE_ENDING_ZELEMIR_UNSCATHED_1020_TEXT	嘿。
$LINE_ENDING_ZELEMIR_UNSCATHED_1030_CHAR	$MCG
$LINE_ENDING_ZELEMIR_UNSCATHED_1030_TEXT	嘿。我以為你和諾曼人一起走了呢？
$LINE_ENDING_ZELEMIR_UNSCATHED_1040_CHAR	$RAN
$LINE_ENDING_ZELEMIR_UNSCATHED_1040_TEXT	不……我還是決定不去了。
$LINE_ENDING_ZELEMIR_UNSCATHED_1050_CHAR	$RAN
$LINE_ENDING_ZELEMIR_UNSCATHED_1050_TEXT	我只是……
$LINE_ENDING_ZELEMIR_UNSCATHED_1060_CHAR	$RAN
$LINE_ENDING_ZELEMIR_UNSCATHED_1060_TEXT	世界大著呢。
$LINE_ENDING_ZELEMIR_UNSCATHED_1070_CHAR	$RAN
$LINE_ENDING_ZELEMIR_UNSCATHED_1070_TEXT	或許有其他革卡人還活著。
$LINE_ENDING_ZELEMIR_UNSCATHED_1080_CHAR	$RAN
$LINE_ENDING_ZELEMIR_UNSCATHED_1080_TEXT	如果是這樣，那他們肯定需要一切説明。
$LINE_ENDING_ZELEMIR_UNSCATHED_1090_CHAR	$RAN
$LINE_ENDING_ZELEMIR_UNSCATHED_1090_TEXT	或者我只是要，你知道的，去遊蕩一會兒。
$LINE_ENDING_ZELEMIR_UNSCATHED_1100_CHAR	$MCG
$LINE_ENDING_ZELEMIR_UNSCATHED_1100_TEXT	*……我想$BER正在尋求冒險。
$LINE_ENDING_ZELEMIR_UNSCATHED_1110_CHAR	$RAN
$LINE_ENDING_ZELEMIR_UNSCATHED_1110_TEXT	真的麼？他……呃……
$LINE_ENDING_ZELEMIR_UNSCATHED_1120_CHAR	$RAN
$LINE_ENDING_ZELEMIR_UNSCATHED_1120_TEXT	他是是個還可以接受的戰友。
$LINE_ENDING_ZELEMIR_UNSCATHED_1130_CHAR	$RAN
$LINE_ENDING_ZELEMIR_UNSCATHED_1130_TEXT	而且他還欠我錢……
$LINE_ENDING_ZELEMIR_UNSCATHED_1140_CHAR	$MCG
$LINE_ENDING_ZELEMIR_UNSCATHED_1140_TEXT	他向那邊去了。
$LINE_ENDING_ZELEMIR_UNSCATHED_1150_CHAR	$RAN
$LINE_ENDING_ZELEMIR_UNSCATHED_1150_TEXT	*謝謝你，$MCG。
$LINE_ENDING_ZELEMIR_UNSCATHED_1160_CHAR	$MCG
$LINE_ENDING_ZELEMIR_UNSCATHED_1160_TEXT	隨時找我。
$LINE_ENDING_ZELEMIR_UNSCATHED_1170_CHAR	$KNI
$LINE_ENDING_ZELEMIR_UNSCATHED_1170_TEXT	女士。
$LINE_ENDING_ZELEMIR_UNSCATHED_1180_CHAR	$MCG
$LINE_ENDING_ZELEMIR_UNSCATHED_1180_TEXT	*$KNI。
$LINE_ENDING_ZELEMIR_UNSCATHED_1190_CHAR	$KNI
$LINE_ENDING_ZELEMIR_UNSCATHED_1190_TEXT	艾殊難民準備好隨時跟你離開。
$LINE_ENDING_ZELEMIR_UNSCATHED_1200_CHAR	$MCG
$LINE_ENDING_ZELEMIR_UNSCATHED_1200_TEXT	*你呢，$KNI？你想回到首都麼？
$LINE_ENDING_ZELEMIR_UNSCATHED_1210_CHAR	$KNI
$LINE_ENDING_ZELEMIR_UNSCATHED_1210_TEXT	這是我的子民。而且，我的債務依然束縛著我，女士。
$LINE_ENDING_ZELEMIR_UNSCATHED_1220_CHAR	$KNI
$LINE_ENDING_ZELEMIR_UNSCATHED_1220_TEXT	我會一直陪著你，直到我償清債務。
$LINE_ENDING_ZELEMIR_UNSCATHED_1230_CHAR	$MCG
$LINE_ENDING_ZELEMIR_UNSCATHED_1230_TEXT	朋友，你的債務已經償清。我會遵守諾言，還你自由。
$LINE_ENDING_ZELEMIR_UNSCATHED_1240_CHAR	$KNI
$LINE_ENDING_ZELEMIR_UNSCATHED_1240_TEXT	那麼我能以朋友的身份陪著你麼？
$LINE_ENDING_ZELEMIR_UNSCATHED_1250_CHAR	$MCG
$LINE_ENDING_ZELEMIR_UNSCATHED_1250_TEXT	這一路上會有很多危險。我很——我們都很高興你能跟我們一起。
$LINE_ENDING_ZELEMIR_UNSCATHED_1260_CHAR	$KNI
$LINE_ENDING_ZELEMIR_UNSCATHED_1260_TEXT	我也很高興和他們一起。
$LINE_ENDING_ZELEMIR_UNSCATHED_1270_CHAR	$KNI
$LINE_ENDING_ZELEMIR_UNSCATHED_1270_TEXT	你知道的……
$LINE_ENDING_ZELEMIR_UNSCATHED_1280_CHAR	$KNI
$LINE_ENDING_ZELEMIR_UNSCATHED_1280_TEXT	……路上沒有人想著要殺我們，可真的是很奇怪又好無聊。
$LINE_ENDING_ZELEMIR_UNSCATHED_1290_CHAR	$MCG
$LINE_ENDING_ZELEMIR_UNSCATHED_1290_TEXT	好吧，我敢打賭<LQ>醉虎<RQ>歌可以用來消磨時間了……
$LINE_ENDING_ZELEMIR_UNSCATHED_1300_CHAR	$KNI
$LINE_ENDING_ZELEMIR_UNSCATHED_1300_TEXT	想法很不錯，但是我既然現在不再負債於你，那麼就不需要再聽從這些愚蠢的建議了，我恐怕我會很忙。
$LINE_ENDING_ZELEMIR_UNSCATHED_1310_CHAR	$MCG
$LINE_ENDING_ZELEMIR_UNSCATHED_1310_TEXT	真的嗎？因為我有一大堆愚蠢的建議呢。
$LINE_ENDING_ZELEMIR_UNSCATHED_1320_CHAR	$MCG
$LINE_ENDING_ZELEMIR_UNSCATHED_1320_TEXT	鑒於我們不喜歡聽醉虎歌，我也不得不重溫一下，自娛自樂了。
$LINE_ENDING_ZELEMIR_UNSCATHED_1330_CHAR	$MCG
$LINE_ENDING_ZELEMIR_UNSCATHED_1330_TEXT	一：不要穿紫色裙子。之前我是穿的紫色裙子，比你穿的好看。
$LINE_ENDING_ZELEMIR_UNSCATHED_1340_CHAR	$KNI
$LINE_ENDING_ZELEMIR_UNSCATHED_1340_TEXT	嘿！
$LINE_ENDING_ZELEMIR_UNSCATHED_1350_CHAR	$MCG
$LINE_ENDING_ZELEMIR_UNSCATHED_1350_TEXT	二：把蜜袋鼯放在兩鬢，因為，嘿，誰不喜歡蜜袋鼯？他們可以攻擊任何一個激怒自己的人。
$LINE_ENDING_ZELEMIR_UNSCATHED_1360_CHAR	$MCG
$LINE_ENDING_ZELEMIR_UNSCATHED_1360_TEXT	三：為蜜袋鼯的左右手起名字，但是將其放在兩鬢的相反方向以混淆敵人。
$LINE_ENDING_ZELEMIR_UNSCATHED_1370_CHAR	$KNI
$LINE_ENDING_ZELEMIR_UNSCATHED_1370_TEXT	*你在$BER身邊待太久了。
$LINE_ENDING_ZELEMIR_UNSCATHED_1380_CHAR	$MCG
$LINE_ENDING_ZELEMIR_UNSCATHED_1380_TEXT	順便說一句，我已經有幾百首這樣的歌呢，去艾殊還有很長的路要走。
$LINE_ENDING_ZELEMIR_UNSCATHED_1390_CHAR	$KNI
$LINE_ENDING_ZELEMIR_UNSCATHED_1390_TEXT	……
$LINE_ENDING_ZELEMIR_UNSCATHED_1400_CHAR	$KNI
$LINE_ENDING_ZELEMIR_UNSCATHED_1400_TEXT	“啊，我是一隻醉醉虎……”
$LINE_ENDING_ZELEMIR_UNSCATHED_1410_CHAR	$MCG
$LINE_ENDING_ZELEMIR_UNSCATHED_1410_TEXT	好了，現在開始單腳並且用假聲！
$SCENE_EPILOGUE_TITLE	秘密尾聲
$LINE_EPILOGUE_00_CHAR	$KNI
$LINE_EPILOGUE_00_TEXT	……<LQ>醉虎<RQ>歌就是這樣的。
$LINE_EPILOGUE_10_CHAR	$MCG
$LINE_EPILOGUE_10_TEXT	真令人印象深刻……我都不知道你的音域……如此之廣……
$LINE_EPILOGUE_20_CHAR	$MCG
$LINE_EPILOGUE_20_TEXT	我是說，我想我是無法唱出這樣的高音的。
$LINE_EPILOGUE_30_CHAR	$KNI
$LINE_EPILOGUE_30_TEXT	這是成為太監的好處之一。
$LINE_EPILOGUE_40_CHAR	$MCG
$LINE_EPILOGUE_40_TEXT	什麼？！
$LINE_EPILOGUE_50_CHAR	$KNI
$LINE_EPILOGUE_50_TEXT	只是嚇唬嚇唬你。
$LINE_EPILOGUE_60_CHAR	$MCG
$LINE_EPILOGUE_60_TEXT	哇……這真的……有很多事我得重新想想……
$LINE_EPILOGUE_70_CHAR	$KNI
$LINE_EPILOGUE_70_TEXT	想哪些——
$LINE_EPILOGUE_80_CHAR	$BER
$LINE_EPILOGUE_80_TEXT	喲！
$LINE_EPILOGUE_90_CHAR	$MCG
$LINE_EPILOGUE_90_TEXT	*$BER？$RAN？你們在這裡幹什麼？
$LINE_EPILOGUE_100_CHAR	$BER
$LINE_EPILOGUE_100_TEXT	好吧，最終證明<LQ>岩石之眼<RQ>是個容易控制的傢伙！一擊便可殺了他！
$LINE_EPILOGUE_110_CHAR	$RAN
$LINE_EPILOGUE_110_TEXT	拿上這個，他就只有五個腦袋了！
$LINE_EPILOGUE_120_CHAR	$BER
$LINE_EPILOGUE_120_TEXT	我知道！我感覺上當受騙了！
$LINE_EPILOGUE_130_CHAR	$RAN
$LINE_EPILOGUE_130_TEXT	不管怎樣，我們對著一些邪教徒歡呼起來了——
$LINE_EPILOGUE_140_CHAR	$BER
$LINE_EPILOGUE_140_TEXT	夥計，這些傢伙現在一定很難過！
$LINE_EPILOGUE_150_CHAR	$RAN
$LINE_EPILOGUE_150_TEXT	——但是我們聽說寶石是<LQ>龍眼<RQ>。一些食人魔把它鎖在滿是巨蛇的塔里。
$LINE_EPILOGUE_160_CHAR	$BER
$LINE_EPILOGUE_160_TEXT	拿上這個，食人魔有七個……
$LINE_EPILOGUE_170_CHAR	$RAN
$LINE_EPILOGUE_170_TEXT	他們不想知道那些！
$LINE_EPILOGUE_180_CHAR	$BER
$LINE_EPILOGUE_180_TEXT	我只是說，它會弄些奇怪的戰利品。
$LINE_EPILOGUE_190_CHAR	$RAN
$LINE_EPILOGUE_190_TEXT	不管怎樣，我們就是恰好經過，覺得應該過來打聲招呼。
$LINE_EPILOGUE_200_CHAR	$MCG
$LINE_EPILOGUE_200_TEXT	……只過了四天……
$LINE_EPILOGUE_210_CHAR	$BER
$LINE_EPILOGUE_210_TEXT	哦，這倒提醒我了，當你到達艾殊時，你能把這封信給我爸爸嗎？
$LINE_EPILOGUE_220_CHAR	$BER
$LINE_EPILOGUE_220_TEXT	他以為我還在北方的城裡學習呢，所以別說墓坑的事。
$LINE_EPILOGUE_230_CHAR	$BER
$LINE_EPILOGUE_230_TEXT	他要是知道了，可能會很生氣，然後流放別人什麼的。
$LINE_EPILOGUE_240_CHAR	$KNI
$LINE_EPILOGUE_240_TEXT	流放？
$LINE_EPILOGUE_250_CHAR	$MCG
$LINE_EPILOGUE_250_TEXT	你爸爸是誰？
$LINE_EPILOGUE_260_CHAR	$BER
$LINE_EPILOGUE_260_TEXT	哦，攝政王。
$LINE_EPILOGUE_270_CHAR	$RAN
$LINE_EPILOGUE_270_TEXT	真的？你們都不知道？
$LINE_EPILOGUE_280_CHAR	$BER
$LINE_EPILOGUE_280_TEXT	夥計，我真的很高興在我能接管之前太子已經適齡了。光是想像一下要管理一個國家，我的腦袋就要爆炸了……
$LINE_EPILOGUE_281_CHAR	$BER
$LINE_EPILOGUE_281_CHAR	那有什麼意思啊？我更願意把別人的腦袋弄爆炸！
$LINE_EPILOGUE_290_CHAR	$RAN
$LINE_EPILOGUE_290_TEXT	別告訴他們我們走哪條路，好嗎？
$LINE_EPILOGUE_300_CHAR	$BER
$LINE_EPILOGUE_300_TEXT	好吧，聊得不錯，但是我們必須從食人魔那里弄個戰利品——
$LINE_EPILOGUE_310_CHAR	$RAN
$LINE_EPILOGUE_310_TEXT	他們不想知道那些！
$LINE_EPILOGUE_320_CHAR	$BER
$LINE_EPILOGUE_320_TEXT	現在前進吧！來點暴力！
$LINE_EPILOGUE_330_CHAR	$KNI
$LINE_EPILOGUE_330_TEXT	……
$LINE_EPILOGUE_340_CHAR	$MCG
$LINE_EPILOGUE_340_TEXT	我完全同意。
$SCENE_SIDEQUEST_1_GET_TITLE	你瘋了麼？
$LINE_SIDEQUEST_1_GET_00_CHAR	$RAN
$LINE_SIDEQUEST_1_GET_00_TEXT	*嘿，$MCG！這個骯髒的卡萊斯卡人不會賣東西給我們的。
$LINE_SIDEQUEST_1_GET_10_CHAR	$RAN
$LINE_SIDEQUEST_1_GET_10_TEXT	你要是問我，我就會說，他是在妒忌革卡人天生的優越性。
$LINE_SIDEQUEST_1_GET_20_CHAR	$MCG
$LINE_SIDEQUEST_1_GET_20_TEXT	額……除了你，我們其他人都不是革卡人……
$LINE_SIDEQUEST_1_GET_30_CHAR	$RAN
$LINE_SIDEQUEST_1_GET_30_TEXT	大概在五分鐘前，我已經讓你成為名譽會員。
$LINE_SIDEQUEST_1_GET_40_CHAR	$RAN
$LINE_SIDEQUEST_1_GET_40_TEXT	所以，我的革卡姐妹，你能使用瘋狂的瘟疫魔法，融化他的臉什麼的嗎？
$LINE_SIDEQUEST_1_GET_50_CHAR	$MCG
$LINE_SIDEQUEST_1_GET_50_TEXT	我不想融化任何人的臉。
$LINE_SIDEQUEST_1_GET_60_CHAR	$MCG
$LINE_SIDEQUEST_1_GET_60_TEXT	一，我甚至不知道該怎麼使用；二，你到底有什麼毛病？
$LINE_SIDEQUEST_1_GET_70_CHAR	$RAN
$LINE_SIDEQUEST_1_GET_70_TEXT	他是卡萊斯卡部落的，如果我們不管他，我們九十在唾棄四百年的世仇傳統。
$LINE_SIDEQUEST_1_GET_80_CHAR	$BER
$LINE_SIDEQUEST_1_GET_80_TEXT	有人說要融化臉麼？
$LINE_SIDEQUEST_1_GET_90_CHAR	$BER
$LINE_SIDEQUEST_1_GET_90_TEXT	給我目標！我將只會注意到我閃閃發光的腹肌和……
$LINE_SIDEQUEST_1_GET_100_CHAR	$BER
$LINE_SIDEQUEST_1_GET_100_TEXT	看啊……我能看到他已經很虛弱了。
$LINE_SIDEQUEST_1_GET_110_CHAR	$RAN
$LINE_SIDEQUEST_1_GET_110_TEXT	……好吧，所以計畫二：你引誘他，使他分心，然後我潛入進去盡可能多的偷些東西。
$LINE_SIDEQUEST_1_GET_120_CHAR	$MCG
$LINE_SIDEQUEST_1_GET_120_TEXT	什麼？不。呃。
$LINE_SIDEQUEST_1_GET_130_CHAR	$RAN
$LINE_SIDEQUEST_1_GET_130_TEXT	你說的對，你應該幹些更漂亮的工作。
$LINE_SIDEQUEST_1_GET_140_CHAR	$RAN
$LINE_SIDEQUEST_1_GET_140_TEXT	好吧，計畫三：趁沒人注意的時候殺了他。
$LINE_SIDEQUEST_1_GET_150_CHAR	$MCG
$LINE_SIDEQUEST_1_GET_150_TEXT	難道你不能告訴他我們是來解放大家的嗎？
$LINE_SIDEQUEST_1_GET_160_CHAR	$RAN
$LINE_SIDEQUEST_1_GET_160_TEXT	啊，我試過了。他只是一直在說監獄下面的墓穴裡被困住的那些孩子。
$LINE_SIDEQUEST_1_GET_170_CHAR	$RAN
$LINE_SIDEQUEST_1_GET_170_TEXT	看吧，我們沒有別的理由了，讓我們殺了這個卡萊斯卡傻瓜吧。
$LINE_SIDEQUEST_1_GET_180_CHAR	$MCG
$LINE_SIDEQUEST_1_GET_180_TEXT	有孩子被困監獄下面？
$LINE_SIDEQUEST_1_GET_190_CHAR	$RAN
$LINE_SIDEQUEST_1_GET_190_TEXT	是的，很恐怖，但現在關鍵的是殺了這個卑鄙小人，讓我們得到他的那些好東西。
$LINE_SIDEQUEST_1_GET_200_CHAR	$MCG
$LINE_SIDEQUEST_1_GET_200_TEXT	……
$LINE_SIDEQUEST_1_GET_210_CHAR	$RAN
$LINE_SIDEQUEST_1_GET_210_TEXT	嘿！等等！你不能就這樣輕易地逃離世仇！
$LINE_SIDEQUEST_1_GET_220_CHAR	$MCG
$LINE_SIDEQUEST_1_GET_220_TEXT	如果你想，你完全可以做個完美的小偷，但是我打算去救孩子們。
$LINE_SIDEQUEST_1_GET_230_CHAR	$RAN
$LINE_SIDEQUEST_1_GET_230_TEXT	你瘋了麼？奧斯蒙的亡者正在追我們呢！
$LINE_SIDEQUEST_1_GET_240_CHAR	$MCG
$LINE_SIDEQUEST_1_GET_240_TEXT	但是我們回到監獄是他們做夢也不會想到的。
$LINE_SIDEQUEST_1_GET_250_CHAR	$RAN
$LINE_SIDEQUEST_1_GET_250_TEXT	是啊 ，因為那太蠢了！
$LINE_SIDEQUEST_1_GET_260_CHAR	$MCG
$LINE_SIDEQUEST_1_GET_260_TEXT	那麼待這別動。
$LINE_SIDEQUEST_1_GET_270_CHAR	$RAN
$LINE_SIDEQUEST_1_GET_270_TEXT	什麼？你是我的逃跑計畫，我不會讓你離開我的視線！
$LINE_SIDEQUEST_1_GET_280_CHAR	$RAN
$LINE_SIDEQUEST_1_GET_280_TEXT	……我要抱怨這條路上的每一步。
$SCENE_SIDEQUEST_1_INTRO_TITLE	火中的手
$LINE_SIDEQUEST_1_INTRO_00_CHAR	$RAN
$LINE_SIDEQUEST_1_INTRO_00_TEXT	啊，看，我們剛剛就是從那間充滿僵屍的牢房裡逃出來的！
$LINE_SIDEQUEST_1_INTRO_10_CHAR	$RAN
$LINE_SIDEQUEST_1_INTRO_10_TEXT	好的，那麼讓我來把事情搞清楚：我們剛剛把手從火中拿出來了……
$LINE_SIDEQUEST_1_INTRO_20_CHAR	$RAN
$LINE_SIDEQUEST_1_INTRO_20_TEXT	 而我們現在就像是<LQ>喔，看，有亮閃閃的東西！讓我們再把手神回去吧！<RQ>
$LINE_SIDEQUEST_1_INTRO_30_CHAR	$RAN
$LINE_SIDEQUEST_1_INTRO_30_TEXT	也許這並未發生在你們身上，但是——
$LINE_SIDEQUEST_1_INTRO_40_CHAR	$MCG
$LINE_SIDEQUEST_1_INTRO_40_TEXT	讓我來把事情說清楚：你是真的在抱怨去救孩子？
$LINE_SIDEQUEST_1_INTRO_50_CHAR	$MCG
$LINE_SIDEQUEST_1_INTRO_50_TEXT	我明白，你抱怨是你的事情，但是是真的嗎？孩子？
$LINE_SIDEQUEST_1_INTRO_60_CHAR	$RAN
$LINE_SIDEQUEST_1_INTRO_60_TEXT	那不是我說的。我根本沒這麼說——
$LINE_SIDEQUEST_1_INTRO_70_CHAR	$MCG
$LINE_SIDEQUEST_1_INTRO_70_TEXT	你討厭孩子？
$LINE_SIDEQUEST_1_INTRO_80_CHAR	$RAN
$LINE_SIDEQUEST_1_INTRO_80_TEXT	你知道，我真的很討厭你污蔑我。
$LINE_SIDEQUEST_1_INTRO_90_CHAR	$MCG
$LINE_SIDEQUEST_1_INTRO_90_TEXT	污蔑你就像把水倒進噴泉裡一樣。
$LINE_SIDEQUEST_1_INTRO_100_CHAR	$BER
$LINE_SIDEQUEST_1_INTRO_100_TEXT	打架啦，大家！打架啦！
$LINE_SIDEQUEST_1_INTRO_110_CHAR	$BER
$LINE_SIDEQUEST_1_INTRO_110_TEXT	我用一雙靴子和一把生銹的刀賭漂亮的那一個會贏。
$LINE_SIDEQUEST_1_INTRO_120_CHAR	$MCG
$LINE_SIDEQUEST_1_INTRO_120_TEXT	……
$LINE_SIDEQUEST_1_INTRO_130_CHAR	$BER
$LINE_SIDEQUEST_1_INTRO_130_TEXT	啊，這路上也有一堆亡者。
$LINE_SIDEQUEST_1_INTRO_140_CHAR	$MCG
$LINE_SIDEQUEST_1_INTRO_140_TEXT	漂亮。
$SCENE_SIDEQUEST_1_OUTRO_TITLE	實際世仇
$LINE_SIDEQUEST_1_OUTRO_00_CHAR	$BER
$LINE_SIDEQUEST_1_OUTRO_00_TEXT	沒有人想領教我的憤怒了麼？
$LINE_SIDEQUEST_1_OUTRO_10_CHAR	$BER
$LINE_SIDEQUEST_1_OUTRO_10_TEXT	<LQ>沒有，我們真的都領教夠了。<RQ>
$LINE_SIDEQUEST_1_OUTRO_20_CHAR	$BER
$LINE_SIDEQUEST_1_OUTRO_20_TEXT	是嗎？是嗎？！
$LINE_SIDEQUEST_1_OUTRO_30_CHAR	$BER
$LINE_SIDEQUEST_1_OUTRO_30_TEXT	嗯，是的，我想就是你剛剛說的。
$LINE_SIDEQUEST_1_OUTRO_40_CHAR	罪犯
$LINE_SIDEQUEST_1_OUTRO_40_TEXT	抱歉，瘋子，但是剛剛發生什麼了呢？
$LINE_SIDEQUEST_1_OUTRO_50_CHAR	$BER
$LINE_SIDEQUEST_1_OUTRO_50_TEXT	他們全不見了！就像 <LQ>喲，我們要把你搞得一團糟！<RQ>
$LINE_SIDEQUEST_1_OUTRO_60_CHAR	$BER
$LINE_SIDEQUEST_1_OUTRO_60_TEXT	……然後我就像這樣，<LQ>我不這麼想，邪惡的朋友！<RQ>
$LINE_SIDEQUEST_1_OUTRO_70_CHAR	$BER
$LINE_SIDEQUEST_1_OUTRO_70_TEXT	然後我的二頭肌就都<LQ>嘣！砰！<RQ>然後——
$LINE_SIDEQUEST_1_OUTRO_80_CHAR	$BER
$LINE_SIDEQUEST_1_OUTRO_80_TEXT	哦，嘿！你肯定是我們要救的罪犯！
$LINE_SIDEQUEST_1_OUTRO_90_CHAR	罪犯
$LINE_SIDEQUEST_1_OUTRO_90_TEXT	救？你是說你不是奧斯蒙的人？
$LINE_SIDEQUEST_1_OUTRO_100_CHAR	$BER
$LINE_SIDEQUEST_1_OUTRO_100_TEXT	你開玩笑嗎？我才不會為那樣的人幹活！
$LINE_SIDEQUEST_1_OUTRO_110_CHAR	$BER
$LINE_SIDEQUEST_1_OUTRO_110_TEXT	他聞起來就跟乳酪一樣。
$LINE_SIDEQUEST_1_OUTRO_120_CHAR	$BER
$LINE_SIDEQUEST_1_OUTRO_120_TEXT	這就是我的底線。
$LINE_SIDEQUEST_1_OUTRO_130_CHAR	罪犯
$LINE_SIDEQUEST_1_OUTRO_130_TEXT	所以我們可以走了？我都不明白發生了什麼。
$LINE_SIDEQUEST_1_OUTRO_140_CHAR	$BER
$LINE_SIDEQUEST_1_OUTRO_140_TEXT	如果你想知道發生什麼了，你應該去問問別人，而不是我。
$LINE_SIDEQUEST_1_OUTRO_150_CHAR	$MCG
$LINE_SIDEQUEST_1_OUTRO_150_TEXT	我們最好在敵人發現前離開這裡。
$LINE_SIDEQUEST_1_OUTRO_160_CHAR	$MCG
$LINE_SIDEQUEST_1_OUTRO_160_TEXT	其他罪犯的小營地離這不遠。我們可以給你帶路。
$LINE_SIDEQUEST_1_OUTRO_170_CHAR	$MCG
$LINE_SIDEQUEST_1_OUTRO_170_TEXT	我不懂，現在你不想對卡拉斯卡那些傢伙做些什麼嗎？
$LINE_SIDEQUEST_1_OUTRO_180_CHAR	$RAN
$LINE_SIDEQUEST_1_OUTRO_180_TEXT	啊，我的革卡姐妹，你要學的還有很多。
$LINE_SIDEQUEST_1_OUTRO_190_CHAR	$RAN
$LINE_SIDEQUEST_1_OUTRO_190_TEXT	我們從戰爭中得到的東西比他從人們身上壓榨的廢物要好得多。
$LINE_SIDEQUEST_1_OUTRO_200_CHAR	$RAN
$LINE_SIDEQUEST_1_OUTRO_200_TEXT	現在沒有理由要對他做什麼。
$LINE_SIDEQUEST_1_OUTRO_210_CHAR	$MCG
$LINE_SIDEQUEST_1_OUTRO_210_TEXT	但你們是世仇……
$LINE_SIDEQUEST_1_OUTRO_220_CHAR	$RAN
$LINE_SIDEQUEST_1_OUTRO_220_TEXT	*$MCG，傳統是為我們服務的，而不是為了其他。記住，首要任務是生存。
$LINE_SIDEQUEST_1_OUTRO_230_CHAR	$MCG
$LINE_SIDEQUEST_1_OUTRO_230_TEXT	所以世仇就是你為所欲為的藉口？
$LINE_SIDEQUEST_1_OUTRO_240_CHAR	$RAN
$LINE_SIDEQUEST_1_OUTRO_240_TEXT	現在你已經找到竅門了！
$LINE_SIDEQUEST_1_OUTRO_250_CHAR	$RAN
$LINE_SIDEQUEST_1_OUTRO_250_TEXT	所以記住，如果你見到富人，也有更好的理由去討厭他們了。
$SCENE_SIDEQUEST_2_GET_TITLE	恐懼之海
$LINE_SIDEQUEST_2_GET_00_CHAR	$BER
$LINE_SIDEQUEST_2_GET_00_TEXT	嘿，和尚！
$LINE_SIDEQUEST_2_GET_10_CHAR	$HEA
$LINE_SIDEQUEST_2_GET_10_TEXT	嗯，陌生的朋友？
$LINE_SIDEQUEST_2_GET_20_CHAR	$BER
$LINE_SIDEQUEST_2_GET_20_TEXT	我以為你們和尚都可以幫助別人，醫治別人！
$LINE_SIDEQUEST_2_GET_30_CHAR	$HEA
$LINE_SIDEQUEST_2_GET_30_TEXT	好吧，通常是。
$LINE_SIDEQUEST_2_GET_40_CHAR	$BER
$LINE_SIDEQUEST_2_GET_40_TEXT	那麼為什麼你卻想毒死我呢？！
$LINE_SIDEQUEST_2_GET_50_CHAR	$HEA
$LINE_SIDEQUEST_2_GET_50_TEXT	毒死？
$LINE_SIDEQUEST_2_GET_60_CHAR	$BER
$LINE_SIDEQUEST_2_GET_60_TEXT	這食物裡有什麼？
$LINE_SIDEQUEST_2_GET_70_CHAR	$HEA
$LINE_SIDEQUEST_2_GET_70_TEXT	怎麼了？
$LINE_SIDEQUEST_2_GET_80_CHAR	$BER
$LINE_SIDEQUEST_2_GET_80_TEXT	怎麼了？全是……全是地上長出來的東西！
$LINE_SIDEQUEST_2_GET_90_CHAR	$HEA
$LINE_SIDEQUEST_2_GET_90_TEXT	蔬菜？
$LINE_SIDEQUEST_2_GET_100_CHAR	$BER
$LINE_SIDEQUEST_2_GET_100_TEXT	是啊，全都是！
$LINE_SIDEQUEST_2_GET_110_CHAR	$BER
$LINE_SIDEQUEST_2_GET_110_TEXT	*蔬菜無法幫我保持體格！你想讓我變得和$MCG一樣麼？骨瘦如柴而且一點用也沒有？
$LINE_SIDEQUEST_2_GET_120_CHAR	$MCG
$LINE_SIDEQUEST_2_GET_120_TEXT	嘿！
$LINE_SIDEQUEST_2_GET_130_CHAR	$BER
$LINE_SIDEQUEST_2_GET_130_TEXT	我都覺得我已經開始萎縮了……
$LINE_SIDEQUEST_2_GET_140_CHAR	$HEA
$LINE_SIDEQUEST_2_GET_140_TEXT	好吧，我們以前有穩定的魚供應，但後來河裡全是水亡者。
$LINE_SIDEQUEST_2_GET_150_CHAR	$BER
$LINE_SIDEQUEST_2_GET_150_TEXT	你說的是水僵屍？
$LINE_SIDEQUEST_2_GET_160_CHAR	$BER
$LINE_SIDEQUEST_2_GET_160_TEXT	聽起來這像是……
$LINE_SIDEQUEST_2_GET_170_CHAR	$BER
$LINE_SIDEQUEST_2_GET_170_TEXT	*$BER——水生動物死亡的承包商！
$LINE_SIDEQUEST_2_GET_180_CHAR	$BER
$LINE_SIDEQUEST_2_GET_180_TEXT	殘缺的水手！流血的漁夫！切片的海員！
$LINE_SIDEQUEST_2_GET_190_CHAR	$MCG
$LINE_SIDEQUEST_2_GET_190_TEXT	陳詞濫調的海員。
$LINE_SIDEQUEST_2_GET_200_CHAR	$BER
$LINE_SIDEQUEST_2_GET_200_TEXT	我航行至恐懼之海；你無力的嘲弄講消失在其榮耀的咆哮聲中。
$LINE_SIDEQUEST_2_GET_210_CHAR	$MCG
$LINE_SIDEQUEST_2_GET_210_TEXT	如果你不再沉溺於自我吹噓，我們或許就可以和亡者戰鬥了。
$SCENE_SIDEQUEST_2_INTRO_TITLE	花褲子大人
$LINE_SIDEQUEST_2_INTRO_00_CHAR	$RAN
$LINE_SIDEQUEST_2_INTRO_00_TEXT	為什麼我們又要這麼做？因為花褲子大人不愛吃蔬菜？
$LINE_SIDEQUEST_2_INTRO_10_CHAR	$BER
$LINE_SIDEQUEST_2_INTRO_10_TEXT	瞧瞧他們對你做的一切！
$LINE_SIDEQUEST_2_INTRO_20_CHAR	$RAN
$LINE_SIDEQUEST_2_INTRO_20_TEXT	什麼？
$LINE_SIDEQUEST_2_INTRO_30_CHAR	$BER
$LINE_SIDEQUEST_2_INTRO_30_TEXT	你現在就想個土豆似的。
$LINE_SIDEQUEST_2_INTRO_40_CHAR	$RAN
$LINE_SIDEQUEST_2_INTRO_40_TEXT	嘿！
$LINE_SIDEQUEST_2_INTRO_50_CHAR	$MCG
$LINE_SIDEQUEST_2_INTRO_50_TEXT	哈。
$LINE_SIDEQUEST_2_INTRO_60_CHAR	$RAN
$LINE_SIDEQUEST_2_INTRO_60_TEXT	太蠢了。
$LINE_SIDEQUEST_2_INTRO_70_CHAR	$BER
$LINE_SIDEQUEST_2_INTRO_70_TEXT	嗯，這也許是我們有史以來的最蠢的開戰理由了。
$LINE_SIDEQUEST_2_INTRO_80_CHAR	$MCG
$LINE_SIDEQUEST_2_INTRO_80_TEXT	什麼？我們在這裡全是因為你！
$LINE_SIDEQUEST_2_INTRO_90_CHAR	$BER
$LINE_SIDEQUEST_2_INTRO_90_TEXT	雖然我這麼做了，但我並不覺得這麼做是聰明的。
$LINE_SIDEQUEST_2_INTRO_100_CHAR	$BER
$LINE_SIDEQUEST_2_INTRO_100_TEXT	我就是我！雖然我希望你更好。
$LINE_SIDEQUEST_2_INTRO_110_CHAR	$MCG
$LINE_SIDEQUEST_2_INTRO_110_TEXT	……
$LINE_SIDEQUEST_2_INTRO_120_CHAR	$BER
$LINE_SIDEQUEST_2_INTRO_120_TEXT	順便說下，貌似河流都在這。
$LINE_SIDEQUEST_2_INTRO_130_CHAR	$MCG
$LINE_SIDEQUEST_2_INTRO_130_TEXT	別說話。
$SCENE_SIDEQUEST_2_OUTRO_TITLE	魚糕
$LINE_SIDEQUEST_2_OUTRO_00_CHAR	$RAN
$LINE_SIDEQUEST_2_OUTRO_00_TEXT	最後一個。
$LINE_SIDEQUEST_2_OUTRO_10_CHAR	$BER
$LINE_SIDEQUEST_2_OUTRO_10_TEXT	……但是屠殺才剛開始。
$LINE_SIDEQUEST_2_OUTRO_20_CHAR	$BER
$LINE_SIDEQUEST_2_OUTRO_20_TEXT	魚啊，遵從你的宿命吧！
$LINE_SIDEQUEST_2_OUTRO_30_CHAR	$BER
$LINE_SIDEQUEST_2_OUTRO_30_TEXT	我是赤炎滅絕之王！
$LINE_SIDEQUEST_2_OUTRO_40_CHAR	$RAN
$LINE_SIDEQUEST_2_OUTRO_40_TEXT	所以河流剛剛安全了……
$LINE_SIDEQUEST_2_OUTRO_50_CHAR	$RAN
$LINE_SIDEQUEST_2_OUTRO_50_TEXT	……因此用瘋狂驅動的劍，即使不用完全出鞘就能屠殺所有生命。
$LINE_SIDEQUEST_2_OUTRO_60_CHAR	$MCG
$LINE_SIDEQUEST_2_OUTRO_60_TEXT	差不多。
$SCENE_SIDEQUEST_3_GET_TITLE	親屬盟約
$LINE_SIDEQUEST_3_GET_00_CHAR	修女
$LINE_SIDEQUEST_3_GET_00_TEXT	抱歉，但是我知道有個革卡成員和你們一起?
$LINE_SIDEQUEST_3_GET_10_CHAR	$MCG
$LINE_SIDEQUEST_3_GET_10_TEXT	確切的說，有幾個，如果<LQ>名譽成員<RQ>也算的話。
$LINE_SIDEQUEST_3_GET_20_CHAR	修女
$LINE_SIDEQUEST_3_GET_20_TEXT	女修道院裡有個革卡人生病了，我們在照顧她。
$LINE_SIDEQUEST_3_GET_30_CHAR	修女
$LINE_SIDEQUEST_3_GET_30_TEXT	當她聽說這裡還有其他革卡人，所以想要見見他們。
$LINE_SIDEQUEST_3_GET_40_CHAR	修女
$LINE_SIDEQUEST_3_GET_40_TEXT	你是否願意去見她……我們擔心如果她變得激動會加重病情。
$LINE_SIDEQUEST_3_GET_50_CHAR	$BER
$LINE_SIDEQUEST_3_GET_50_TEXT	別擔心，對於人們而言，我是一種很好的撫慰劑！
$LINE_SIDEQUEST_3_GET_60_CHAR	修女
$LINE_SIDEQUEST_3_GET_60_TEXT	抱歉，但是……只有女人才能進修道院。
$LINE_SIDEQUEST_3_GET_70_CHAR	$BER
$LINE_SIDEQUEST_3_GET_70_TEXT	什麼？但那不是——
$LINE_SIDEQUEST_3_GET_80_CHAR	$RAN
$LINE_SIDEQUEST_3_GET_80_TEXT	呀——呀！
$LINE_SIDEQUEST_3_GET_90_CHAR	病人
$LINE_SIDEQUEST_3_GET_90_TEXT	她……在哪兒？
$LINE_SIDEQUEST_3_GET_100_CHAR	$RAN
$LINE_SIDEQUEST_3_GET_100_TEXT	*$RAN·塔基莉·革卡在跟你打招呼。
$LINE_SIDEQUEST_3_GET_110_CHAR	病人
$LINE_SIDEQUEST_3_GET_110_TEXT	阿蒂亞……科利客提·革卡
$LINE_SIDEQUEST_3_GET_120_CHAR	阿蒂亞
$LINE_SIDEQUEST_3_GET_120_TEXT	我……病的有點嚴重……快支撐不住了……
$LINE_SIDEQUEST_3_GET_130_CHAR	阿蒂亞
$LINE_SIDEQUEST_3_GET_130_TEXT	我在牆外……看見了……我們的革卡同伴。
$LINE_SIDEQUEST_3_GET_140_CHAR	阿蒂亞
$LINE_SIDEQUEST_3_GET_140_TEXT	在……一群……不安寧的死人之中……
$LINE_SIDEQUEST_3_GET_150_CHAR	阿蒂亞
$LINE_SIDEQUEST_3_GET_150_TEXT	他們值得……更好的對待。他們……應該擁有平靜。
$LINE_SIDEQUEST_3_GET_160_CHAR	$RAN
$LINE_SIDEQUEST_3_GET_160_TEXT	死者已經抵達和平，姐妹。
$LINE_SIDEQUEST_3_GET_170_CHAR	阿蒂亞
$LINE_SIDEQUEST_3_GET_170_TEXT	他們……一邊走……一邊尋找……還一邊胡言亂語？
$LINE_SIDEQUEST_3_GET_180_CHAR	阿蒂亞
$LINE_SIDEQUEST_3_GET_180_TEXT	你可以……解放他們。
$LINE_SIDEQUEST_3_GET_190_CHAR	$RAN
$LINE_SIDEQUEST_3_GET_190_TEXT	嗯……你應該知道，亡者無法被殺死。
$LINE_SIDEQUEST_3_GET_200_CHAR	阿蒂亞
$LINE_SIDEQUEST_3_GET_200_TEXT	*我知道你的朋友……$MCG，和她的能力。你的團隊就可以做到！
$LINE_SIDEQUEST_3_GET_210_CHAR	$RAN
$LINE_SIDEQUEST_3_GET_210_TEXT	抱歉，我不能。這種冒險完全沒必要。
$LINE_SIDEQUEST_3_GET_220_CHAR	阿蒂亞
$LINE_SIDEQUEST_3_GET_220_TEXT	你離開他們了？
$LINE_SIDEQUEST_3_GET_230_CHAR	$RAN
$LINE_SIDEQUEST_3_GET_230_TEXT	我不想加入他們。他們會明白的。
$LINE_SIDEQUEST_3_GET_240_CHAR	阿蒂亞
$LINE_SIDEQUEST_3_GET_240_TEXT	……塔基莉的女兒……蔑視……親屬關係。
$LINE_SIDEQUEST_3_GET_250_CHAR	阿蒂亞
$LINE_SIDEQUEST_3_GET_250_TEXT	我已經活得太久了。
$LINE_SIDEQUEST_3_GET_260_CHAR	$RAN
$LINE_SIDEQUEST_3_GET_260_TEXT	我不會犧牲自己去救那些已死的人！
$LINE_SIDEQUEST_3_GET_270_CHAR	阿蒂亞
$LINE_SIDEQUEST_3_GET_270_TEXT	滾……出……我的……視線。
$LINE_SIDEQUEST_3_GET_280_CHAR	$RAN
$LINE_SIDEQUEST_3_GET_280_TEXT	我沒意見。
$LINE_SIDEQUEST_3_GET_290_CHAR	阿蒂亞
$LINE_SIDEQUEST_3_GET_290_TEXT	你應該知道……沒有血緣關係的那一個……是克萊夫……和他的弟弟卡基特……
$LINE_SIDEQUEST_3_GET_300_CHAR	阿蒂亞
$LINE_SIDEQUEST_3_GET_300_TEXT	……克拉斯特的兒子們。
$LINE_SIDEQUEST_3_GET_310_CHAR	$RAN
$LINE_SIDEQUEST_3_GET_310_TEXT	……
$LINE_SIDEQUEST_3_GET_320_CHAR	$RAN
$LINE_SIDEQUEST_3_GET_320_TEXT	……該死。
$SCENE_SIDEQUEST_3_INTRO_TITLE	償還債務
$LINE_SIDEQUEST_3_INTRO_00_CHAR	$MCG
$LINE_SIDEQUEST_3_INTRO_00_TEXT	嘿！等等！
$LINE_SIDEQUEST_3_INTRO_10_CHAR	$MCG
$LINE_SIDEQUEST_3_INTRO_10_TEXT	什麼，你也在這些死人後跑進沙漠了？
$LINE_SIDEQUEST_3_INTRO_20_CHAR	$RAN
$LINE_SIDEQUEST_3_INTRO_20_TEXT	不死族，嗯，我不打算……殺他們，或者隨便怎麼樣。
$LINE_SIDEQUEST_3_INTRO_30_CHAR	$MCG
$LINE_SIDEQUEST_3_INTRO_30_TEXT	你覺得你可能需要幫助？
$LINE_SIDEQUEST_3_INTRO_40_CHAR	$RAN
$LINE_SIDEQUEST_3_INTRO_40_TEXT	這是……私事。
$LINE_SIDEQUEST_3_INTRO_50_CHAR	$MCG
$LINE_SIDEQUEST_3_INTRO_50_TEXT	嗯，這目前確實困擾著我。難道這不是有點……出乎意料麼？
$LINE_SIDEQUEST_3_INTRO_60_CHAR	$RAN
$LINE_SIDEQUEST_3_INTRO_60_TEXT	我欠他們的。
$LINE_SIDEQUEST_3_INTRO_70_CHAR	$MCG
$LINE_SIDEQUEST_3_INTRO_70_TEXT	所以你打算殺了自己麼？
$LINE_SIDEQUEST_3_INTRO_80_CHAR	$MCG
$LINE_SIDEQUEST_3_INTRO_80_TEXT	我是說，或許你已經忘了，但是亡者是不可戰勝的，除非你是在半路上。
$LINE_SIDEQUEST_3_INTRO_90_CHAR	$RAN
$LINE_SIDEQUEST_3_INTRO_90_TEXT	……你在這，不是麼？
$LINE_SIDEQUEST_3_INTRO_100_CHAR	$MCG
$LINE_SIDEQUEST_3_INTRO_100_TEXT	……以及一群模樣可怕的亡者也在這。
$SCENE_SIDEQUEST_3_OUTRO_TITLE	克拉斯特之子
$LINE_SIDEQUEST_3_OUTRO_00_CHAR	$RAN
$LINE_SIDEQUEST_3_OUTRO_00_TEXT	克拉斯特之子，請安靜。
$LINE_SIDEQUEST_3_OUTRO_10_CHAR	$MCG
$LINE_SIDEQUEST_3_OUTRO_10_TEXT	……那麼這些傢伙是誰？
$LINE_SIDEQUEST_3_OUTRO_20_CHAR	$RAN
$LINE_SIDEQUEST_3_OUTRO_20_TEXT	這現在不重要，不是嗎？
$LINE_SIDEQUEST_3_OUTRO_30_CHAR	$MCG
$LINE_SIDEQUEST_3_OUTRO_30_TEXT	*我只是想查出究竟是誰對殘酷生存主義者$RAN如此重要，讓她甘願冒生命危險。
$LINE_SIDEQUEST_3_OUTRO_40_CHAR	$RAN
$LINE_SIDEQUEST_3_OUTRO_40_TEXT	他們曾經救了我的命。
$LINE_SIDEQUEST_3_OUTRO_50_CHAR	$RAN
$LINE_SIDEQUEST_3_OUTRO_50_TEXT	他們救了我們所有人的命。
$LINE_SIDEQUEST_3_OUTRO_60_CHAR	$RAN
$LINE_SIDEQUEST_3_OUTRO_60_TEXT	不管怎麼樣，都是這些人編造出來的。
$LINE_SIDEQUEST_3_OUTRO_70_CHAR	$MCG
$LINE_SIDEQUEST_3_OUTRO_70_TEXT	編了些什麼？
$LINE_SIDEQUEST_3_OUTRO_80_CHAR	$RAN
$LINE_SIDEQUEST_3_OUTRO_80_TEXT	我們中了埋伏。他們留了下來，而我們跑了。這的確是真的。
$LINE_SIDEQUEST_3_OUTRO_90_CHAR	$RAN
$LINE_SIDEQUEST_3_OUTRO_90_TEXT	我們回去告訴那個話簍子，這樣她就可以含笑九泉了。
$LINE_SIDEQUEST_3_OUTRO_100_CHAR	$MCG
$LINE_SIDEQUEST_3_OUTRO_100_TEXT	這麼多有關我前男友的理論……
$LINE_SIDEQUEST_3_OUTRO_110_CHAR	$RAN
$LINE_SIDEQUEST_3_OUTRO_110_TEXT	我感到自己很太悲哀，因為我忘記了血緣關係。明明自己就已經鑄下大錯，在很多時候，我還去唾棄別人這一點。
$LINE_SIDEQUEST_3_OUTRO_120_CHAR	$RAN
$LINE_SIDEQUEST_3_OUTRO_120_TEXT	但時光飛逝。當狼群將我圍困時，我沒有劍，也沒有盾。
$LINE_SIDEQUEST_3_OUTRO_130_CHAR	$RAN
$LINE_SIDEQUEST_3_OUTRO_130_TEXT	沒有帳篷的我在風中依然苦澀。沒有船隻的我在海上仍然渺茫。然而無助時卻得不到絲毫的慰藉。
$LINE_SIDEQUEST_3_OUTRO_140_CHAR	$RAN
$LINE_SIDEQUEST_3_OUTRO_140_TEXT	我將我自己帶向深淵走向黑暗。我撕扯開自己的貪婪和仇恨的外表卻得不到救贖，就像我現在這樣。
$LINE_SIDEQUEST_3_OUTRO_150_CHAR	$MCG
$LINE_SIDEQUEST_3_OUTRO_150_TEXT	她什麼時候死的？
$LINE_SIDEQUEST_3_OUTRO_160_CHAR	$RAN
$LINE_SIDEQUEST_3_OUTRO_160_TEXT	大概在我們帶著運氣離開五分鐘後。
$LINE_SIDEQUEST_3_OUTRO_170_CHAR	$RAN
$LINE_SIDEQUEST_3_OUTRO_170_TEXT	事實便是如此，只要你忽略一個問題的時間足夠長，它就會自己消失不見。
$LINE_SIDEQUEST_3_OUTRO_180_CHAR	$MCG
$LINE_SIDEQUEST_3_OUTRO_180_TEXT	這真是一個悲哀的玩笑。
$LINE_SIDEQUEST_3_OUTRO_190_CHAR	$RAN
$LINE_SIDEQUEST_3_OUTRO_190_TEXT	不，最可悲的是我們付出那麼多卻沒有回報。
$LINE_SIDEQUEST_3_OUTRO_200_CHAR	$MCG
$LINE_SIDEQUEST_3_OUTRO_200_TEXT	當你幫助別人一次，就自我救贖了一回。這不是沒有回報。
$LINE_SIDEQUEST_3_OUTRO_210_CHAR	$RAN
$LINE_SIDEQUEST_3_OUTRO_210_TEXT	嗯，<LQ>幫助<RQ>……
$LINE_SIDEQUEST_3_OUTRO_220_CHAR	$MCG
$LINE_SIDEQUEST_3_OUTRO_220_TEXT	……你想談談這個？
$LINE_SIDEQUEST_3_OUTRO_230_CHAR	$RAN
$LINE_SIDEQUEST_3_OUTRO_230_TEXT	對，讓我們一起站在過去的彼岸面對曾經迷茫的內心。
$LINE_SIDEQUEST_3_OUTRO_240_CHAR	$MCG
$LINE_SIDEQUEST_3_OUTRO_240_TEXT	或許很好——
$LINE_SIDEQUEST_3_OUTRO_250_CHAR	$MCG
$LINE_SIDEQUEST_3_OUTRO_250_TEXT	——哦，我知道了，你又在譏諷他們了。
$LINE_SIDEQUEST_3_OUTRO_260_CHAR	$RAN
$LINE_SIDEQUEST_3_OUTRO_260_TEXT	我有沒有說過，你不如我有魅力，而且還不會為人處世？
$LINE_SIDEQUEST_3_OUTRO_270_CHAR	$MCG
$LINE_SIDEQUEST_3_OUTRO_270_TEXT	你這個混蛋。
$LINE_SIDEQUEST_3_OUTRO_280_CHAR	$RAN
$LINE_SIDEQUEST_3_OUTRO_280_TEXT	我感覺好多了。
$LINE_SIDEQUEST_3_OUTRO_290_CHAR	$MCG
$LINE_SIDEQUEST_3_OUTRO_290_TEXT	很好！我永遠都不會告訴你葡萄乾布丁的事！
$LINE_SIDEQUEST_3_OUTRO_300_CHAR	$RAN
$LINE_SIDEQUEST_3_OUTRO_300_TEXT	<LQ>葡萄乾布丁<RQ>？
$LINE_SIDEQUEST_3_OUTRO_310_CHAR	$MCG
$LINE_SIDEQUEST_3_OUTRO_310_TEXT	太糟糕了。
$LINE_SIDEQUEST_3_OUTRO_320_CHAR	$RAN
$LINE_SIDEQUEST_3_OUTRO_320_TEXT	可是……我現在備受好奇心的折磨。
$LINE_SIDEQUEST_3_OUTRO_330_CHAR	$RAN
$LINE_SIDEQUEST_3_OUTRO_330_TEXT	該死！
$LINE_SIDEQUEST_3_OUTRO_340_CHAR	$MAG
$LINE_SIDEQUEST_3_OUTRO_340_TEXT	有次我殺了一個帶著葡萄乾布丁的人。
$LINE_SIDEQUEST_3_OUTRO_350_CHAR	$MAG
$LINE_SIDEQUEST_3_OUTRO_350_TEXT	關鍵是當他們停止動彈後，還是要多抱一會他們的頭。
$LINE_SIDEQUEST_3_OUTRO_360_CHAR	$MAG
$LINE_SIDEQUEST_3_OUTRO_360_TEXT	不然，他們會射出像布丁一樣的怪物，你必須用烤火雞消滅它們。
$LINE_SIDEQUEST_3_OUTRO_370_CHAR	$MAG
$LINE_SIDEQUEST_3_OUTRO_370_TEXT	……然後爸爸你毀掉了火雞的事情很生氣，而你，<LQ>可是爸爸，有刺客！<RQ>
$LINE_SIDEQUEST_3_OUTRO_380_CHAR	$MAG
$LINE_SIDEQUEST_3_OUTRO_380_TEXT	……然後他說，<LQ>那你為什麼不用我給你的劍？<RQ>
$LINE_SIDEQUEST_3_OUTRO_390_CHAR	$MAG
$LINE_SIDEQUEST_3_OUTRO_390_TEXT	接著你說道，<LQ>那其他女孩嘲笑我<LQ>，然後他說，<LQ>那就削掉她們的腦袋！現在去你的房間裡練習投擲匕首！<LQ>
$LINE_SIDEQUEST_3_OUTRO_400_CHAR	$RAN
$LINE_SIDEQUEST_3_OUTRO_400_TEXT	……
$LINE_SIDEQUEST_3_OUTRO_410_CHAR	$MAG
$LINE_SIDEQUEST_3_OUTRO_410_TEXT	所以能有這樣女孩間的談話，我真的很高興。
$SCENE_SIDEQUEST_4_GET_TITLE	和平荒地
$NARR_SIDEQUEST_4_GET_00_TEXT	那天早些時候……
$LINE_SIDEQUEST_4_GET_00_CHAR	$BER
$LINE_SIDEQUEST_4_GET_00_TEXT	它已經跟著我整整兩天了，因為我殺了什麼……
$LINE_SIDEQUEST_4_GET_10_CHAR	$BER
$LINE_SIDEQUEST_4_GET_10_TEXT	我能感覺到寂寞空虛腐蝕了我的靈魂。
$LINE_SIDEQUEST_4_GET_20_CHAR	$BER
$LINE_SIDEQUEST_4_GET_20_TEXT	救命！
$LINE_SIDEQUEST_4_GET_30_CHAR	$HEA
$LINE_SIDEQUEST_4_GET_30_TEXT	怎麼了？
$LINE_SIDEQUEST_4_GET_40_CHAR	$BER
$LINE_SIDEQUEST_4_GET_40_TEXT	我在和平荒地！
$LINE_SIDEQUEST_4_GET_50_CHAR	$BER
$LINE_SIDEQUEST_4_GET_50_TEXT	天啊，從未想過居然會這樣結束！
$LINE_SIDEQUEST_4_GET_60_CHAR	$BER
$LINE_SIDEQUEST_4_GET_60_TEXT	*這裡躺著$BER，被他的朋友殘忍的拋棄。死於對缺乏殺戮。
$LINE_SIDEQUEST_4_GET_70_CHAR	$HEA
$LINE_SIDEQUEST_4_GET_70_TEXT	……
$LINE_SIDEQUEST_4_GET_80_CHAR	$BER
$LINE_SIDEQUEST_4_GET_80_TEXT	不，不要幫我。我把自己交付給我的命運。我就坐在這裡，等到不再寂寞——
$LINE_SIDEQUEST_4_GET_90_CHAR	$BER
$LINE_SIDEQUEST_4_GET_90_TEXT	噢，那閃閃發光的是什麼？
$LINE_SIDEQUEST_4_GET_100_CHAR	$HEA
$LINE_SIDEQUEST_4_GET_100_TEXT	什麼？
$LINE_SIDEQUEST_4_GET_110_CHAR	$BER
$LINE_SIDEQUEST_4_GET_110_TEXT	快過來，閃光！
$LINE_SIDEQUEST_4_GET_120_CHAR	$BER
$LINE_SIDEQUEST_4_GET_120_TEXT	我需要殺了你！
$SCENE_SIDEQUEST_4_INTRO_TITLE	神秘女子
$LINE_SIDEQUEST_4_INTRO_00_CHAR	$HEA
$LINE_SIDEQUEST_4_INTRO_00_TEXT	剛剛發生了什麼？
$LINE_SIDEQUEST_4_INTRO_10_CHAR	$BER
$LINE_SIDEQUEST_4_INTRO_10_TEXT	*啊，那肯定是$MCG。
$LINE_SIDEQUEST_4_INTRO_20_CHAR	$BER
$LINE_SIDEQUEST_4_INTRO_20_TEXT	我知道沒有我，他們不會殺害任何東西！
$LINE_SIDEQUEST_4_INTRO_30_CHAR	$HEA
$LINE_SIDEQUEST_4_INTRO_30_TEXT	但她只會讓那些東西靠近她……這不可能是——
$LINE_SIDEQUEST_4_INTRO_40_CHAR	神秘女子
$LINE_SIDEQUEST_4_INTRO_40_TEXT	嗯……這陣不是我所期待的。
$LINE_SIDEQUEST_4_INTRO_50_CHAR	$BER
$LINE_SIDEQUEST_4_INTRO_50_TEXT	你好，神秘的美麗女子！你不會恰好需要一位元帥氣、強壯而且感性的暴力打手來為你服務吧？
$LINE_SIDEQUEST_4_INTRO_60_CHAR	神秘女子
$LINE_SIDEQUEST_4_INTRO_60_TEXT	為什麼你覺得會是我帶你來的呢？
$LINE_SIDEQUEST_4_INTRO_70_CHAR	神秘女子
$LINE_SIDEQUEST_4_INTRO_70_TEXT	我需要進入這個神社，但其裡面的居民卻不同意。你能幫助我殺了裡面的人嗎？
$LINE_SIDEQUEST_4_INTRO_80_CHAR	$BER
$LINE_SIDEQUEST_4_INTRO_80_TEXT	請嫁給我。
$LINE_SIDEQUEST_4_INTRO_90_CHAR	神秘女子
$LINE_SIDEQUEST_4_INTRO_90_TEXT	這樣就對了。
$LINE_SIDEQUEST_4_INTRO_100_CHAR	$HEA
$LINE_SIDEQUEST_4_INTRO_100_TEXT	我不喜歡這個。
$LINE_SIDEQUEST_4_INTRO_110_CHAR	$BER
$LINE_SIDEQUEST_4_INTRO_110_TEXT	我知道你是個和尚，所以你可以假裝不知道這個，但她非常迷人。
$LINE_SIDEQUEST_4_INTRO_120_CHAR	$HEA
$LINE_SIDEQUEST_4_INTRO_120_TEXT	所以你對她言聽計從？
$LINE_SIDEQUEST_4_INTRO_130_CHAR	$BER
$LINE_SIDEQUEST_4_INTRO_130_TEXT	唔……
$LINE_SIDEQUEST_4_INTRO_140_CHAR	$BER
$LINE_SIDEQUEST_4_INTRO_140_TEXT	沒錯。
$SCENE_SIDEQUEST_4_OUTRO_TITLE	我說什麼了？
$LINE_SIDEQUEST_4_OUTRO_00_CHAR	$HEA
$LINE_SIDEQUEST_4_OUTRO_00_TEXT	等等，我知道廢墟。
$LINE_SIDEQUEST_4_OUTRO_10_CHAR	$HEA
$LINE_SIDEQUEST_4_OUTRO_10_TEXT	你是誰？你怎麼帶我們來這的？
$LINE_SIDEQUEST_4_OUTRO_20_CHAR	$HEA
$LINE_SIDEQUEST_4_OUTRO_20_TEXT	我知道還有一個女人能做類似的事情……但也不是這樣的事情。
$LINE_SIDEQUEST_4_OUTRO_30_CHAR	神秘女子
$LINE_SIDEQUEST_4_OUTRO_30_TEXT	*你認識$MCG·萊博？
$LINE_SIDEQUEST_4_OUTRO_40_CHAR	神秘女子
$LINE_SIDEQUEST_4_OUTRO_40_TEXT	當然……我應該感覺到的。
$LINE_SIDEQUEST_4_OUTRO_50_CHAR	神秘女子
$LINE_SIDEQUEST_4_OUTRO_50_TEXT	如果……不。不，太危險了。
$LINE_SIDEQUEST_4_OUTRO_60_CHAR	$HEA
$LINE_SIDEQUEST_4_OUTRO_60_TEXT	*你怎麼認識$MCG？
$LINE_SIDEQUEST_4_OUTRO_70_CHAR	神秘女子
$LINE_SIDEQUEST_4_OUTRO_70_TEXT	……
$LINE_SIDEQUEST_4_OUTRO_80_CHAR	神秘女子
$LINE_SIDEQUEST_4_OUTRO_80_TEXT	就一次，你忘了。
$LINE_SIDEQUEST_4_OUTRO_90_CHAR	$HEA
$LINE_SIDEQUEST_4_OUTRO_90_TEXT	什麼？
$LINE_SIDEQUEST_4_OUTRO_100_CHAR	$HEA
$LINE_SIDEQUEST_4_OUTRO_100_TEXT	我……我說什麼了？
$LINE_SIDEQUEST_4_OUTRO_110_CHAR	$BER
$LINE_SIDEQUEST_4_OUTRO_110_TEXT	整整兩天沒有暴亂。
$LINE_SIDEQUEST_4_OUTRO_120_CHAR	$BER
$LINE_SIDEQUEST_4_OUTRO_120_TEXT	我能感覺到我的殺戮肌肉在萎縮……
$LINE_SIDEQUEST_4_OUTRO_130_CHAR	$HEA
$LINE_SIDEQUEST_4_OUTRO_130_TEXT	或許你應該花點時間平靜地沉思一下。
$LINE_SIDEQUEST_4_OUTRO_140_CHAR	$BER
$LINE_SIDEQUEST_4_OUTRO_140_TEXT	平靜會殺了我！
$LINE_SIDEQUEST_4_OUTRO_150_CHAR	$MCG
$LINE_SIDEQUEST_4_OUTRO_150_TEXT	好吧，我們從修道院回來了。那裡很……
$LINE_SIDEQUEST_4_OUTRO_160_CHAR	$BER
$LINE_SIDEQUEST_4_OUTRO_160_TEXT	不要再離開我！
$SCENE_SIDEQUEST_7_GET_TITLE	秘密存放
$LINE_SIDEQUEST_7_GET_00_CHAR	$MCG
$LINE_SIDEQUEST_7_GET_00_TEXT	所以……就因為是你發現的，所以這房間裡的東西都是你的？
$LINE_SIDEQUEST_7_GET_10_CHAR	$DRA
$LINE_SIDEQUEST_7_GET_10_TEXT	人類，你有什麼爭議嗎？
$LINE_SIDEQUEST_7_GET_20_CHAR	$MCG
$LINE_SIDEQUEST_7_GET_20_TEXT	不，不，完全沒有。我只是想搞清楚規則是怎樣的。
$LINE_SIDEQUEST_7_GET_30_CHAR	$DRA
$LINE_SIDEQUEST_7_GET_30_TEXT	很好。
$LINE_SIDEQUEST_7_GET_40_CHAR	$MCG
$LINE_SIDEQUEST_7_GET_40_TEXT	所以，比如說，如果我發現了一個充滿寶物的房間，那麼那裡的一切就都是我的。
$LINE_SIDEQUEST_7_GET_50_CHAR	$DRA
$LINE_SIDEQUEST_7_GET_50_TEXT	哈，一個渺小的人類能嗅到金子的味道？你的自大讓我覺得好笑。
$LINE_SIDEQUEST_7_GET_60_CHAR	$MCG
$LINE_SIDEQUEST_7_GET_60_TEXT	但是如果我找到了，你就必須認為我是合理的所有者了，是嗎？
$LINE_SIDEQUEST_7_GET_70_CHAR	$DRA
$LINE_SIDEQUEST_7_GET_70_TEXT	當然。
$LINE_SIDEQUEST_7_GET_80_CHAR	$MCG
$LINE_SIDEQUEST_7_GET_80_TEXT	所以，這個下邊的密室裡的一切都屬於我，是麼？
$LINE_SIDEQUEST_7_GET_90_CHAR	$DRA
$LINE_SIDEQUEST_7_GET_90_TEXT	什麼？
$LINE_SIDEQUEST_7_GET_100_CHAR	$MCG
$LINE_SIDEQUEST_7_GET_100_TEXT	要知道，暗門打開就能進去的。
$LINE_SIDEQUEST_7_GET_110_CHAR	$MCG
$LINE_SIDEQUEST_7_GET_110_TEXT	可真是個相當古老的堡壘設計：你建了一個寶庫，把你的最好的東西都丟了進去。
$LINE_SIDEQUEST_7_GET_120_CHAR	$MCG
$LINE_SIDEQUEST_7_GET_120_TEXT	然後在那之下會有另一個寶庫，儲藏著真正的寶藏。
$LINE_SIDEQUEST_7_GET_130_CHAR	$MCG
$LINE_SIDEQUEST_7_GET_130_TEXT	入侵者發現第一個藏匿室然後就走了，並不會意識到他們錯過了所有的好東西。
$LINE_SIDEQUEST_7_GET_140_CHAR	$MCG
$LINE_SIDEQUEST_7_GET_140_TEXT	如果你讀過南方合併戰爭，你就會知道克萊蒂安·寇里蒂奧就是這麼設法保住其首都的財物的。
$LINE_SIDEQUEST_7_GET_150_CHAR	$MCG
$LINE_SIDEQUEST_7_GET_150_TEXT	如果你想看的話，我可以借給你。
$LINE_SIDEQUEST_7_GET_160_CHAR	$MCG
$LINE_SIDEQUEST_7_GET_160_TEXT	……夥計，我想知道那下面有什麼。
$LINE_SIDEQUEST_7_GET_170_CHAR	$DRA
$LINE_SIDEQUEST_7_GET_170_TEXT	……
$SCENE_SIDEQUEST_7_INTRO_TITLE	火焰之月
$LINE_SIDEQUEST_7_INTRO_00_CHAR	$KNI
$LINE_SIDEQUEST_7_INTRO_00_TEXT	女士，我希望你讓我先下去。
$LINE_SIDEQUEST_7_INTRO_10_CHAR	$MCG
$LINE_SIDEQUEST_7_INTRO_10_TEXT	哦，請。
$LINE_SIDEQUEST_7_INTRO_20_CHAR	$KNI
$LINE_SIDEQUEST_7_INTRO_20_TEXT	在我開始演講我如何需要接受你可以自己處理好這個事實之前，我必須先承認我的動機完全是自私的。
$LINE_SIDEQUEST_7_INTRO_30_CHAR	$MCG
$LINE_SIDEQUEST_7_INTRO_30_TEXT	我不知自己這一輩子是否都有資格享受這樣<LQ>自私<RQ>的生命榮譽債務。
$LINE_SIDEQUEST_7_INTRO_40_CHAR	$KNI
$LINE_SIDEQUEST_7_INTRO_40_TEXT	是的，如果我讓你死了，你覺得會怎麼樣呢？
$LINE_SIDEQUEST_7_INTRO_50_CHAR	$MCG
$LINE_SIDEQUEST_7_INTRO_50_TEXT	其他騎士都嘲笑你工作很爛？
$LINE_SIDEQUEST_7_INTRO_60_CHAR	$KNI
$LINE_SIDEQUEST_7_INTRO_60_TEXT	好吧，那麼我必須自殺。
$LINE_SIDEQUEST_7_INTRO_70_CHAR	$MCG
$LINE_SIDEQUEST_7_INTRO_70_TEXT	真的嗎？哇，那可……我想你應該沒我想像中的那麼女孩子氣。
$LINE_SIDEQUEST_7_INTRO_80_CHAR	$KNI
$LINE_SIDEQUEST_7_INTRO_80_TEXT	什麼？
$LINE_SIDEQUEST_7_INTRO_90_CHAR	$MCG
$LINE_SIDEQUEST_7_INTRO_90_TEXT	那是鎧甲。不管怎樣，我都覺得我們不必擔心什麼。那只是個古老的寶庫。
$LINE_SIDEQUEST_7_INTRO_100_CHAR	$MCG
$LINE_SIDEQUEST_7_INTRO_100_TEXT	但那有很多……死屍。但似乎它們這次真正地、認真地死掉了，這對我們來說真是一件不常有的事……
$LINE_SIDEQUEST_7_INTRO_101_CHAR	神秘女子
$LINE_SIDEQUEST_7_INTRO_101_TEXT	*$MCG·萊博爾。我以為你會來。
$LINE_SIDEQUEST_7_INTRO_102_CHAR	$MCG
$LINE_SIDEQUEST_7_INTRO_102_TEXT	什麼？
$LINE_SIDEQUEST_7_INTRO_110_CHAR	神秘女子
$LINE_SIDEQUEST_7_INTRO_110_TEXT	*$MCG·萊博。我知道你會來。
$LINE_SIDEQUEST_7_INTRO_120_CHAR	$MCG
$LINE_SIDEQUEST_7_INTRO_120_TEXT	什麼？
$LINE_SIDEQUEST_7_INTRO_130_CHAR	$KNI
$LINE_SIDEQUEST_7_INTRO_130_TEXT	是那個女法師！
$LINE_SIDEQUEST_7_INTRO_140_CHAR	$KNI
$LINE_SIDEQUEST_7_INTRO_140_TEXT	我們得離開這兒。
$LINE_SIDEQUEST_7_INTRO_150_CHAR	神秘女子
$LINE_SIDEQUEST_7_INTRO_150_TEXT	門關上了。我需要你在這。
$LINE_SIDEQUEST_7_INTRO_160_CHAR	$MCG
$LINE_SIDEQUEST_7_INTRO_160_TEXT	你要怎麼處理這些屍體？
$LINE_SIDEQUEST_7_INTRO_170_CHAR	神秘女子
$LINE_SIDEQUEST_7_INTRO_170_TEXT	我得找個人談談。
$LINE_SIDEQUEST_7_INTRO_180_CHAR	神秘女子
$LINE_SIDEQUEST_7_INTRO_180_TEXT	我說出艾斯裡-特諾奇的名字。就一次，你被召喚了！
$LINE_SIDEQUEST_7_INTRO_190_CHAR	艾斯裡-特諾奇
$LINE_SIDEQUEST_7_INTRO_190_TEXT	誰？我的……泰都-米期理……
$LINE_SIDEQUEST_7_INTRO_200_CHAR	艾斯裡-特諾奇
$LINE_SIDEQUEST_7_INTRO_200_TEXT	火焰之月，渴望一切。你終於和你的僕從們來放解放我了嗎？
$LINE_SIDEQUEST_7_INTRO_210_CHAR	泰都-米期理
$LINE_SIDEQUEST_7_INTRO_210_TEXT	不……是解放我們。
$LINE_SIDEQUEST_7_INTRO_211_CHAR	艾斯裡-特諾奇
$LINE_SIDEQUEST_7_INTRO_211_TEXT	我已經渴望——
$LINE_SIDEQUEST_7_INTRO_220_CHAR	艾斯裡-特諾奇
$LINE_SIDEQUEST_7_INTRO_220_TEXT	不——你說的不可能是真的。
$LINE_SIDEQUEST_7_INTRO_230_CHAR	泰都-米期理
$LINE_SIDEQUEST_7_INTRO_230_TEXT	所以我告訴自己很多年了……但是看看：
$LINE_SIDEQUEST_7_INTRO_240_CHAR	泰都-米期理
$LINE_SIDEQUEST_7_INTRO_240_TEXT	我就站在鑰匙旁……但是……我抵抗住了。
$LINE_SIDEQUEST_7_INTRO_250_CHAR	艾斯裡-特諾奇
$LINE_SIDEQUEST_7_INTRO_250_TEXT	她在這？！
$LINE_SIDEQUEST_7_INTRO_260_CHAR	泰都-米期理
$LINE_SIDEQUEST_7_INTRO_260_TEXT	是的，我可以抵抗！
$LINE_SIDEQUEST_7_INTRO_270_CHAR	艾斯裡-特諾奇
$LINE_SIDEQUEST_7_INTRO_270_TEXT	她在這！那你怎麼能不放了我？
$LINE_SIDEQUEST_7_INTRO_280_CHAR	泰都-米期理
$LINE_SIDEQUEST_7_INTRO_280_TEXT	你可以抵抗！你可以自己選擇！
$LINE_SIDEQUEST_7_INTRO_290_CHAR	艾斯裡-特諾奇
$LINE_SIDEQUEST_7_INTRO_290_TEXT	你這個卑鄙的背叛者！我的孩子會完成你做不了的那些事！
$LINE_SIDEQUEST_7_INTRO_300_CHAR	泰都-米期理
$LINE_SIDEQUEST_7_INTRO_300_TEXT	*$MCG！幫幫我！我們必須控制他！
$SCENE_SIDEQUEST_7_OUTRO_TITLE	薩爾和薩莉
$LINE_SIDEQUEST_7_OUTRO_00_CHAR	泰都-米期理
$LINE_SIDEQUEST_7_OUTRO_00_TEXT	我們身體裡的惡魔……使我們變得更卑微。如果我們再次結合的話，世界會在我們手中消失殆盡的。
$LINE_SIDEQUEST_7_OUTRO_10_CHAR	艾斯裡-特諾奇
$LINE_SIDEQUEST_7_OUTRO_10_TEXT	不會消耗殆盡。只是淨化了。緩和了。淨化了軟弱和污穢，以及那些渺小的思想匱乏的人類。
$LINE_SIDEQUEST_7_OUTRO_20_CHAR	泰都-米期理
$LINE_SIDEQUEST_7_OUTRO_20_TEXT	我不能……我不能任由我們。
$LINE_SIDEQUEST_7_OUTRO_30_CHAR	艾斯裡-特諾奇
$LINE_SIDEQUEST_7_OUTRO_30_TEXT	這……這就是你仍然愛我的方式？
$LINE_SIDEQUEST_7_OUTRO_40_CHAR	艾斯裡-特諾奇
$LINE_SIDEQUEST_7_OUTRO_40_TEXT	你忘記了我們是誰！
$LINE_SIDEQUEST_7_OUTRO_50_CHAR	泰都-米期理
$LINE_SIDEQUEST_7_OUTRO_50_TEXT	你忘了我們是誰！我多麼渴望回到過去……
$LINE_SIDEQUEST_7_OUTRO_60_CHAR	泰都-米期理
$LINE_SIDEQUEST_7_OUTRO_60_TEXT	在第一次鮮血誕生之前。在鮮血果實和火焰之月之前。在只有薩爾和薩莉的時候。
$LINE_SIDEQUEST_7_OUTRO_70_CHAR	艾斯裡-特諾奇
$LINE_SIDEQUEST_7_OUTRO_70_TEXT	這兩個名字都已經死了。
$LINE_SIDEQUEST_7_OUTRO_80_CHAR	泰都-米期理
$LINE_SIDEQUEST_7_OUTRO_80_TEXT	如果我們那時就知道我們會成為什麼——
$LINE_SIDEQUEST_7_OUTRO_90_CHAR	艾斯裡-特諾奇
$LINE_SIDEQUEST_7_OUTRO_90_TEXT	一切都不會有什麼改變。
$LINE_SIDEQUEST_7_OUTRO_91_CHAR	泰都-米期理
$LINE_SIDEQUEST_7_OUTRO_91_TEXT	我已經過了……這麼多世沒有你的生活。在世界的十字路口，我已經以淚洗面，將我的渴望丟棄在哪裡。我已經試著把它倒出，來把它填滿。
$LINE_SIDEQUEST_7_OUTRO_92_CHAR	泰都-米期理
$LINE_SIDEQUEST_7_OUTRO_92_TEXT	沒有任何的喜悅可以治癒我的悲傷。
$LINE_SIDEQUEST_7_OUTRO_93_CHAR	泰都-米期理
$LINE_SIDEQUEST_7_OUTRO_93_TEXT	但是我們的重逢不應該是這樣的。讓我們拋卻我們給自己下的詛咒。讓我們重新成為薩爾和薩莉。
$LINE_SIDEQUEST_7_OUTRO_100_CHAR	艾斯裡-特諾奇
$LINE_SIDEQUEST_7_OUTRO_100_TEXT	你想要的事情不可能的發生。
$LINE_SIDEQUEST_7_OUTRO_101_CHAR	艾斯裡-特諾奇
$LINE_SIDEQUEST_7_OUTRO_101_TEXT	像我這樣……這麼多年……但是我們不能。
$LINE_SIDEQUEST_7_OUTRO_110_CHAR	艾斯裡-特諾奇
$LINE_SIDEQUEST_7_OUTRO_110_TEXT	我們曾經拿起神性王冠！我們獨自監督這些烏合之眾，審判，引導，屠宰！我們沒有回頭的餘地了。
$LINE_SIDEQUEST_7_OUTRO_120_CHAR	艾斯裡-特諾奇
$LINE_SIDEQUEST_7_OUTRO_120_TEXT	我們無法逃開這可怕的責任。
$LINE_SIDEQUEST_7_OUTRO_130_CHAR	泰都-米期理
$LINE_SIDEQUEST_7_OUTRO_130_TEXT	……我在地球表面用鮮血寫下了我的名字。
$LINE_SIDEQUEST_7_OUTRO_140_CHAR	泰都-米期理
$LINE_SIDEQUEST_7_OUTRO_140_TEXT	但是我可以與過去一刀兩斷。
$LINE_SIDEQUEST_7_OUTRO_150_CHAR	艾斯裡-特諾奇
$LINE_SIDEQUEST_7_OUTRO_150_TEXT	那麼你就是個傻瓜。
$LINE_SIDEQUEST_7_OUTRO_160_CHAR	泰都-米期理
$LINE_SIDEQUEST_7_OUTRO_160_TEXT	求求你——
$LINE_SIDEQUEST_7_OUTRO_170_CHAR	艾斯裡-特諾奇
$LINE_SIDEQUEST_7_OUTRO_170_TEXT	你會否定我們的目的麼？你會違背你的承諾麼？
$LINE_SIDEQUEST_7_OUTRO_180_CHAR	艾斯裡-特諾奇
$LINE_SIDEQUEST_7_OUTRO_180_TEXT	你沒看見我們不在時世界成了什麼樣子麼？
$LINE_SIDEQUEST_7_OUTRO_190_CHAR	泰都-米期理
$LINE_SIDEQUEST_7_OUTRO_190_TEXT	我們當時造成了更糟糕的局面。
$LINE_SIDEQUEST_7_OUTRO_200_CHAR	泰都-米期理
$LINE_SIDEQUEST_7_OUTRO_200_TEXT	我求求你了！
$LINE_SIDEQUEST_7_OUTRO_210_CHAR	泰都-米期理
$LINE_SIDEQUEST_7_OUTRO_210_TEXT	不……
$LINE_SIDEQUEST_7_OUTRO_220_CHAR	薩莉
$LINE_SIDEQUEST_7_OUTRO_220_TEXT	……薩莉求求你了。解放我們吧。
$LINE_SIDEQUEST_7_OUTRO_230_CHAR	薩莉
$LINE_SIDEQUEST_7_OUTRO_230_TEXT	賜予我毀滅的天賦。
$LINE_SIDEQUEST_7_OUTRO_240_CHAR	艾斯裡-特諾奇
$LINE_SIDEQUEST_7_OUTRO_240_TEXT	……
$LINE_SIDEQUEST_7_OUTRO_250_CHAR	艾斯裡-特諾奇
$LINE_SIDEQUEST_7_OUTRO_250_TEXT	這是我能留給你的唯一天賦。
$LINE_SIDEQUEST_7_OUTRO_260_CHAR	艾斯裡-特諾奇
$LINE_SIDEQUEST_7_OUTRO_260_TEXT	……
$LINE_SIDEQUEST_7_OUTRO_270_CHAR	艾斯裡-特諾奇
$LINE_SIDEQUEST_7_OUTRO_270_TEXT	所以過去的最後一件衣服被廢除了
$LINE_SIDEQUEST_7_OUTRO_271_CHAR	艾斯裡-特諾奇
$LINE_SIDEQUEST_7_OUTRO_271_TEXT	……然後它……不……
$LINE_SIDEQUEST_7_OUTRO_280_CHAR	艾斯裡-特諾奇
$LINE_SIDEQUEST_7_OUTRO_280_TEXT	很快這個虛弱的世界就能感覺到神的鞭策之手。
$LINE_SIDEQUEST_7_OUTRO_281_CHAR	艾斯裡-特諾奇
$LINE_SIDEQUEST_7_OUTRO_281_TEXT	……或者他死亡的哀悼。
$LINE_SIDEQUEST_7_OUTRO_290_CHAR	艾斯裡-特諾奇
$LINE_SIDEQUEST_7_OUTRO_290_TEXT	你讓我失去了……比你所知道的更多……
$LINE_SIDEQUEST_7_OUTRO_291_CHAR	艾斯裡-特諾奇
$LINE_SIDEQUEST_7_OUTRO_291_TEXT	神性……
$LINE_SIDEQUEST_7_OUTRO_292_CHAR	艾斯裡-特諾奇
$LINE_SIDEQUEST_7_OUTRO_292_TEXT	你給了我兩個自由。但是哪一個是真正的救贖呢？
$LINE_SIDEQUEST_7_OUTRO_293_CHAR	艾斯裡-特諾奇
$LINE_SIDEQUEST_7_OUTRO_293_TEXT	我已經邁出了一步……但是……不……
$LINE_SIDEQUEST_7_OUTRO_294_CHAR	艾斯裡-特諾奇
$LINE_SIDEQUEST_7_OUTRO_294_TEXT	不！
$LINE_SIDEQUEST_7_OUTRO_300_CHAR	艾斯裡-特諾奇
$LINE_SIDEQUEST_7_OUTRO_300_TEXT	*做好準備，$MCG。
$LINE_SIDEQUEST_7_OUTRO_310_CHAR	艾斯裡-特諾奇
$LINE_SIDEQUEST_7_OUTRO_310_TEXT	你會是……全人類的……偉大的引導者。
$LINE_SIDEQUEST_7_OUTRO_320_CHAR	$MCG
$LINE_SIDEQUEST_7_OUTRO_320_TEXT	……
$LINE_SIDEQUEST_7_OUTRO_330_CHAR	$MCG
$LINE_SIDEQUEST_7_OUTRO_330_TEXT	……薩爾和薩莉。
$SCENE_HERMIT_1_INTRO_TITLE	給你的特價！
$LINE_HERMIT_1_INTRO_00_CHAR	隱士
$LINE_HERMIT_1_INTRO_00_TEXT	嘿，陌生人！
$LINE_HERMIT_1_INTRO_10_CHAR	$MCG
$LINE_HERMIT_1_INTRO_10_TEXT	你看著好眼熟。我們見過麼？
$LINE_HERMIT_1_INTRO_20_CHAR	隱士
$LINE_HERMIT_1_INTRO_20_TEXT	就算見過了也不能說。雖然這麼說——
$LINE_HERMIT_1_INTRO_30_CHAR	隱士
$LINE_HERMIT_1_INTRO_30_TEXT	你有頭骨嗎？
$LINE_HERMIT_1_INTRO_40_CHAR	隱士
$LINE_HERMIT_1_INTRO_40_TEXT	我不是說你自己的。我可以看出來……
$LINE_HERMIT_1_INTRO_50_CHAR	隱士
$LINE_HERMIT_1_INTRO_50_TEXT	因為，你知道，如果你沒有頭骨，你的頭就會變得奇形怪狀，左右搖擺。
$LINE_HERMIT_1_INTRO_60_CHAR	$MCG
$LINE_HERMIT_1_INTRO_60_TEXT	*呃……$BER似乎要收集他們……有點令人不安。
$LINE_HERMIT_1_INTRO_70_CHAR	$MCG
$LINE_HERMIT_1_INTRO_70_TEXT	其實，我很擔心他。
$LINE_HERMIT_1_INTRO_80_CHAR	$MCG
$LINE_HERMIT_1_INTRO_80_TEXT	現在也有點擔心你。
$LINE_HERMIT_1_INTRO_90_CHAR	隱士
$LINE_HERMIT_1_INTRO_90_TEXT	不，不是亡者頭骨！你那瘋狂的同伴可以自己保留那些亂七八糟的東西。
$LINE_HERMIT_1_INTRO_100_CHAR	隱士
$LINE_HERMIT_1_INTRO_100_TEXT	我是說……
$LINE_HERMIT_1_INTRO_110_CHAR	隱士
$LINE_HERMIT_1_INTRO_110_TEXT	魔法頭骨！
$LINE_HERMIT_1_INTRO_120_CHAR	隱士
$LINE_HERMIT_1_INTRO_120_TEXT	它們由石頭、銅或黑曜石製成。亡者有時候會背著它們到處跑。
$LINE_HERMIT_1_INTRO_130_CHAR	隱士
$LINE_HERMIT_1_INTRO_130_TEXT	不管怎樣，你要是找到了，就帶來給我。我不會虧待你的。
$LINE_HERMIT_1_INTRO_140_CHAR	$MCG
$LINE_HERMIT_1_INTRO_140_TEXT	你要它們做什麼？
$LINE_HERMIT_1_INTRO_150_CHAR	隱士
$LINE_HERMIT_1_INTRO_150_TEXT	這是秘密。
$LINE_HERMIT_1_INTRO_160_CHAR	隱士
$LINE_HERMIT_1_INTRO_160_TEXT	如果我告訴你它們味道有多好，那你就會全部留給自己了！
$LINE_HERMIT_1_INTRO_170_CHAR	隱士
$LINE_HERMIT_1_INTRO_170_TEXT	所以我是不會告訴你它們和黑麵包，麵條搭配在一起是有多美味的。
$LINE_HERMIT_1_INTRO_180_CHAR	隱士
$LINE_HERMIT_1_INTRO_180_TEXT	跟大米和燉李子在一起也很不錯。
$LINE_HERMIT_1_INTRO_190_CHAR	隱士
$LINE_HERMIT_1_INTRO_190_TEXT	我的嘴很嚴。
$SCENE_HERMIT_2_INTRO_TITLE	我們的交易真是太瘋狂了！
$LINE_HERMIT_2_INTRO_00_CHAR	$MCG
$LINE_HERMIT_2_INTRO_00_TEXT	等等。我之前見過你們？
$LINE_HERMIT_2_INTRO_10_CHAR	隱士
$LINE_HERMIT_2_INTRO_10_TEXT	*當然了，在勒索斯，記得嗎？你朋友$HEA送我去的。
$LINE_HERMIT_2_INTRO_20_CHAR	$MCG
$LINE_HERMIT_2_INTRO_20_TEXT	你有兄弟姐妹什麼的嗎？
$LINE_HERMIT_2_INTRO_30_CHAR	隱士
$LINE_HERMIT_2_INTRO_30_TEXT	確實有！他住在勒索斯的西南部。我們一共有四個人。
$LINE_HERMIT_2_INTRO_40_CHAR	$MCG
$LINE_HERMIT_2_INTRO_40_TEXT	四胞胎？你們穿的都一樣嗎？
$LINE_HERMIT_2_INTRO_50_CHAR	隱士
$LINE_HERMIT_2_INTRO_50_TEXT	當然！難道你以為我編故事嗎？
$LINE_HERMIT_2_INTRO_60_CHAR	隱士
$LINE_HERMIT_2_INTRO_60_TEXT	什麼，我是那種跟在你身後只是為了升級你的裝備以交換美味魔法頭骨的瘋子嗎？
$LINE_HERMIT_2_INTRO_70_CHAR	$MCG
$LINE_HERMIT_2_INTRO_70_TEXT	好吧……那很瘋狂。
$LINE_HERMIT_2_INTRO_80_CHAR	隱士
$LINE_HERMIT_2_INTRO_80_TEXT	不管怎樣，有魔法頭骨嗎？
$LINE_HERMIT_2_INTRO_90_CHAR	$MCG
$LINE_HERMIT_2_INTRO_90_TEXT	……
$SCENE_HERMIT_3_INTRO_TITLE	一切終將流逝！
$LINE_HERMIT_3_INTRO_00_CHAR	隱士
$LINE_HERMIT_3_INTRO_00_TEXT	你好陌生人！
$LINE_HERMIT_3_INTRO_10_CHAR	$MCG
$LINE_HERMIT_3_INTRO_10_TEXT	又是你？
$LINE_HERMIT_3_INTRO_20_CHAR	隱士
$LINE_HERMIT_3_INTRO_20_TEXT	夫人，我們見過嗎？
$LINE_HERMIT_3_INTRO_30_CHAR	$MCG
$LINE_HERMIT_3_INTRO_30_TEXT	我真的不確定……
$LINE_HERMIT_3_INTRO_40_CHAR	$MCG
$LINE_HERMIT_3_INTRO_40_TEXT	也許你不收集魔法頭骨，是嗎？
$LINE_HERMIT_3_INTRO_50_CHAR	隱士
$LINE_HERMIT_3_INTRO_50_TEXT	你是說魔法頭骨？
$LINE_HERMIT_3_INTRO_60_CHAR	隱士
$LINE_HERMIT_3_INTRO_60_TEXT	當然不是，那些東西只是給小孩子的。
$LINE_HERMIT_3_INTRO_70_CHAR	隱士
$LINE_HERMIT_3_INTRO_70_TEXT	我收集神秘頭骨！
$LINE_HERMIT_3_INTRO_80_CHAR	隱士
$LINE_HERMIT_3_INTRO_80_TEXT	它們由石頭、銅或黑曜石製成。亡者有時候會背著它們到處跑。
$LINE_HERMIT_3_INTRO_90_CHAR	隱士
$LINE_HERMIT_3_INTRO_90_TEXT	很多笨蛋*咳咳，像我哥哥，咳咳*把它們錯認為是魔法頭骨。
$LINE_HERMIT_3_INTRO_100_CHAR	隱士
$LINE_HERMIT_3_INTRO_100_TEXT	但我向你保證，它們完全是不一樣的東西。
$LINE_HERMIT_3_INTRO_110_CHAR	隱士
$LINE_HERMIT_3_INTRO_110_TEXT	味道都完全不同。
$SCENE_HERMIT_4_INTRO_TITLE	城鎮裡最好的交易！
$LINE_HERMIT_4_INTRO_00_CHAR	隱士
$LINE_HERMIT_4_INTRO_00_TEXT	喂那邊的，那個我這輩子一定從未見過的傢伙！
$LINE_HERMIT_4_INTRO_10_CHAR	$MCG
$LINE_HERMIT_4_INTRO_10_TEXT	哇，哇啊，追到來這裡？
$LINE_HERMIT_4_INTRO_20_CHAR	隱士
$LINE_HERMIT_4_INTRO_20_TEXT	啊，我知道了，你見過我的兄弟。他們喜歡玩智力遊戲。
$LINE_HERMIT_4_INTRO_30_CHAR	隱士
$LINE_HERMIT_4_INTRO_30_TEXT	當然，我從未夢到會做出這樣的事。
$LINE_HERMIT_4_INTRO_40_CHAR	隱士
$LINE_HERMIT_4_INTRO_40_TEXT	隨便干擾顧客的腦袋可不是什麼好生意。
$LINE_HERMIT_4_INTRO_50_CHAR	$MCG
$LINE_HERMIT_4_INTRO_50_TEXT	……那當然了。
$LINE_HERMIT_4_INTRO_60_CHAR	$MCG
$LINE_HERMIT_4_INTRO_60_TEXT	你收集魔法，神秘和其他古怪的頭庫嗎？
$LINE_HERMIT_4_INTRO_70_CHAR	隱士
$LINE_HERMIT_4_INTRO_70_TEXT	都收集！你有嗎？
$LINE_HERMIT_4_INTRO_80_CHAR	$MCG
$LINE_HERMIT_4_INTRO_80_TEXT	我會去查一下的，謝謝你“沒有隨便干擾我的腦袋”。
$LINE_HERMIT_4_INTRO_90_CHAR	隱士
$LINE_HERMIT_4_INTRO_90_TEXT	*拜託，我怎麼會對待像你這樣的老朋友呢，$MCG。
$LINE_HERMIT_4_INTRO_100_CHAR	$MCG
$LINE_HERMIT_4_INTRO_100_TEXT	……
$LINE_HERMIT_4_INTRO_110_CHAR	隱士
$LINE_HERMIT_4_INTRO_110_TEXT	我是指，我兄弟的老朋友！他們向我提起過你！
$LINE_HERMIT_4_INTRO_120_CHAR	隱士
$LINE_HERMIT_4_INTRO_120_TEXT	這很明顯嘛，我是說，否則我怎麼知道你的名字呢？
$LINE_HERMIT_4_INTRO_130_CHAR	隱士
$LINE_HERMIT_4_INTRO_130_TEXT	我才沒有每晚偷偷摸摸的潛入你的營地，偷看你的日記，偷取你的補給品，好讓我能繼續隱士生活呢！
$LINE_HERMIT_4_INTRO_140_CHAR	隱士
$LINE_HERMIT_4_INTRO_140_TEXT	對了我想起來了，“雅琪”到底是什麼樣的中間名啊？我要說，你一定非常恨你父母取了這麼一個名字。
$LINE_HERMIT_4_INTRO_150_CHAR	$MCG
$LINE_HERMIT_4_INTRO_150_TEXT	……
$LINE_HERMIT_4_INTRO_160_CHAR	隱士
$LINE_HERMIT_4_INTRO_160_TEXT	對了，升級！
